-a|adjectival suffix (suf)
a-|infinitive prefix (pref)
na-²|infinitive prefix (pref)
á|imperative particle (particle)
a¹|O, Oh (interj)
a²|accusative definite article (article)
accal-|to blaze, shine (suddenly and) brilliantly (vb)
accamátala|over-eating (adj)
accamatië|over-eating (n)
accasúcala|over-drinking (adj)
accasucië|over-drinking (n)
aha|rage (n)
ahtar-|to do back, react; ⚠️to requite, avenge (vb)
ahtar-|to do back, react; to requite, avenge (vb)
accar-|to do back, react; to requite, avenge (vb)
ahtarië|reaction; ⚠️vengeance (n)
ahtarulas(së)|responsibility, (lit.) aptitude to react (n)
ahto|wright, maker (n)
ahto|wright, maker (n)
ahya-|to change (vb)
ai¹|ah, alas (interj)
ai²|supposing, suppose, maybe; *any (adv)
aia|strange, unusual (adj)
aian|holy thing or object or place (n)
aica|fell, terrible, dire; [ᴹQ.] sharp (adj)
aico|cliff (n)
ailin|(large) lake, [ᴹQ.] pool (n)
ailumë¹|anytime (adv)
aima|anything, whatever (pron)
aiqua|anything, whatever (pron)
aimahto|martyr, (lit.) blessed slain (n)
aimanen|however (adv)
aimo|saint (n)
aina|holy, revered, numinous, *divine, ⚠️[ᴱQ.] worshipful (adj)
aina-|to hallow, bless, treat as holy (vb)
ainas|hallow, fane, *shrine, holy place, sanctuary (n)
ainima|any kind of (pron)
ainima|blessed, holy (of things) (adj)
aino|god (n)
ainocimië|reverence, piety, godliness (n)
ainocimya|reverent, pious (adj)
ainolóra|godless (adj)
ainolórië|godlessness (n)
ainomë|anyplace, anywhere (adv)
Ainu|holy one, angelic spirit (m.); ⚠️[ᴱQ.] (pagan) god (n)
aipio|cherry (n)
aiqualë|steepness, a steep [thing] (n)
aiquassë|precipice (n)
aiquen|if anybody, whoever, [ᴺQ.] anybody (pron)
aira|holy, sanctified, [ᴱQ.] worshipful (adj)
airalindë|hymn, (lit.) holy song (n)
airelinna|hymn, (lit.) holy song (n)
airasëa|hyssop (n)
airë¹|holy; sanctity, holiness (adj n)
airë²|sea (n)
airëa|holy (applied to persons) (adj)
airemma|icon, (lit.) holy image (n)
airilírë|hymn (n)
airimo|priest (n)
airimossë|priesthood (n)
airita-|to hallow (vb)
airon|ocean (n)
aista|*holy (adj)
aistana|*blessed (adj)
manna|*blessed (adj)
aita-¹|to revere, worship (vb)
tyer-|to worship (vb)
aita-²|to astound, surprise, shock, (orig.) make aghast (vb)
aitalë|reverence, worship, religion (n)
aitalëa|reverent, worshipful, religious (adj)
aitamo|worshiper (n)
tyerindo|worshiper (n)
aitë|of some sort, of any sort (adj)
aivë|anyway, anyhow, in any way (adv)
aiwë|(small) bird (n)
aiya|hail; behold, lo (interj)
aia|hail (interj)
(a)lá|yes (interj)
lá³|yes (interj)
ála|do not (particle)
al(a)-¹|in-, un-, not; †-less, without (pref)
ala-¹|to grow (of plants) [intr. and trans.], plant; *to thrive, flourish (of other creatures) (vb)
al(a)-²|well, happily (pref)
ala-²|to deny (vb)
alacarna|well-done, well-made (adj)
alacénima|invisible (adj)
alacestaima|unsearchable (adj)
alacestima|unsearchable (adj)
alafasta|tidy, orderly (adj)
alahasta|unmarred (adj)
alahastaima|incorruptable (adj)
alahastima|incorruptable (adj)
alahen|eyeless (adj)
alahírima|unfindable, impossible to find (adj)
alahta-|to rush (vb)
alaica|blunt (adj)
alairë|unholy (adj)
alalla-|*to keep on growing (vb)
alalmë|inflorescence (n)
alalbë|inflorescence (n)
alaloitala|unfailing (adj)
alalunga|light, unheavy (adj)
alalvëa|having many elms (adj)
alamára|no-good (adj)
alamen|good omen on departure (n)
alamirwa|cheap, not precious, not expensive (adj)
alamo|cultivator, grower (n)
alanancárima|indestructible (adj)
alanessë|nicotiana, pipeweed, *tobacco (n)
alenessë|nicotiana, pipeweed (n)
alapálima|unshakable (adj)
alapihta|unshrunk (adj)
alapulúna|unleavened, unfermented (adj)
alaquenta|well (happily) said (adj)
alarya-|to be happy or merry, rejoice (vb)
alasta-²|to be merry, rejoice (vb)
alas|marble (n)
alasaila|unwise (adj)
alasatya|common, general, *communal, (lit.) not private (adj)
alasóvina|unwashed (adj)
alassë|happiness, [ᴹQ.] joy, merriment (n)
alassëa|joyful, happy, *merry (adj)
alasta|of marble, marble (adj)
alasta-¹|to make happy, cheer (up) (vb)
alatya-|to shield, ward off, ⚠️protect (vb)
alavahtaina|undefiled (adj)
alavistaima|unchangeable (adj)
alavistima|unchangeable (adj)
alca-|to glitter, *shine out, flash (vb)
alcar|glory, splendour, radiance, brilliance (n)
alcárima|not feasible, impossible (adj)
lacárima|not feasible, impossible (adj)
alcarin(qua)|glorious, brilliant, [ᴹQ.] radiant (adj)
alcarvalda|honourable (adj)
alcarya-|to glorify (vb)
alda|tree, ⚠️[ᴱQ.] branch (n)
aldarembina|tree-meshed (adj)
Aldëa|*Tuesday, Tree-day (Númenórean) (n)
aldeon|avenue (of trees) (n)
aldinga|tree-top (n)
aldomë|nowhere (pron)
Aldúya|*Tuesday, Day of the Two Trees (n)
Aldauya|*Tuesday, Day of the Two Trees (n)
aleldarin|unelvish (adj)
aleldarinwa|unElvish (adj)
alermaitë|abstract, non-concrete (adj)
alima|fair, good (adj)
alla|welcome, hail (interj)
allumë|never (adv)
úoio|never (adv)
alma|flower (n)
alba|flower (n)
almë|good (or blessed) thing, blessing, piece of good fortune (n)
almien|cheers, (lit.) to good fortune (interj)
almo|shoulder, ⚠️back (n)
alon|limestone, (lit.) grow-stone (n)
alqua|swan (n)
alquen|nobody, no one (pron)
alaquen|nobody, no one (pron)
altarnië|empire (n)
alu|(dressed) leather (n)
alumo|leather-worker (n)
alvë|elm (n)
albë|elm (n)
alya|[ᴹQ.] rich, prosperous, abundant, blessed; ⚠️[Q.] fair, good (adj)
alya-|to cause to prosper, bless (a work), help one (vb)
am-|up, [ᴱQ.] upwards (pref)
ama-|*well, happily (pref)
amacarastië|upbuilding (n)
amaltil|*mother finger (n)
amanya|*blessed (adj)
amapta-|to ravish, seize and carry off forcibly (vb)
amaquat-|to fulfill, (lit.) up fill (vb)
amatírë|hope (n)
amaurë|dawn, early day, morning (n)
amaurëa|dawn, early day, morning (adj)
amavil-|to fly up, soar (vb)
amba¹|up(wards) (adv)
amba²|more (adj pron)
ambahep-|to maintain, (lit.) upkeep (vb)
ambalasar|stalagmite, (lit.) up-growing stone (n)
ambalotsë|uprising-flower (n)
Ambar|The World, Earth, (lit.) Habitation, Settlement (n)
Imbar|Habitation (n)
ambarónë|dawn; [ᴹQ.] uprising, sunrise, Orient (n)
ambarya|worldwide, world-wide, international, global (adj)
ambë|more (adv)
ambela|further still beyond, far away beyond (adv)
am(be)na|nearer to (adv)
amna|nearer to (adv)
ambo|hill, rising ground, ⚠️mount (n)
ambona|hill (n)
amboraxosta|rib cage (n)
amboremma|bust, (lit.) breast-picture (n)
ambos|breast, *chest (n)
ambostulco|bra, (lit.) breast-support (n)
ambuna|hilly (adj)
Américárin|American (adj)
amilessë|mother-name (n)
amil(lë)|mother (n)
emil|mother (n)
amilosto|metropolis (n)
ammë|mummy, mother (n)
emmë²|mummy, mother (familiar/family) (n)
amna|almost (adv)
amorta-|to heave (vb)
ampa|hook, [ᴹQ.] crook (n)
ampícië|less (adv)
ampollië|great effort, struggle (n)
andavië|struggle, strong effort (n)
empollië|*harder (adv)
amya|mummy, (orig.) my mother (n)
am(il)ye|*mummy (n)
emya|mummy, (orig.) my mother (n)
amya-²|[unglossed] (vb)
amyára|elder (n)
an|for, but, then, or; moreover, furthermore (conj adv)
an-|intensive prefix (pref)
am(a)-|intensive prefix (pref)
an(da)-|superlative prefix (pref)
an(a)|to, towards, to a point near, alongside; ⚠️[ᴱQ.] until (prep)
na|to, towards (prep)
ana-|to, towards (pref)
ana-¹|to, towards (pref)
(a)nacca|narrows, defile, pass, cut (n)
nacca|narrows, defile, pass, cut (n)
Anahristo|Antichrist (n)
anahtai|although, even though, (lit.) against-that-which (conj)
analelya-|to approach (vb)
Anar|Sun (n)
Anarya|Sunday, (lit.) Sun-day (n)
anasirë|tributary (n)
anastorna|*extremely hard (adj)
anat|against (prep)
(ana)tarwesta|crucifix(ion) (n)
anca|jaws; [ᴹQ.] jaw, row of teeth (n)
ancárima|easy, (lit.) very doable (adj)
anda|long, far (adj)
andalango|giraffe, (lit.) long-neck (n)
andamacil|long sword (n)
andanéya|long ago, once upon a time (adv)
andanyarro|weasel, ferret, mink, stoat, polecat, (lit.) long-rat (n)
andarestë|long-suffering, patience (n)
andarma-|to crash (vb)
andatehta|long-mark (n)
andavë|long, at great length (adv)
andë|length (n)
ando|gate, [great] door; †entrances, approaches (n)
andorië|landing (place), dock (n)
andorya-|to land, dock (vb)
andosan|vestibule, (lit.) gate room (n)
andú-|going down, setting (of sun), west (pref)
andúna|western (adj)
andúnë|sunset, evening, (orig.) going down; west (n)
anel|daughter (n)
anessë|given (or added) name, nickname, surname (n)
anga|iron (n)
angal|mirror, *reflective surface (n)
angaraxa|train (n)
angatië|railway line, railroad track, (lit.) iron-road (n)
angulóceluntë|dragon boat (n)
angwenda|chain (n)
anna|gift, (orig.) thing handed, brought or sent to a person, *present (n)
anwa|gift (n)
annún|at least (adv)
anon|son (n)
anqua|opposite, against (adj adv)
anquantaina|complete, thoroughly filled (adj)
anta|[ᴹQ.] face, *front of the head, [ᴱQ.] cheek; ⚠️[Q.] jaw (n)
anta|jaw (n)
anta-|to give, present; †to add to (vb)
antac-|to apply (vb)
antelwa|later, (lit.) very late (adj)
telwina|later (adj)
antil|*middle finger (n)
anto|mouth [as a thing for eating]; ⚠️[ᴱQ.] jaw (n)
antorya-|to strengthen [of sound] (vb)
antoryamë|strengthening (n)
anwavë|surely, certainly (adv)
anya-|to reach, arrive at, go to; *to manage, suceed (at something) + infinitive (vb)
ten-|to arrive, come to (vb)
tenya-|to arrive, end (not at speaker’s[?] place) (vb)
anyaitië|range, reach, distance of capability (n)
anyára|elder, *senior (adj)
ap-|to touch one, concern, affect (vb)
apa¹|after (of time) (prep)
apa³|but (conj)
apacen|foresight, *(lit.) after-sight (n)
apacendo|seer, prophet (n)
apacenya|of foresight (adj)
apalúmë|future, (lit.) after-time (n)
apanaina-|to regret, (lit.) after-lament (vb)
apanta-|to open, reveal, show, display (vb)
apantië|display, *revealing, ⚠️revelation (n)
apaquet-|to forebode, foretell, predict (vb)
(apa)ruivë|wild fire, fire as conflagration (n)
ruivë|wild fire (n)
appa-|to touch (vb)
appalë|sense of touch, sensation, feeling [physical] (n)
apsen-|to remit, release, forgive (vb)
apta-|to refuse, deny, say nay (vb)
aptaina|cooked, broiled (adj)
apterya-|to repair, fix (vb)
aqua|fully, completely, altogether, wholly (adv)
aquapahtië|privacy, *(lit.) full-closedness (n)
ar|and; ⚠️[ᴱQ., ᴹQ.] but (conj)
ar-|by-, beside, near; ⚠️[ᴹQ.] outside (pref)
ar(a)|beside, next [to], *by; ⚠️out, [ᴹQ.] outside (prep)
ar(a)-|noble, high (pref)
aralussë|aorist, (lit.) beside-tense (n)
aramallë|side-street (n)
aran|king (n)
arandil|king’s friend, royalist (n)
arandur|minister, steward, (lit.) king’s servant (n)
aranel|princess (n)
aranië|kingdom (n)
túrindië|*kingdom (n)
túrinasta|*kingdom (n)
aranisquë|frankincense (n)
ninquima|frankincense (n)
aranta-|to turn over, (lit.) give by (vb)
arantyalmë|chess, (lit.) king-game (n)
aranus(së)|kingship (n)
aranya|*royal (adj)
arasso|hart, stag, (male) deer (n)
arassë|deer, hart, stag (n)
arata|high, noble, exalted, lofty (adj)
arta²|high, noble, exalted, lofty (adj)
arátië|nobility (n)
aráto|champion, eminent man, noble, lord, ⚠️king (n)
arcandë|*petition (n)
arcólima|equivalent, (lit.) beside-bear-able (adj)
arda|region, realm, particular land or region; ⚠️[ᴱQ.] place, spot (n)
ardahyalma|[planetary] crust (n)
arë|beside, along, near (adv)
árë|sunlight, warmth (especially of the sun); ⚠️day (n)
arëa|close, nearby (adj)
árë nuquerna|árë-reversed (n)
ar(i)-|superlative prefix; ⚠️good; [ᴱQ.] intensive (pref)
arimaitë|[most] skillful, *gifted (adj)
árinqua|sunny, (lit.) sunlight-full (adj)
arinwat|breakfast, (lit.) morning-meal (n)
arma|ray of sunlight (n)
armaro|*neighbor (n)
asambar(o)|*neighbor (n)
aromundo|auroch, kine of Araw (n)
arosto|suburb(s), suburbia, outskirts (of city, town) (n)
arpo|seizer, thief (n)
arquen|noble, knight (n)
arquenië|nobility (n)
arra|[unglossed] (adj)
arrongo|right away, promptly, very soon (adv)
arta¹|etcetera (adv)
artanwa|award (n)
artapano|chessboard (n)
artatúrë|government (n)
-arya|*inceptive (suf)
arya|excelling, *better (adj)
arya-|to excel (vb)
aryata-|to improve (vb)
aryë|also, as well, besides, too (adv)
aryonië|inheritance (n)
as|with (prep)
as(a)-|easily (pref)
asa-|to be willing, agree (vb)
aþa-|to be willing, agree (vb)
asahanyë|understandably, of course, (lit.) easily understood (adv)
asalastë|easily heard (adj)
asalsambë|guest-room (n)
asamahte|simple, (lit.) easily handled (adj)
asanótë|*easily counted (adj)
asar|fixed time, festival (n)
asarta|doctor, leech (n)
asar(o)|doctor, leech (n)
ascara|violent, rushing, impetuous (adj)
ascarë|easily done (adj)
ascárima|easy [to do] (adj)
ascénië|obviously, *(lit.) easily seen (adv)
ascénima|visible, easily seen (adj)
ascenë|visible, easily seen (adj)
ásë|aid, benefit (n)
asëa|healing herb, ⚠️athelas (n)
asëa aranion|kingsfoil, asëa of the Kings (n)
asië|ease, comfort (n)
Asiya|Asia (n)
asquétima|easy to say (adj)
asta|month; division, part (esp. one of other equal parts) (n)
asta-|to heat, bake (by exposure to sun) (vb)
astai|whereas, (lit.) beside-that-which (conj)
astaincë|particle (n)
astal|valour (n)
astalda|*valiant; ⚠️strong (adj)
astalda|strong, *valiant (adj)
astamo|member (n)
astar|faith, loyalty (n)
astarindo|bystander; supporter (n)
artarindo|bystander; supporter (n)
astarmo|bystander; witness (n)
asumo|friend at need, friend with shared interests, colleague (n)
aþumo|friend at need, friend with shared interests, colleague (n)
asya-|to ease, assist, comfort (vb)
asyar|assistant (n)
at-|to catch, capture (vb)
at(a)-|double, [repeat a] second time; [ᴱQ.] bi-, twi-; [ᴹQ.] back, again, re- (pref)
atacar-|to revenge, (lit.) back-make (vb)
atacarmë|vengeance, reaction (n)
ataformaitë|ambidextrous (adj)
atahenta-|to revise, (lit.) re-examine (vb)
atalantë|collapse, downfall (n)
atalantëa|ruinous, downfallen (adj)
atamaitë|two-handed (adj)
atamenta-|to transmit (vb)
atamentië|transmission (n)
atamir|heirloom (n)
Atan|Man, (lit.) the Second (People) (n)
atannahtar|man-slayer (n)
atapengëa|bilabial (of consonants) (adj)
ataquanta-|*to refill, fill a second time, double fill (vb)
ataquer|bike, bicycle (n)
atar¹|father (n)
atartil|thumb [nursery rhymes] (n)
atatya|double (adj)
atesta-|to mention (vb)
atomë|atom (n)
atomëa|atomic (adj)
atsinta-|to recognize (vb)
atta|two (cardinal)
attalya|biped, *(lit.) two-footed (n adj)
attëa|second (ordinal)
attië|group of two, couple, pair (n)
attindo|doubt, (lit.) two mind (n)
atto|daddy, father (familiar/family) (n)
atya¹|daddy, (my) father (n)
(a)taryo|daddy (n)
atyo|*daddy (n)
atyenárë|anniversary (n)
au-|away (from) (pref)
au¹|away, off, not here (of position) (adv)
au²|if only (adv)
auca|foolish (adj)
aucelië|sewer, (lit.) away-flowing (n)
aucië|foolishness (n)
aucir-|to cut off (and get rid of or lose a portion) (vb)
aucol-|to remove, (lit.) bear away (vb)
auhanta|refuse, trash, garbage, (lit.) thing thrown away (n)
aulerya-|to rid, free somebody of something (vb)
auma|machine (n)
aumanca-|to sell, (lit.) trade away (vb)
aumapando|abductor, (lit.) away-seizer (n)
aumenta-|to dismiss, divorce, (lit.) away-send (vb)
aumentalë|dismissal, divorce (n)
aupenya|complete, without lack (adj)
auqua|awkward, clumsy ⚠️(of things), difficult (adj)
auquer-|to reject, (lit.) turn away (vb)
aura|possession, thing owned (n)
aurë|day (as opposed to night), daylight, morning; ⚠️sunlight, [ᴱQ.] sunshine, gold light, warmth (n)
aurëa|sunny, sunlit; *daytime (adj)
aurehen|dandelion, (lit.) day-eye (n)
aurië|wealth [in possessions], property (n)
ausa|dim shape, spectral or vague apparition (n)
ausatië|especially, (lit.) setting aside (adv)
aut|fool, clumsy fellow (n)
auta|ago (adv)
auta-¹|to go (away), depart, leave; to disappear, be lost, pass away (vb)
autaila|going, passing, nearly gone (adj)
autas|a former occur[rence] (n)
autulya-|to deport, (lit.) bring away (vb)
autulyalë|deportation (n)
auvië|possession (abstract), *the act of possessing (n)
áva|don’t, negative imperative (particle)
ava-¹|to refuse, forbid (vb)
ava¹|[ᴹQ.] outside, beyond; outer, exterior (adv adj)
ava-²|negation (refusing or forbidden) (pref)
vá-|negation (refusing or forbidden) (pref)
avalatya-|to close, shut (vb)
avalda|move[d], stirred, excited (adj)
awalda|move[d], stirred, excited (adj)
avalerya-|to restrain, to deprive of liberty (vb)
avamarwa|homeless (adj)
avamat-|to fast, (lit.) refuse to eat (vb)
avanev-|to avoid, (lit.) refuse to face (vb)
avanir|unwill (n)
avanwa|refused, forbidden, banned (adj)
avanyárima|unspeakable, what one must not tell, not to be told or related (adj)
avaquétima|not to be said, that must not be said (adj)
avarta-|to abandon (vb)
avatup-|to uncover, expose (vb)
avatyar-|*to forgive, (lit.) do away with (vb)
avëalta-|to resemble closely (vb)
axan|commandment, [divine] law or rule (n)
axanwë|logic, (orig.) law of thought (n)
axanwëa|logical (adj)
axë|neck [vertebrae], *(upper) spine; rock ridge (n)
acas|neck (n)
axo²|neck (n)
axë|steel (n)
axendë|marrow (n)
axína|(of) steel, *like steel (adj)
axo¹|bone (n)
axosta|skeleton (n)
axula|bony (adj)
áya|awe (n)
cacanna-|to announce repeatedly, herald, propagate, advertise (vb)
cacannalë|advertisement (n)
cacar-|to continue, *keep on doing (vb)
cacarpa-|to chatter (vb)
cacátu-|to design, shape or fashion slowly (vb)
cacáva|cocoa (n)
cahta|cause, motive, reason (n)
caimen|horizontal direction (n)
caimenya|horizontal (adj)
cainu-|to lie down, *bend down; [with locative] to endure, suffer (from) (vb)
caira|eager [to do] (adj)
caita-¹|to lie (down) (vb)
caita-²|*to lay (transitive); [ᴱQ.] to place, ⚠️lie down (vb)
cal-|to shine (vb)
cala|light; ⚠️[ᴱQ.] daytime (sunlight), 12 hours (n)
calaina|serene (adj)
calainë|serenity, ⚠️serene (n)
calambar|*light-fated (adj)
calampa|spoon (n)
calar|lamp (n)
calarus|polished copper (n)
calarwa|optical (adj)
calas|brass (n)
calassina|brazen, *made of brass (adj)
calatengwë|photograph, (lit.) light-writing (n)
calca|glass (n)
cilin|glass [transluscent or reflective] (n)
calcata-|to glaze (vb)
calcëa|glassy, of glass (adj)
cálë|light (n)
calima|bright, luminous (adj)
calina|light, bright, sunny, (lit.) illumined (adj)
callë|fair weather, clear sky, blue sky (n)
calleva|fair (weather or complexion) (adj)
callië|heroism (n)
callovëa|heroic, hero-like (adj)
calma|lamp, (device for shining) light, ⚠️[ᴱQ.] candle; (day)light (n)
calmatan|lampwright (n)
calmatarma|lampstand (n)
calmatéma|k-series (n)
calta|picture, photography (n)
calta-|to kindle, [ᴹQ.] (cause to) shine, light up, [ᴱQ.] set light to (vb)
calwa|lurid (adj)
cáma|guilt, responsibility (n)
cámalóra|innocent (adj)
cámayanca|guilt-offering (n)
camba|(cupped) hand, hollow of the hand (n)
cambë|(hollow of) hand (n)
cambie|profit, gain, intake, income (n)
camma|receptacle (n)
campo|flea (n)
camtanë|adaptation (n)
camya-|to contain, hold (vb)
can-|to claim, demand (when applied to things) (vb)
cána|backward (adv)
ca(na)sta|one fourth, *quarter (fraction)
cansat|one fourth (fraction)
candóla|crown of head (n)
canguru|kangaroo (n)
cáno|commander, chief(tain), ruler, governor; †crier, herald (n)
canquain|forty (cardinal)
canaquain|forty (cardinal)
canaquëan|forty (cardinal)
canquë|*fourteen (cardinal)
canaquë|*fourteen (cardinal)
canquëa|fourteenth (ordinal)
canaquëa|fourteenth (ordinal)
canta-|? (vb)
canta¹|four (cardinal)
canta²|shape, framework, [ᴹQ.] frame; shaped (n)
cantallumë|four times (adv)
cantalya|four-legged, quadruped, (lit.) four-footed (adj n)
cantëa|fourth (ordinal)
cantemma|shaped image, sculpture (n)
cantië|pattern (n)
cantil|quadrangle, *quadrilateral, rectangle, square (n)
cantilya|quadrangular (adj)
canton|soapstone, (lit.) sculpted rock (n)
canu|lead [metal] (n)
canuina|of lead (adj)
canuva|leaden (adj)
canwa¹|announcement, order (n)
canwahimië|obedience (n)
canwacimië|obedience (n)
canwahimya|obedient (adj)
canwacimya|obedient (adj)
canya-|?to command (vb)
capaitë|leaping, bounding (adj)
capanda|jump (n)
capië|leap, ⚠️deep gorge (n)
capta-|to make spring, scatter; [ᴱQ.] to startle, ⚠️leap (vb)
car|act, an action (n)
car-|to do, make, ⚠️[ᴹQ.] build (vb)
caraitë|active, busy; ⚠️[ᴹQ.] able to make, handy, crafty, craftsmanlike, skilled (adj)
caraitië|activity, business (n)
caras|lettuce (n)
carassë|built fort or dwelling surrounded by bulwarks (n)
carasta|making, manufacture, construction (n)
carasta-|to build, construct (vb)
carastanyarro|beaver, (lit.) build-rat (n)
caraxë|[ᴹQ.] jagged hedge of spikes, [ᴱQ.] row of spikes or teeth (n)
carca|fang, [ᴹQ.] tooth, [ᴱQ.] tusk; ⚠️[Q.] rock (n)
carcapolca|boar, *(lit.) tusk-pig (n)
carcara|toothed (adj)
carcaran|crocodile, (lit.) toothed-beam (n)
carcasarma|large saw (n)
carda|deed, *action (n)
carma³|deed (n)
-carë|action, doing, making (suf)
carië|doing, making (n)
cariendë|production, process of manufacture (n)
cárima|feasible, possible (to do), able to be done, [ᴹQ.] able to be made (adj)
carina|done, [ᴹQ.] made, [ᴱQ.] finished (adj)
cariquetta|verb (n)
carma¹|helm (n)
carma²|tool, implement, means, weapon (n)
carmatan|toolsmith (n)
carmë|production, making; structure; ⚠️art (n)
carmen|recipe (n)
carnë|red, scarlet (adj)
carniambos|robin, (lit.) red-breast (n)
carpa|(entire) mouth; phonetic system (n)
carpa-|to talk, speak, use tongue (vb)
carpalos|tulip, (lit.) hat-flower (n)
carpassë|mouth-system; full organized language, including system, vocabulary, metre, etc. (n)
carpë|hat (n)
carpo|frog (n)
carranta|strategy, (lit.) action-course (n)
carrëa|tressure, *headdress (n)
-carya|-doing (suf)
cas|head, [ᴱQ.] top, ⚠️summit (n)
cára|head (n)
Casar|Dwarf (n)
cas(ta)|to(wards) the top, upwards (adv)
castëa|top (with added sense of prominent, chief) (adj)
castol(o)|helmet (n)
castor|beaver (n)
cat-|to shape, fashion (vb)
ca(ta)|behind, at back of place; [ᴹQ.] after (prep)
ca|behind, at back of place (prep)
cana|behind, at back of place (prep)
catamen|background, milieu (n)
catassa|anus, arsehole, (lit.) behind-hole (n)
catta|back (n)
cauma|protection, shelter, shield (n)
cav-|to receive, *accept, ⚠️require, cost (vb)
cam-|to receive (vb)
cávima|acceptable (adj)
-cca|your (dual) (suf)
-xa|your (dual) (suf)
-ccë|you (dual) (suf)
-xë²|you (dual) (suf)
cé¹|may (be) (adv)
cëa|*hedge (n)
cecenna-|to visit (vb)
cecet|pheasant (n)
cehtecet|clucking (n)
céla|maybe not (adv)
céla|maybe not (adv)
celeta|trickle (n)
celima|fluent, *(lit.) able to flow freely (adj)
celu|source, origin (n)
celumë|flow(ing), stream, flood (tide); ⚠️[ᴱQ.] fountain, spring (n)
celundë|welling forth (n)
celussë|freshnet, water falling out swiftly from a rocky spring (n)
celusta|outflow (n)
celuva|original (adj)
celva|animal, living thing that moves (n)
celvacir|butcher (n)
cuimacir|butcher (n)
celvamatta|animal food (n)
celvamatya|carnivorous, (lit.) animal-eating (adj)
celvatarwa|zoo, (lit.) life-garden (n)
celvavëa|animal-like (adj)
celvë|hind, deer, doe (n)
celwë|spring, source (n)
cemen|the earth; earth, [ᴹQ.] soil (n)
cemendur|farmer (n)
cemenquasië|earthquake (n)
cempalië|earthquake (n)
cemië|chemistry (n)
cemievëa|chemical (adj)
cemma|picture, (lit.) something seen (n)
cemnassë|earthenware, pottery (n)
centánië|ceramics, pottery-craft (n)
cemorva|potato, (lit.) earth-apple (n)
cen|sight, *sense of sight (n)
cen-|to see, behold, look, *perceive (vb)
cenai|if it be that (conj)
cenasta|if it be so, may be, perhaps (adv)
cenasit|if it be so, may be, perhaps (adv)
cenda|inspection, reading (n)
cenda-|to watch (intensively), observe (for some time); to read (vb)
cendë|point (n)
cendelë|face, *visage (n)
canwa²|face (n)
cénë|sight (n)
cénima|visible, [ᴹQ.] able to be seen (adj)
ceniril(lë)|mirror (n)
cenítë|seeing, *able to see (adj)
cennassë|pottery, ceramic vessel (n)
centa|enquiry, *essay (n)
cenwa|?reading (n)
cenya|*seeing (adj)
cenya|*seeing (adj)
Cermië|July (n)
cermië|harvest (n)
certa|rune (n)
ces-|to search, examine (in order to find something) (vb)
cesië|search (n)
cesta-¹|to seek, search for (vb)
cesta-²|to ask (vb)
cesula|inquisitive, curious (adj)
cesya-|to cause interest, interest (oneself), (lit.) to cause one to enquire (vb)
cesyarë|interest (n)
cesyarëa|interesting (adj)
cesyalima|interesting (adj)
cetta-|to witness (vb)
ceula|?alive (of vegetable) (adj)
ceulë|*renewal (n)
ceura|renewed (adj)
ceurë|renewed (adj)
ceuran|new-moon (n)
ceuranar|new sun after solstice (n)
ceuta-|to renew, refresh (vb)
céva|fresh, new, ⚠️renewed (adj)
ceu|fresh, new, (adj)
cil-|to choose, select (vb)
cilintilla|looking-glass, *mirror (n)
cilintír|looking-glass (n)
cilinyul|drinking-vessel (made of glass) (n)
cilmë|choice, choosing, *selection (n)
cilmessë|self-name (n)
cilometer|kilometer (n)
cilta-|to divide, separate (vb)
ciltië|division, separation (n)
címa|edge of a cutting weapon/tool (n)
cimba|edge, brink (n)
cimba-|to care (vb)
címëa|edged (adj)
cílëa|edged (adj)
maicëa|edged (adj)
ciminqua|attentive, heedful (adj)
Cimrinórin|Welsh (n)
cinta|small (adj)
cir-|to cut, [ᴱQ.] cleave; *to separate from (vb)
circa|sickle (n)
cirda|splinter, wood shaving (n)
cirihta-|to reap, harvest (vb)
cer-|reap (vb)
cirihtor|reaper (n)
cerihtando|reaper (n)
cirincë|scarlet-plumed species of bird (n)
cirma|knife (n)
cirmacin|knife-edge (n)
cirya¹|(sharp-prowed) ship, [ᴹQ.] boat; [Q.] swift gliding (n)
cirya²|cleft, pass (n)
ciryamo|mariner (n)
ciryampa|anchor, (lit.) boat-hook (n)
ciryando|sailor (n)
ciryapanda|haven, (lit.) ship-enclosure (n)
ciryaquen|shipman, sailor (n)
ciryasta|fleet (of ships) (n)
(cirya)talan|deck (of a ship), main deck (n)
ciryatan|shipbuilder, shipwright (n)
cíta-|to suppose (vb)
citya-|to tickle (vb)
cityalë|tickling (n)
cityalëa|ticklish, susceptible, sensitive (adj)
ciuca|*thigh (n)
cyúca|*thigh (n)
cöa|house; outhouse, shed, hut, booth; building used for a dwelling or other purposes; †body (n)
cöacalina|light of the house, indwelling spirit (n)
cöacolindo|snail, (lit.) house-bearer (n)
cöantur|householder, master of the house (n)
coilemma|fossil, biological artifact/relic (n)
coimas|life-bread, lembas (n)
lerembas|bread taken on leaving home (for a long journey) (n)
coimen|life-year (n)
coina|alive, ⚠️living (adj)
coingolmë|biology (n)
cuingolmë|biology (n)
coirë|stirring, early spring; ⚠️[ᴱQ.] life (n)
coirëa|living, ⚠️[ᴱQ.] lively, alive (adj)
coita-|[ᴹQ.] to live, be alive, have life (vb)
coiva|lively, ⚠️living; awake (adj)
coivenqua|lively, vibrant, vivacious, (lit.) full of life (adj)
coivië|life, [ᴱQ.] liveliness; ⚠️awakening (n)
coivë|life (n)
cuivië²|life (n)
col-|to bear, carry, wear (vb)
colba|*womb (n)
colbanavië|gestation, *(lit.) womb-being (n)
colbamarië|gestation, *(lit.) womb-residence (n)
colca|box (n)
colcallë|phylactery, (lit.) little box (n)
cólë|passivity, endurance, patience; a passive individual (n)
cólema|patience, endurance; hardship (n)
cólemaina|patient (adj)
cóleva|passive (adj)
cólima|bearable, light (of burdens and things comparable, troubles, labors, afflications) (adj)
colindo|bearer (n)
colla|borne, worn; vestment, cloak (adj n)
collo|cloak (n)
colma|stretcher (n)
cólo|burden (n)
coloitë|capable of bearing, tolerant (of), enduring (adj)
coloitië|endurance, staunchness, fortitude (n)
colonda|burdened, weighed down, sad (adj)
colosta|cucumber (n)
colta-|to lade, burden, weigh down (vb)
colucë|strainer (n)
cómë|file (n)
comya-|to collect (vb)
conta-|[unglossed] (vb)
coranar|(solar) year, (lit.) sun-round (n)
corda|temple (n)
cordamo|cleric (n)
cordon|idol (n)
corma|ring (n)
cornë|loaf (n)
coro|around (prep)
coron|mound; [ᴹQ] globe, ball (n)
corpë|skull (n)
caraxo|skull, *(lit.) head-bone (n)
coropë|skull (n)
corta-|to roll up, roll, pack (vb)
cortangwa|button, (lit.) circle-fastener (n)
corto|circle (n)
costaima|debatable (adj)
costë|quarrel, dispute; legal action (n)
costula|quarrelsome, belligerent (adj)
cotto|*enemy (n)
notto|*enemy (n)
cotwë|struggle, wrestling (n)
cucuollë|turtledove (n)
cuilórë|day-dream, (lit.) awake-dream (n)
cuilórëa|absent-minded, (lit.) day-dreamy (adj)
cuima|creature, animal (n)
cuiva|animal (n)
cuina-|to live, be alive (vb)
cuiru-|to stir (to wakefullness) (vb)
cuita-|to waken, rouse; ⚠️to live (vb)
cuita-|to live (vb)
cuitar|alarm, device to waken somebody (n)
cuiva|awake (adj)
cuiva-|to awake (vb)
cuivië¹|awakening (n)
cuivë|awakening (n)
cullingwë|goldfish (n)
culmírë|sardius, carneol [carnelian], (lit.) orange-jewel (n)
culumalda|laburnum, *(lit.) orange-tree (n)
culvelyávë|pumpkin (n)
cúma|[unglossed] (n)
cumbo|belly (n)
cumya-|to empty (vb)
cúna|bent, curved (adj)
cúna-|to bend (vb)
cundo|lord, guardian, [ᴹQ.] prince (n)
condo|lord (n)
cúnë|crescent, arch, ⚠️bow (n)
cungandë|violin, (lit.) bow-harp (n)
cunya-|to rule, *govern, reign over (vb)
cunya-|to rule (vb)
cunta-|to rule (vb)
cupta|deception, lie (n)
cupta-|to deceive, lie (vb)
cuptalë|deception, deceit (n)
hurulë|deception (n)
cuptamo|liar, deceiver (n)
enwacuvindo|liar, cheater (n)
hurindo|liar (n)
curo|skillful (?device) (n)
curu|skill; ⚠️[ᴱQ.] magic, wizardry (n)
curuni|witch, *sorceress, female magician (not necessarily evil) (n)
curwa|cunning, skillful (adj)
curwë|[ᴹQ.] craft, [Q.] skill of the hand, technical skill and invention (n)
curwesta|technology (n)
curya|potent, powerful, strong (as function of craft or cunning) (adj)
cuv-|to conceal, *hide (vb)
cúvima|concealable (adj)
cuvo|hider (n)
cuvoitë|hiding, secretive; treacherous (adj)
-da|product of an action (suf)
-e|plural of adjectives (suf)
e|one, (neuter) it; [ᴹQ.] he, she (pron)
Eä|Creation, the (Material) Universe, Cosmos, †World; it is, let it be, [ᴹQ.] all that is (n)
ëa-|to be, exist, [ᴹQ.] have being, be found extant in the real world (vb)
-ëa¹|continuative present (suf)
-ëa²|ordinal suffix (suf)
ëala|spirit (not incarnate), being (n)
ëar|sea, great sea, [ᴹQ.] open sea; ⚠️water (n)
ëarel|starfish, (lit.) sea-star (n)
ëaren|ocean, great sea (n)
eäron|ocean, great sea (n)
ëarendur|(professional) mariner, *(lit.) servant of the sea (n)
Eärenya|Sea-day, *Thursday (n)
ëarina|of the sea (adj)
ëarra|seal, sea lion (n)
ëarsil|pearl, (lit.) sea-sheen (n)
ëassar|pearl, (lit.) sea-pebble/stone (n)
ëasta|existence, being (n)
ec-|to have a chance of; may, can (vb)
ecar|or (conj)
ecca|hole, *lair (n)
eccahta|hawthorn, (lit.) thorn-hedge (n)
eccalda|cactus, (lit.) spine tree (n)
eccan-|to proclaim, assert, (lit.) forth-call out (vb)
eccat-|to fashion, make (vb)
ecces-|to find out, bring out by examining or eyeing[?] (vb)
eccoia|thorny (adj)
eccol-|to export (vb)
eccuinu-|to awake, wake up (vb)
ecellë|urchin, hedgehog (n)
ecesta|opportunity, chance (n)
ecet|short stabbing sword (n)
ef-|to emerge (especially from water) (vb)
ehta-|to stab (vb)
ehtelë|spring, issue of water (n)
ehten|outlook, sight, view, spectacle (n)
ehtipolca|porcupine, (lit.) spike-pig (n)
él|star (n)
ela|behold! (interj)
elanar|pimpernel, (lit.) sun-star (n)
Elda|Elf, (lit.) one of the Star-folk (n)
eldafindë|maidenhair fern, (lit.) elf tress (n)
Eldalië|People of the Eldar, Elven-folk, [ᴹQ.] Elf-folk (n)
Eldarin|of the Eldar; Elvish (language) (adj n)
eldë|you (plural emphatic) (pron)
elecetomacnetëa|electromagnetic (adj)
elen|star (n)
elengolmë|astronomy (n)
elenitsë|firefly, (lit.) star-fly (n)
Elenya|Saturday, *Star-day (n)
elenya|adjective referring to the stars, *of the stars, stellar (adj)
elhíse|nebula, star cloud (n)
élicombë|galaxy, collection of stars (n)
ellumë|once, one time (adv)
elma|wonder, miracle (n)
elma-|to marvel at, admire (vb)
elmë|we (emphatic inclusive), *we (emphatic exclusive) (pron)
elmenda|wonder, wonderment (n)
elmendëa|wonderful (adj)
elp-|to anoint (vb)
elvë|we (emphatic inclusive) (pron)
elvëa|starlike (adj)
elyë|thou (emphatic polite) (pron)
em-|to depict, portray (vb)
emba-|to paint, draw (something) (vb)
embë|painting, drawing (vb)
(e)mecima|accurate, always aiming at the mark (adj)
emel|love [abstract] (n)
emer-|?to herd (sheep) (vb)
emerro|shepherd, herdsman (n)
emerwen|shepherdess (n)
emino|character (in a story) (n)
emma|picture, *image (n)
emmata-|to draw/create (a picture); to photograph (vb)
emmë¹|we (emphatic exclusive), *we (dual emphatic exclusive) (pron)
empatyellë|advancement, progress (n)
en|(then) soon, [ᴹQ.] in that (future) case; there, yonder; look yon(der); ⚠️far away; that, [ᴱQ.] that by you; thereupon (adv)
enya|then soon (adv)
en-|re-, again (pref)
en(a)|still (adv)
enar|tomorrow (n)
entan|tomorrow (n)
-enca|without, -less (suf)
enda|heart; centre, *interior (n)
endaurë|noon, (lit.) mid-day (n)
táranar|noon, (lit.) high-sun (n)
endë|centre, middle; [ᴹQ.] core (n)
entë²|centre (n)
endëa|middle (adj)
endemat|lunch, (lit.) mid-meal (n)
Endëranda|Middle-Ages (n)
enel|in the middle, between (prep)
enelmo|go-between, intervener, intermediary, mediator (n)
enenquë|sixteen (cardinal)
enenquëa|sixteenth (ordinal)
eneques|rumor, (lit.) re-saying (n)
ener(a)|on, onward, further (adv)
engë|ago, in the past, [ᴹQ.] once (in past), †it was (adv)
engwa|sickly (adj)
engwë|thing [that exists] (n)
ennóna|born again (adj)
Ennosta|Renaissance (n)
enortalë|resurrection (n)
enontië|rebirth, resurrection (n)
enquain|sixty (cardinal)
enenquain|sixty (cardinal)
enenquëan|sixty (cardinal)
enquanta-|to refill (vb)
enquë|six (cardinal)
enquëa|sixth (ordinal)
enquellumë|six times (adv)
enquesta|one sixth (fraction)
enquet-|to repeat, say again (vb)
ataquetië|saying again, repetition (n)
enquië|Elvish week of six days (n)
enta|another, one more; [ᴹQ.] that yonder, then (fut.); ⚠️[ᴱQ.] that there (emphatic) (adj)
entë¹|moreover, further(more), what is more; *next (of time or in a sequence) (adv)
entul-|to come again, *return (vb)
entulessë|return (n)
entya|central, middle (adj)
envinyata-|to renew, heal, *restore (vb)
enwina|old (adj)
enyal-|to recall, *remember (vb)
enyálëa|memorial (adj)
enyalië|memory, (lit.) recalling (n)
eo|person, somebody (unnamed) (pron)
epë|after (of time), following; before (in all relations but time) (prep)
opo|before, in front (of place); ⚠️after (of time) (prep)
pó|before, in front (of place); after (of time) (prep)
pono|in front (of place) (prep)
poto|in front (of place) (prep)
epeharmo|president (n)
epello|already (adv)
epemat|dessert, (lit.) after-meal (n)
epemma|example (n)
epessë|after-name (n)
epetai|consequently, thereupon, thence, whereupon, (lit.) following which (fact) (conj)
ep(e)ta|following that, thereupon, thence, whereupon (conj)
potai|*therefore, (lit.) before which (conj)
etta|*therefore, (lit.) out of that (conj)
equë|say, says, said (vb)
eques|saying, (current or proverbial) dictum, quotation from someone’s uttered words, *quote, statement (n)
equi|even if, eventhough, (lit.) indeed-if (conj)
er|one, alone; ⚠️[ᴱQ.] only, a single (adj adv)
erda|solitary, deserted (adj)
erdë|singularity (n)
erdevainë|seed pod, peapod (n)
eressë|[ᴹQ.] solitude; ⚠️[ᴱQ.] alone, by oneself, singly, only; once (n)
eressëa|lonely (adj)
eretildo|unicorn (n)
erië|oneness (n)
erinqua|single, alone (adj)
eritë|singular (adj)
erma|(physical) matter (n)
hrón|matter, substance, flesh; body (n)
orma|(physical) matter (n)
ermaitë|concrete, material (adj)
ermangolmë|study of matter, physics, [possibly also] chemistry (n)
ernóna|only-born, only-begotten (adj)
erta-|to unite (vb)
ertië|union (n)
Eru|The One, God (n)
Erutercáno|prophet, (lit.) God-herald (n)
Eruva|divine (adj)
essar-|to recross (vb)
essë¹|name (n)
esta|outwards (adv)
estat-|to distribute (in even portions), *partition (vb)
etsat-|to distribute in even portions (vb)
estatië|portion, share (n)
estatina|divided, shared, distributed (adj)
estel|hope, trust, *faith (n)
estelenca|hopeless, despairing, desperate (adj)
estelya-|to hope (vb)
estirnë|brow (n)
esto|they (dual emphatic) (pron)
estolië|camp (n)
et|out (of) (prep)
etanta-|to publish, (lit.) out-give (vb)
et(e)-|[ᴹQ.] forth, out (pref)
etehat-|to throw out (vb)
etelehta-|*to deliver (vb)
eterúna-|*to deliver (vb)
etelehto|deliverer (n)
etelelya-|to go out, ⚠️go into exile (vb)
etelenda|exiled (adj)
etelerro|exile (n)
etelesta-|to measure (out) (vb)
etemen-|to go out, go forth (vb)
etementa-|to banish, send out, (lit.) out-send (vb)
eteminya|prominent (adj)
etepanya-|to put out (vb)
etequet-|to confess, speak out (vb)
eterahta-|to reach out (vb)
etevatta-|to trample out (vb)
ethenta-|to read aloud (vb)
etil|ivy (n)
etsatië|especially (adv)
etsen-|to let loose, release, forget (vb)
etserca-|to bleed out, exsanguinate (vb)
etsurya-|to go out (vb)
ettalan|balcony (n)
ettanië|spectacle, (lit.) showing forth (n)
ettë|they (two) (pron)
ettelë|outer fence, encircling fence (n)
ettemo|foreigner (n)
ettir-|to watch out, spy on (vb)
ettirno|spy (n)
ettuc-|to draw out (vb)
etulya-|to pour forth, pour out (vb)
etya|exiled (adj)
etyanetië|hypocrisy (n)
eulë|lamb (n)
evandil|[Christian] missionary (n)
evandilyon|gospel (n)
exanen|otherwise, in an other way (adv)
fá¹|*ray of light, flame (n)
fai|*before of time (adv)
faila|fair-minded, just, generous (adj)
failanta|justified (adj)
failassë|justice, fair-mindedness (n)
failata-|to justify (vb)
failatië|justification (n)
fairë|spirit (disembodied), phantom; †radiance (n)
falampa|whip (n)
falarië|splashing, splash (n)
palastië|splashing (n)
falarya-|to splash, ⚠️foam (vb)
palasta-|to splash, sprinkle (vb)
falassë|(wave-beaten) shore, seashore, line of surf; ⚠️[ᴹQ.] beach (n)
falassëa|coastal (adj)
falasta-|to foam, surge, [ᴱQ.] make a sound like surf (vb)
falma|(crested or foaming) wave, breaker; ⚠️[ᴱQ.] foam (n)
falmaril|aquamarine, (lit.) wave-crystal (n)
falpa-|to flog (vb)
falwa|turquoise, (lit.) pale surf colour (adj)
fana|raiment, veil; (bright) shape or figure; bodily form of an angelic spirit (n)
fána|white; ⚠️[ᴹQ.] cloud (adj)
fánë|white (adj)
fanga|beard (n)
fanorcarnë|sardonyx (n)
fanta-|to veil, cloak, mantle; [ᴺQ.] to muffle (vb)
fantercenya|perspicacious, penetrating of sight or understanding (adj)
fantercenya|perspicacious, penetrating of sight or understanding (adj)
fanto|whale (n)
fanwa|veil, screen (n)
fanwë|vapour, steam (n)
fanya|(white) cloud, white and shining [thing]; ⚠️[ᴹQ.] sky; white (n)
fanyarë|the skies (not heaven or firmament), the upper airs and clouds (n)
fara-|to hunt (vb)
faralë|hunting (n)
Faranconórë|France (n)
farasta|hunting, the chase (n)
farinë|vermin (n)
farnë|️ash, rowan; ⚠️[ᴹQ.] foliage (n)
farta-|to sate, satisfy (vb)
fassalë|(tasseled) fringe (n)
fassëa|shaggy, tangled [hair] (adj)
fassitë|tasseled (adj)
fëa|(indwelling or incarnate) spirit, soul (n)
fëafelmë|*spirit-impulse (n)
fel-|to feel (emotions) (vb)
felca|[unglossed] (adj)
felco|cave, mine, underground dwelling (n)
felehta-|*to excavate, tunnel, mine (vb)
felmë|*emotion, impulse (n)
felminqua|passionate, full of feeling (adj)
felya|mine, boring, tunnel, ⚠️underground dwelling; [ᴹQ.] cave (n)
fendassë|doorway, gateway (n)
fendë|door (n)
fenna|door (n)
fennatir|door-watcher (n)
férima|ready to hand, (quickly) available (adj)
ferya|quick, ready, prompt (adj)
ferya-|to make ready (promptly), *prepare (vb)
feuna|abhorred, aghast (adj)
fifíru-|to slowly fade away (vb)
filiculumpe|ostrich, (lit.) sparrow-camel (n)
filincë|finch (n)
fillannë|sack-cloth (n)
filquë|fern (n)
fimbë|slender, *thin (adj)
finca¹|clever (in petty ways), *tricky (adj)
finca²|[unglossed] (n)
finda¹|having hair, -haired (adj)
finda²|fine and delicately made (adj)
findë|hair (especially of the head); tress or plait of hair, [ᴹQ.] braid of hair (n)
findelë|tress, lock [of hair] (n)
findessë|head of hair, person’s hair as a whole (n)
findilë|head of hair (n)
findimaitar|barber, hairdresser (n)
findori|barley (n)
finë|(single) hair, filament (n)
fínë|dexterity (n)
finëa|downy, hairy [specifically fine, light hair] (adj)
fínëa|dexterous (adj)
finië|cunning (n)
finta-|to make, finish off, decorate a thing with delicate work; to show skill (vb)
fintalë|trick (n)
fintemótalë|industry, (lit.) making toil (n)
finwa|️dexterous, clever; fine, delicate; ⚠️[ᴱQ.] acute, sagacious (adj)
finya|clever (adj)
finya-|to do/make a thing (with fine work) (vb)
finyalë|cleverness (n)
fir-|to die, fade, †expire, breathe forth (vb)
fírië|death (of Men), *natural death (n)
effírië|death (n)
fírima|mortal, *(lit.) able to die (adj)
firinga|necklace, carcanet (n)
firya|[ᴹQ.] human; [Q.] mortal (adj)
fisica|physics (n)
fó|nay, no (interj)
föa|breath, puff of breath (n)
fá²|breath, puff of breath (n)
föalócë|*breath-dragon (n)
Foinicer|Phoenicians (n)
Foralcar|aurora, (lit.) northern radiance (n)
forma|right-hand (n)
formaitë|righthanded, ⚠️dexterous (adj)
formen|north, [ᴹQ.] right-hand [direction] (n)
forna|northern (adj)
fornúmen|northwest (n adj)
fornúna|northwestern (adj)
forrómen|northeast (n adj)
forróna|northeastern (adj)
hac-|to squat (vb)
hac-|to yawn (vb)
hácala|yawning (adj)
hacca|the hams, buttocks (n)
hahta|fence, hedge (n)
haila|far beyond (adj)
hailë|removal, distancing (n)
haimëa|habitual, ⚠️cultural (adj)
haimelë|culture (n)
haimelëa|cultural (adj)
hairië|distance, (lit.) farness (n)
haita-|to remove, (lit.) make distant (vb)
hala|cast shadow, *shade (n)
ixal|cast shadow (n)
halla|tall (adj)
halda|tall; [ᴱQ.] wide, broad (adj)
hamna|pile, (artificial) mound, [ᴹQ.] heap (n)
hampa|restrained, delayed, kept (adj)
hampë|clothing, garment (n)
han|beyond (prep)
han-|*back as an answer or return by another agent (pref)
handelóra|witless (adj)
hando|big brother, ‘big bro’ (intimate) (n)
háno|brother (n)
hanno|brother (diminutive) (n)
hanquenta|answer, *response (n)
hanquet-|to answer, *respond (vb)
nanhanquet-|to answer back (vb)
nanquet-²|to answer (vb)
endaquet-|to answer (vb)
tóquet-|to answer (vb)
aquet-|to answer (vb)
hanta-|to thank, give thanks (vb)
hantalë|thanksgiving (n)
hanúrë|manliness, masculinity (n)
hanusta|monastery (n)
hanustar|monk (n)
hanúva|doughty, *manly (adj)
hanúvië|manhood, doughtyness (n)
hanwa|seat, *chair (n)
hap-¹|to bind, restrain; ⚠️to retain, keep, detain (vb)
hap-²|to clothe, enfold (vb)
hapta-|to eject, ejaculate (vb)
hapya-|to delay, retain, keep (temporarily) (vb)
har-|to sit, stay, [ᴱQ.] remain; ⚠️[ᴹQ.] to dwell, abide, reside (vb)
haranyë|century (100 years) (n)
harivë|closely, nearly (adv)
harma|treasure, [ᴹQ.] treasured thing (n)
harnalasse|schadenfreude, malicious enjoyment derived from observing someone else’s misfortune, (lit.) wound-joy (n)
harnalë|harm, damage (n)
harno|possessor (n)
haru|grandfather (n)
haru-|to sit down, take a seat (vb)
haruni|grandmother (n)
harya-|to have, [ᴹQ.] possess (vb)
hasa-|to treat (medically), (help to) cure; to treat kindly, make easy (vb)
hasaino|patient, (lit.) medically treated one (n)
hasarë|medicine (n)
haswa|medicine (n)
hasarëa|medical (adj)
hasiendë|therapy, a process of treating medically (n)
hassë|little brother, ‘lil bro’ (intimate) (n)
hasta-|to mar (vb)
hastaina|marred (adj)
χarina|marred (adj)
harina|marred (adj)
sahta|marred (adj)
hastalë|corruption (n)
hastima|corruptible (adj)
hat-|[ᴱQ.] to hurl, fling, *throw (vb)
hatal|spear, *javelin (n)
hatar|thrower (of spears and darts) (n)
hatta|missile (n)
haura¹|huge (adj)
haura²|hoard, store (n)
hauro|wardrobe, cupboard, piece of furniture used for storing (n)
hausta|nest (n)
aiwestë|bird’s nest (n)
háva|[unleavened] bread (collective) (n)
havar|a loaf or cake of [unleavened] bread (n)
havarcë|cookie (n)
hayassë|distance (n)
heca|be gone!, stand aside! (vb)
hecil|one lost or forsaken by friends, waif, outcast, outlaw (n)
hecile|one lost or forsaken by friends, waif, outcast, outlaw (f.) (n)
hecilo|one lost or forsaken by friends, waif, outcast, outlaw (m.) (n)
hecima|special (negative) (adj)
heconna|child born out of wedlock, bastard (n)
hehta-|to put aside, leave out, exclude, abandon, forsake (vb)
hehtar|renegade (n)
hel-|to freeze (of water) (vb)
helca|icy, ice-cold (adj)
helcelmë|glacier; (lit.) frozen flow (n)
heldassë|nakedness (n)
helet|fur, fur-coat (n)
helexë|hail (n)
helillos|wisteria, (lit.) purple cluster (n)
helin|pansy (n)
helina|frozen (adj)
helinillë|violet [flower] (n)
helinillëa|*violet [colour] (n)
helinquila|mauve (n)
helinwa|of pansies; (of colour) a blue-violet (n)
helissar|amethyst (n)
mirumírë|amethyst, (lit.) wine-jewel (n)
Hellenórë|Greece, Greek people (n)
helmolpë|wine-skin, (lit.) skin-bottle (n)
helmunquë|wrinkle, (lit.) skin-hollow (n)
helquir|ice cream (n)
helta-|to strip, bare, peel; to despoil, denude (vb)
hempa|cord (n)
hen|eye (n)
henca|rare (as opposite of dense) (adj)
hencalcat|eye-glasses, spectacles (n)
hencúne|eyebrow, (lit.) eye-arch (n)
hendelë|window (n)
hendelúpea cecet|peafowl, (lit.) eye-plumed pheasant (n)
hendumaica|sharp-eye[d] (adj)
henet|window (n)
henfanwa|eye-screen, veil upon eyes (n)
henta-|to eye, examine, read, scan (vb)
hententa-|to spot with eye (vb)
hentië|reading (n)
hentópa|eyelid (n)
hep-|to keep (vb)
hequa|leaving aside, not counting, excluding, except (prep adv)
héramat|main course, (lit.) chief meal (n)
herca|or (conj)
hérë|lordship (n)
heren|order, *association (n)
heri|lady (n)
hérincë|*little lady (n)
hérosto|capital city (n)
heru|lord, master (n)
hér|lord (n)
heru-|to lord it over, be master of, own, [ᴱQ.] rule (vb)
herulatsë|estate, domain (n)
herwa|lordly (adj)
hes|*sibling (n)
hessa|withered, ⚠️dead (adj)
hesta-|to wither (vb)
hesta(lë)|the nearest consanguinity (n)
hexan|toilet, lavatory (n)
satyasambë|privy, lavatory (n)
hí|here (adv)
hildë|heir, follower; ⚠️[ᴱQ.] child (n)
hilië|following (act of) (n)
hilmë²|following (act of) (n)
hilmë¹|offspring, *descendant (n)
hilyalë|succession, dynasty (n)
híma|sticky, viscous (adj)
himítë|clinging, sticking, (lit.) able to stick on; persistent, chronic (adj)
himítië|compliance (n)
himta-|to make stick, attach (vb)
himyalë|connection (n)
hína|child (n)
hindë|[unglossed] (n)
hindo|[unglossed] (n)
sén|child (n)
hinta-|to adopt (vb)
yenta-|to adopt (a daughter) (vb)
yentarë|adoptive mother (for a daughter) (n)
yentaro|adoptive father (for a daughter) (n)
yonta-|to adopt (a son) (vb)
yontarë|adoptive mother (for a son) (n)
yontaro|adoptive father (for a son) (n)
hir-|to find (vb)
hirdë|entrails, bowels (n)
hísë|mist, [ᴹQ.] fog, [ᴱQ.] haze; ⚠️dusk; bleared (n)
hísëa|misty (adj)
hísië|mist, mistiness (n)
hísilanya|mist thread, grey elvish rope (n)
Hísimë|November, *Misty-one (n)
hisquë|smog (n)
hiuma|hint, clue (n)
hlaimar|hospital (n)
hlaiwa|sickly, sick, ill (adj)
hlapil|flag (n)
hlappo|dress, (lit.) flying cloth (n)
hlapu-|to blow, fly or stream in the wind (vb)
hlar-|to hear (vb)
hlaraitë|able to hear (adj)
hlárerya|hearing (ability) (n)
hlarië|hearing (n)
hlarindo|hearer (n)
hlarma|earpiece, receiver (n)
hlas|ear (n)
hlimbë|sliding, gliding, slippery, sleek (adj)
hlintë|fluff, down, soft stuff (adj)
hlit-|to speed swiftly, race, dash, hurtle (vb)
hlívë|sickness, *disease (n)
hlöa|flood, fenland (n)
hlöa|flood, fenland (n)
hlócë|reptile, snake, serpent, worm, *lizard; [ᴹQ.] dragon (n)
lócë²|snake, serpent (n)
hloima|poison, poisonous substance (n)
hloirë|venom, poison, poisonousness (n)
hloirëa|venomous, *poisonous (adj)
hloita-|to poison, envenom, fill with poison (vb)
hlón(a)|noise, sound; *phone (in linguistics), speech sound (n)
hlónemma|phoneme (n)
hlonitë|phonetic (adj)
hlonaitë|phonetic (adj)
hlonta-|to boom, bang, make (loud) noise (vb)
hluc-|to swallow (vb)
hlunco|pharynx, gullet (n)
hlussa-|to whisper (vb)
hlussë|whispering sound, *whisper (n)
hlúvo|greasy, fat (adj)
lúvo|greasy, fat (adj)
hó|owl (n)
hó-|away, from, from among (pref)
höa|big, large (adj)
höahan|big brother (informal/familiar) (n)
höanet|big sister (informal/familiar) (n)
höassë|size (n)
hócilmë|example, outtake, selection, representative item (n)
hócir-|to cut off (so as to have or use a required portion) (vb)
holdë|[unglossed] (n)
holla|?shut (adj)
holma|?shut (adj)
hollë|shout (n)
hollo|cock, cockerel, rooster (n)
holmo|sincerely, heartily; *(lit.) from the heart (adv)
holtu-|to call out, *shout (vb)
holya-|to shut, close (vb)
holta-|to shut, close (vb)
holyë|hen (n)
homanca-|to buy (vb)
hón|heart (physical organ) (n)
honda|hearted (adj)
hondacil|belladonna, (lit.) heartsbane (n)
hondo|(seat of the) deepest feelings (n)
hont|sneeze (n)
hontompa|heartbeat (n)
hontossë|loud sneeze (n)
horina|driven under compulsion, impelled (adj)
horna²|driven under compulsion, impelled (adj)
hórista|citation, quotation, (lit.) something cut out (n)
horna¹|uneven, rough; rude (adj)
hornië|roughness; rudeness (n)
hosta-|to gather (hastily together), collect, assemble, pile up (vb)
hostaitë|able to gather (adj)
hototyossë|a cough and a sneeze (n)
hotsë|army, band, troop (n)
hótul-|to come away (vb)
hotya-|to sneeze (vb)
hrai-|hard, *difficult (pref)
hrai(a)¹|difficult, awkward, ⚠️stiff (adj)
hrai|awkward, difficult, stiff (adj)
hrai(a)²|easy (adj)
hraicénima|scarcely visible, hard to see (adj)
hraicenë|scarcely visible, hard to see (adj)
hrainotë|*hard to count (adj)
hraitasta|detail (n)
hrambundo|bison, gaur, wisent, buffalo (lit. wild ox) (n)
hranga|awkward, difficult, stiff, hard (adj)
hranga-|to thwart (vb)
hrangwë|problem, difficulty (n)
hráva|wild, savage, [ᴹQ.] untamed (adj)
hróva²|savage, wild (adj)
hravan|wild beast (n)
hravanda|wilderness (n)
hrávë|flesh (n)
hrávëa|fleshly, carnal (adj)
hresta|beach, shore (n)
hríma|edge, hem, border (n)
hris-|to snow (vb)
hriz-|to snow (vb)
hrisya-|to snow (impersonal) (vb)
hrissë|fall of snow (n)
hristil|snow (?peak) (n)
Hristondur|Christian, (lit.) Servant of Christ (n)
hritya-|to achieve, accomplish (n)
hrívë|winter (n)
hröa|body, bodily form, ⚠️flesh; physical matter (n)
hrondo|(physical) body, corporeal form (n)
hröafelmë|*body-impulse (n)
hröaloica|cripple (n)
hröangolmë|lore of the body and arts of healing (n)
hröava|corporeal, bodily (adj)
(h)róna|eastern, east (adj)
róna|east (adj)
hróta|dwelling underground, artificial cave or rockhewn hall (n)
hru-|evil- (pref)
ru-|evil- (pref)
hrúcarë|evil-doing (n)
rúcare|evil-doing (n)
hrúcen|envy, (lit.) evil-sight (n)
hrúfinta-|to cheat (vb)
hruhirdië|dysentery (n)
hrundav-|to condemn (vb)
undav-|to condemn, damn, convict (vb)
hruo|*wickedness (n)
hrupuhta-|to fornicate (vb)
úpuhta-|to fornicate (vb)
hrupuhtië|fornication (n)
úpuhtalë|fornication (n)
hrupuhto|fornicator (n)
hrú(y)a|evil, wicked (adj)
hú|hound (or ?heart) (n)
hó|hound (or ?heart) (n)
huar|wild dog, jackal (n)
huarda|pack (of dogs, wolves) (n)
huinë|gloom, (unrelieved) darkness, deep shadow, ⚠️night shade; dark (as a substance) (n)
huiva|murky, *(nearly) lightless (adj)
húmë|thousand; †great number (cardinal)
mencë|thousand (cardinal)
húmeter|kilometre, km (n)
húna|cursed, accursed (adj)
hundo|thunder (n)
hundu-|to thunder (vb)
fundu-|to thunder (vb)
húni|bitch, *female dog (n)
huolë|litter (of pups, cubs, etc.) (n)
hurumo|imposter (n)
húta-|to curse (vb)
hwandasar|pumice, (lit.) sponge-stone (n)
hwarrissë|blizzard, (lit.) blowing fall of snow (n)
hwarwa|violent wind (n)
hwá|violent wind (n)
hwermë|gesture-code (n)
hwesta|breeze; [ᴹQ.] breath, puff of air (n)
hwestalauca|vapour (n)
hwestalaucata-|to vapourize (vb)
hwesta sindarinwa|Grey-elven hw (n)
hwinda|mad, crazy (adj)
hwindë|birch (n)
hwinquetë|confused talk, nonsense (n)
hwinta-|to mix, stir; to confuse (vb)
hwintaila|confusing (adj)
hwinima|confusing (adj)
hwinwaiwa|whirlwind (n)
hya¹|or (conj)
hela|*other than (conj)
hya²|other thing (pron)
hyal-|to ring, resound (vb)
hyalin|paper (n)
hyallë|otherwise, another way, differently (adv)
hyalta-|to strike, make ring (vb)
hyam-|*to pray (vb)
arca-|*to petition, ⚠️pray (vb)
hyamië|prayer (n)
hyermë|prayer (n)
kyermë|prayer (n)
hyan-|to injure (vb)
hyana|other (adj)
exa|other (adj)
hyanda|harm, damage (n)
hyando|cleaver, [ᴹQ.] hewer (sword) (n)
hyanda|pressed mass, crowd, [ᴹQ] throng (n)
hyarna²|compact, [ᴹQ.] compressed (adj)
hyanna|compact, [ᴹQ.] compressed (adj)
hyano|rather (adv)
hyapalle|slipper, (lit.) little shoe (n)
hyaqui|or else, otherwise (conj)
hyar|plough (n)
hyar-|left-hand, south (pref)
Hyaralcar|aurora, (lit.) southern radiance (n)
hyarehtë|halberd (n)
hyarma|left hand (n)
hyarmen|south, (lit.) left-hand direction (n)
hyarna¹|southern (adj)
hyarnúmen|southwest (n)
hyarnúna|southwestern (adj)
hyarrómen|southeast (n)
hyarróna|southeastern (adj)
hyassë|rushing noise, *rustling (n)
hyasta-|to rush, rustle (vb)
hyasta-²|to hack through (vb)
hye|other person, him (the other) (pron)
exe|the other (n)
hé|other person, him (the other) (pron)
hyólamo|trumpeter (n)
hyuxo|hiccup (n)
í-|e-, a prefix for electronic things like e-book (pref)
-i¹|general plural for nouns (suf)
i¹|the (article)
in|the (article)
-i²|simplest aorist infinitive (suf)
i²|who, what, which, that (pron)
iasintë|hyacinth (n)
-ië¹|abstract noun, adverb (suf)
-tië|verbal suffix (suf)
-ië²|gerund suffix, -ing (suf)
-ië³|perfect suffix (suf)
-iel|-daughter; feminine suffix (suf)
-ien¹|feminine ending; ⚠️feminine patronymic, -daughter (suf)
-ien²|-land (suf)
ier|*as (prep)
il-|every, *all (pref)
-(i)la|active participle (suf)
-la|active participle (suf)
ilaurëa|*daily (adj)
ilyarëa|*daily (adj)
ilca-|to gleam (white) (vb)
ilcaxo|ivory, (lit.) gleam bone (n)
ilcë|you (plural emphatic) (pron)
ildomë|everywhere (pron)
ilimba|milky (adj)
ilin|milk (n)
illangiéla|nevertheless, (lit.) all-having-been-bypassed (adv)
illi|all (n)
illië|public (n)
illöa(va)|annual, yearly, per annum (year as item) (adj adv)
illómëa|nightly (adj)
illumë|*always (adv)
ilquárëa|general (adj)
ilquen|everybody, *everyone (pron)
iltana-|to prove, demonstrate (vb)
tyapta-|to prove (vb)
ilu|everything, all, the whole; [ᴹQ.] universe, ⚠️world; [ᴱQ.] ether (n)
iluasta|omnipresence (n)
ilucara|omnificent (adj)
iluisa|omniscient (adj)
ilúvala|omnipotent (adj)
ilúvë|the whole, the all, allness; ⚠️[ᴹQ.] universe, world; Heaven (n)
ilúvëa|universal (adj)
ëavëa|universal, natural (adj)
ilvan(y)a|perfect (adj)
ilya|every, each, all (of a particular group of things), [ᴹQ.] the whole (adj)
ilyë|all (adj)
im-|same (pref)
-ima|-able, [ᴹQ.] -ible, able to be done, [ᴱQ.] possible; [with short base vowel] *having a (strong) nature of (suf)
-tima|*-able (suf)
imbacindë|harlot (n)
imbalandë|equality (n)
imbë¹|between, among; ⚠️[ᴹQ.] in(wards) (prep adv)
imbë²|deep valley, (wide) ravine, [ᴹQ.] glen, dell, (lit.) tween-land (n)
imbenatsë|internet (n)
imberaima|internet (n)
imbilat|*deep valley (n)
imíca|among (prep)
mica|*among (prep)
mici|among (prep)
imirë|crystal (n)
imirin|of crystal (adj)
(i)missë|inside (n)
imlë|yourself (polite) (pron)
imli|*yourself (polite) (pron)
imma|same, self-same, same thing (pron)
imba|same, self-same (pron)
immë¹|ourselves (exclusive) (pron)
immë²|ourselves (dual, emphatic) (pron)
immenwa|automobile (n)
immo|same one (person), self (pron)
immë³|?the same person (pron)
immolaitië|self-praise (n)
immoquanta|full of him/herself, egotistic, narcissistic (adj)
immotuntië|conscience, (lit.) self-perceiving (n)
immoturië|self-control (n)
imnetyala|hypocritical, (lit.) self-adorning (adj)
imnetyalë|hypocrisy, (lit.) self-adornment (n)
imnetyando|hypocrite (n)
imni|myself (pron)
imnë|myself (pron)
imya|same, identical, self-same (adj)
imyalë|sameness (n)
-ina|adjective suffix; passive participle (suf)
incánu|mind master (n)
incánussë|mind mastership (n)
-incë|diminutive ending (suf)
indë|yourselves (pron)
indemma|mind-picture (of apparition in dream) (n)
indil|lily, other large single flower (n)
insil|flower, lily (n)
indis|[ᴹQ.] bride; ⚠️[Q.] wife (n)
indo|(state of) mind, (inner) thought, mood; will, resolve; [ᴹQ.] heart (n)
indómë|settled character; will of Eru (n)
indosatië|resolution (n)
indu-|to will, do on purpose (vb)
induinen|purpose (n)
indya|device, machine, engine (n)
indyarin|device, escutcheon, blazon (n)
indyel|small bell (n)
inga|top, highest point, ⚠️[ᴹQ.] first (n)
ingaran|high-king (n)
ingëa|top (adj)
ingolë|lore, science, philosophy; [ᴹQ.] deep lore, magic (n)
ingolmo|loremaster, wizard, one with very great knowledge, *scientist (n)
ingor|summit of a mountain (n)
inimë|femininity, womanliness (n)
iniva|womanly (adj)
-inqua|-ful, complete (suf)
inquë|thou-and-I (emphatic) (pron)
incë|*you (dual emphatic) (pron)
insa|itself (pron)
insë|himself, herself (pron)
intë¹|themselves (pron)
intë²|they (emphatic) (pron)
intu|themselves (dual) (pron)
intyaitë|fantastic, fantasy (adj)
intyë|yourself (familiar) (pron)
inwalmë|mood of mind (n)
inwë|ourselves (inclusive) (pron)
inwirya-|to change one’s mind, reconsider (vb)
inwis|change of mind/mood (n)
inwissar|opal, (lit.) mood-change stone (n)
inwista-|to persuade, convince (vb)
inyë|I (emphatic) (pron)
inyenna|have, (lit.) added to me (adv)
-ion|-son, masculine patronymic (suf)
ipsin|fine thread (n)
iqu-|to beg, ‘pray’ [ask earnestly] (vb)
iquindo|beggar (n)
iquirya-|to ask for, request (vb)
iquis|requirement (n)
iquista|request; ⚠️if you please, please (n)
ir-|to shudder (vb)
írë|desire, [ᴹQ.] longing (n)
írima|desirable, lovely (adj)
irta-|to peck, prick (vb)
irtë|peck, pinprick (n)
Isil|Moon, (lit.) Sheen (n)
isilmë|moonlight (n)
Isilya|*Monday, Moon-day (n)
-issë|ending in feminine names (suf)
issë|he, *she, it (emphatic) (pron)
essë²|he, *she, it (emphatic) (pron)
ista-|to know (vb)
istalë|information (n)
istanómë|school, academy (n)
istima|wise (in sense knowing very much), knowledgeable, very well informed, learned (adj)
istyalóra|ignorant (adj)
-ita|particular infinitive (suf)
ita|that which, what (conj)
tai²|that which, what (conj)
ita-|to sparkle (vb)
íta¹|flash (n)
íta²|very, extremely; (lit.) multiplied, increased (adv)
ítacelmë|electricity (n)
ítacelmëa|electrical (n)
ítacelmítë|electronic (n)
Italinórë|Italy (n)
italo|since (conj)
itan|so that, in order to (conj)
itara|gleaming (adj)
itas|in that case (adv)
-itë|adjectival ending; [with verbs] capable of doing, generally (and naturally) doing (suf)
it(ë)|if (adv)
itila|twinkling, glinting (adj)
itis|fly bite; *itch (n)
itisin|itching (adj)
itisya-|to itch, irritate (vb)
itsë|fly (n)
ívë|to cliff, sheer descent, precipice (n)
la-|not, in-, un- (pref)
lá-|to not be (vb)
lá¹|no, not (adv)
lá²|beyond, over, across, athwart (prep)
lacalima|not possible to be kindled (made to shine) (adj)
lacaltaima|not possible to be kindled (adj)
lacaraitë|*inactive; ⚠️impossible (adj)
lacarë|inaction, (lit.) not-doing (n)
lacarina|undone, *unfinished, incomplete (adj)
lacenítë|unseeing, blind (adj)
cellóra|blind, sightless (adj)
cénelóra|blind (n)
cenenca|blind, sightless (adj)
lacenítë|unseeing, blind (adj)
lahlaraitë|deaf, (lit.) unable to hear (adj)
hlárelóra|deaf, (lit.) hearing-less (adj)
lahta-|to cross, pass over, go over; to surpass, excel (vb)
langa-|to cross, go over, pass over (vb)
lanya-²|to cross (vb)
lahtalë|passover (n)
lai|very (adv)
laica|green (adj)
laiqua|green (adj)
laicalassë|green-leaf, green as leaves (adj)
laicelumir|malachite (lit.) green-flowing-jewel (n)
lailinquë|beryllium, (lit.) fresh-liquid light (n)
laima|plant (n)
laimamatta|vegetable food, (lit.) plant food (n)
laimamatya|herbivorous, vegetarian, (lit.) plant-eating (adj)
laimaril|emerald (n)
laiquaril|emerald (n)
laiquë|herb (n)
laiquelis|rue (plant) (n)
lairë|summer (n)
lairelossë|summer-snow-white, species of tree in Númenor (n)
lairemírë|daisy, (lit.) meadow-jewel *(or summer-jewel) (n)
lairemo|poet (n)
lairesta|poetry (n)
linwelë|poetry (n)
lairus|verdigris (n)
laista|ignorance, (lit.) not-knowing (n)
laistila|ignorant (adj)
laistëa|ignorant (adj)
laistima|unknowable, secret (adj)
laita-|to praise, bless (vb)
laitalë|praise (n)
laitë|false (adj)
nauna|false (adj)
laitelë|falsehood (n)
naumë|falsehood (n)
naunië|falsehood (n)
laitië|praising, honour (n)
laitima|honourable, praiseworthy (adj)
laitita-|to falsify (vb)
nauta-¹|to falsify (vb)
laivelyávë|(water)melon (n)
lala-|to laugh (vb)
lalamma-|to chatter, babble (vb)
lalammamo|babbler (n)
lalammië|babble (n)
lalasta|laughter (n)
lalda|laugh (n)
lalevítë|lame (adj)
lalië|laughter, laughing (n)
lalië-malina|daffodil, (lit.) yellow laughter (n)
lalil|chuckle (n)
lalta-|to make laugh (vb)
laltaula|funny, (lit.) apt to make laugh (adj)
láma|sound; ⚠️[ᴹQ.] ringing sound, echo (n)
laman|animal, [ᴹQ.] tame beast (n)
lamanwa|animal-like, beastly, stupid (adj)
lamate|fasting, a fast (n)
lámatyávë|*sound-taste (n)
lamba|(physical) tongue (n)
lambë|language, tongue, dialect (n)
lambelanga|translation (n)
lambelanga-|to translate (generally, between languages) (vb)
lambelë|phonetics (n)
lambengolmë|linguistics (n)
lambetengwë|consonant (n)
lambina|of tongue, spoken with tongue (adj)
lamélima|unlovable (adj)
lamma-|?to echo (vb)
lamnarë|flock, *herd (n)
lan|*while (conj)
lana|no, not any, not (a); none (adj pron)
lanca|sharp edge (not of tools), sudden end (n)
lancanta-|to transform, turn into (trans.) (vb)
lancöa|tent, (lit.) cloth shelter (n)
landa|boundary (n)
lane|hem (n)
lanéya|recently, not long ago (adv)
langa|thing that crosses, ferry, ford, crossway, bridge, ⚠️cross-bar (n)
langandë|stringed instrument with a neck (lute, guitar, etc.) (n)
langë|surpassingly, superlatively, extremely (adv)
lango|neck, [ᴹQ.] throat (n)
lanna|athwart, (to a point) beyond, *across (adv prep)
lanotoitë|innumerable (adj)
lanquet-|to converse, debate, *discuss (vb)
artaquet-|to converse, debate (vb)
lanquetta|conversation, debate, interchange of words (n)
artaquetië|conversation (n)
artaquetta|debate, discussion (n)
lanquinga|crossbow (n)
lanquit-|to darn a knitted garment, (lit.) cross/over-knit (vb)
lanta|fall; falling, ⚠️[ᴱQ.] fallen (n adj)
lanta-|to fall; [ᴱQ.] to drop (vb)
lantalca|boundary post or mark (n)
lantanna|banner, standard (n)
lantanwa|fallen (adj)
lantasírë|waterfall, (lit.) falling river (n)
lantë|fall (n)
lanwa|within bounds, limited, finite, (well-)defined (adj)
lanya|thread, warp (n)
lanya-¹|to bound, enclose, separate from, mark the limit of (vb)
lap-|to wrap, swathe, wind (vb)
lapa-|to hop (vb)
laparotsë|sleeve, trouser leg, (lit.) wrap-tube (n)
lapil|swathe, flowing cloth (n)
lappa|loose-end, end of rope, hem of robe (n)
lapselunga|pregnant, (lit.) baby-heavy (adj)
lapsarwa|pregnant, (lit.) baby-having (adj)
laptë|gluttonous eating, [ᴹQ.] †licking up (food or drink) (n)
laptë|gluttonous eating (n)
láquet-|to deny (fact or accusation); (lit.) to say ‘it is not’ (vb)
laqui|unless (conj)
lár|league; †stop, pause (n)
lára-|to flatten, level (vb)
larma|raiment (n)
larmëa|fatty, fleshy (adj)
larmo|listener (spy or scout) (n)
larnelta|mile; *(lit.) league third (n)
larta-|to wait, stay, remain, last, endure (vb)
laru|grease, ⚠️fat (n)
larúva|greasy (adj)
las|it is/was not so (adv)
lassë|leaf; ⚠️[ᴱQ.] petal (n)
lassëa|with leaves, leafy (adj)
lasselanta|(late) autumn, (lit.) leaf-fall; ⚠️[ᴹQ.] October (n)
lassewinta|leaf fall, autumn, *(lit.) leaf blowing (n)
lasta-|to listen; ⚠️[ᴹQ.] to hear (vb)
lat|flap, small hinged door, lid (n)
láta|open (not closed) (adj)
látacar|pub, public house, (lit.) open-house (n)
latanca|unsure, insecure (adj)
látie|openness (n)
latil|key (n)
patil|key (n)
latina|free (of movement), not encumbered with obstacles, [ᴹQ.] open, cleared (of land) (adj)
latsë|area, space, room (n)
lattasta|harness, (lit.) collection of straps (n)
latter-|to darn a sewn garment, (lit.) cross/over-sew (vb)
lattin|window (n)
lattinsan|shutter, (lit.) window-barrier (n)
lattinsámo|shutter, (lit.) window-barrier (n)
latúcen|tin [metal] (n)
latucenda|of tin (adj)
latya|opening (n)
latya-|to open anything (so as to allow entry) (vb)
lauca|[ᴹQ.] warm (adj)
laucata-|to heat up, warm (vb)
laucehtelë|hot spring (n)
laulë|mode of life, *lifestyle (n)
laulema|inhabiting (adj)
laulemo|inhabitant (n)
laulesta|livelihood (n)
laulesta-|to lead a life, gain a living (vb)
laupë|tunic, shirt (n)
laurë|gold (light or colour) (n)
laurëa|golden (of hue) (adj)
laurië|goldenness; like gold (n adv)
laurinquë|yellow-flowered tree (n)
lauta-|to warm (vb)
lauya-|to flourish (green), grow (vb)
lav-|to lick (vb)
lávar|(golden) blossom (n)
löar|(golden) blossom (n)
lávë|permission (n)
lávëar|glutton (n)
lávehentar|ticket inspector, (lit.) permission examiner (n)
lavéla|different, dissimilar (adj)
alavéla|different, various [pl.] (adj)
alimya|different, (lit.) not-same (adj)
lávima|permissible (adj)
-lda¹|your (plural) (suf)
-lla¹|your (plural polite) (suf)
-lda³|a comparative suffix (suf)
-ldë¹|you (plural) (suf)
-llë²|you (plural) (suf)
-ntyë|you (plural familiar) (suf)
-lë|abstract noun, ⚠️adverb (suf)
le|you (plural) (pron)
lé¹|way, method, manner (n)
lé²|with, [ᴹQ.] by, ⚠️[ᴱQ.] with (accompaniment) (prep)
lehta|free, released (adj)
lélë|will (n)
lelelya-|to travel (vb)
lelta-|to send, *(lit.) cause to go (vb)
leluya|thick (of a single thing) (adj)
lelya|delicate, beautiful and fine, slender, lovely (adj)
lelya-¹|to go, proceed (in any direction), travel (vb)
lenna-|to come; [ᴹQ.] to go, depart (vb)
lelya-²|to appear (of beautiful things); to attract, enchant (with dative) (vb)
lelya-⁴|to will with conscious purpose, immediate or remote (vb)
lelyaláve|ticket, (lit.) travel-permission (n)
lemba|sad (adj)
lemma|artifact, relic, residue (n)
lemmë|remnant(s), remains, remainders (n)
lempë|five (cardinal)
lemen|five (cardinal)
lemnë|five (cardinal)
lempëa|fifth (ordinal)
lepenya|fifth (ordinal)
lemenya|fifth (ordinal)
lempellumë|five times (adv)
lenca|slow, ⚠️dull, stiff; left (hand) (adj)
taira|slow (adj)
lenda|journey, *travel, trip (n)
lenda-|to go free (vb)
lendë|journey (n)
lendië|tourism, *traveling (n)
lenga-|to behave (vb)
lenga-|to behave (vb)
lengalë|behavior (n)
lengë|gesture, characteristic look, gesture or trait (n)
lengë|gesture, characteristic look, gesture or trait (n)
lengesta|character (of a person), set of characteristic traits (n)
lengwë|yearning, desire for what is lost or absent (n)
lenwë|leaving, departure (n)
lenweta-|to go away, migrate, leave one’s abode (vb)
lenya|yours (plural) (pron)
lep-|to take [with fingers], *pick, pluck (vb)
lepecan|fourth finger (n)
cantil|fourth finger (n)
lepente|fourth finger (n)
lependë|middle finger (n)
enestil|*middle finger (n)
eneldë|*middle finger (n)
enellë|*middle finger (n)
lepenel|middle finger (n)
lependórë|quintillion (cardinal)
lepenquain|fifty (cardinal)
lepenquëan|fifty (cardinal)
lepenquë|*fifteen (cardinal)
quailepen|*fifteen (cardinal)
lepenquëa|fifteenth (ordinal)
leper|finger (n)
lepsë|*finger (n)
lepesta|one fifth (fraction)
lepsat|one fifth (fraction)
lepetas|index finger (n)
leptas|*index finger (n)
tastil|*index finger (n)
lepetta|Gondorian hardwood (n)
lepincë|little finger (n)
lepinca|little finger (n)
nihtil|little [finger] (n)
leppa|thimble (n)
lepsa|liver (n)
lepsilë|tendril (n)
lepta|fingered; ⚠️thumb, [ᴱQ.] finger (adj n)
leuta|finger (n)
lepta-|to pick (up/out); to finger, feel with the fingertips (vb)
leptafinya|clever-fingered (adj)
leptenta-|*to point to, indicate with finger (vb)
léra|free (of persons) (adj)
léramo|freeman (n)
lerca-|to flee (vb)
lercië|flight (n)
lerië|issue, release, edition (n)
lérië|freedom (n)
lerina|free (of things) (adj)
lerta-|to be free to do (vb)
lerya-|to release, set free, let go (vb)
leryalë|release (n)
lesta|*girdle (n)
lesta-|to measure (vb)
letinwessë|constellation (n)
leuca|snake (n)
lev-|to move (intr.) (vb)
levë|movement, motion (n)
levemma|movie, motion picture (n)
menemma|movie, motion picture (n)
-li|partitive plural (suffix); many, some, a lot of (suf)
lia-|to entwine (vb)
lialóra|cordless, wireless (adj)
liantassë|vine (n)
lic-|to glide, slip, slide, ⚠️drip (vb)
líco|wax (n)
lícuma|taper, candle (n)
lië|people, folk (n)
liëarda|republic (n)
liëmelehtëa|democratic (adj)
liendina|popular (adj)
lieraxa|a bus, coach, (lit.) people wagon (n)
lietarwa|park, (lit.) people-garden (n)
lietúrie|democracy (n)
lihta|seal (n)
lihta-|to seal (vb)
lihtaina|sealed (adj)
lilíva-|to drip, drip-drop (vb)
lillassëa|having many leaves (adj)
lillumë|many times, often (adv)
lilma|patch (n)
lilómëa|many-shadowed, very dark, full of darkness (adj)
lilótëa|having many flowers (adj)
liltë|dance (n)
liltië|dancing, dance (n)
limbë|quick, swift (adj)
limë|link, *joint (n)
limil|chain (n)
limpa|frail, slender and drooping (adj)
limpevorma|wine-press (n)
limpunqua|drunken (adj)
limpunquië|drunkenness (n)
limya-|to link, join (vb)
li(n)-|many (pref)
lina|many (adj)
lincantëa|diverse, (lit.) many shaped (adj)
lincantilda|checkered; (lit.) many-squared (adj)
linda|beautiful (of sound), sweet, melodious; soft, gentle, light, [ᴱQ.] kind; ⚠️[ᴹQ.] fair (adj)
linda-|*to sing, make music (vb)
lindalë|music (n)
lindalëa|melodious, *musical (adj)
lindë|singing, song, musical sound; [ᴹQ.] air, tune (n)
lindëa|singing, ⚠️*musical (adj)
lindelin|melody, tune (n)
lindelos|laburnum, (lit.) singing cluster (n)
lindimaitar|composer, musician (n)
lindista|music album (n)
lindóra|millions of, many millions (adv)
linga-|[ᴹQ.] to hang, dangle (vb)
lingi-|[unglossed] (vb)
lingë|musical sound (n)
lingëa|with a musical sound (adj)
lingil|hanger, hook (for clothes) (n)
lingwë|fish (n)
lingwëa|fishlike (adj)
lingwileuca|eel (n)
lingwimo|fisherman (n)
raito|fisher (n)
lingwiremnë|fishing (n)
linima|of many kinds, manifold (adj)
linipsinwa|complex, complicated, convoluted; (lit.) many-threaded (adj)
linipsinwië|complexity, complication, complicatedness; (lit.) many-threadedness (n)
linitë|plural (adj)
linquë¹|(leaf of a) hyacinth, *grass or grass-like leaf (n)
linquë²|light-substance; liquid light, *photons (n adj)
linquemir|hyacinth [jewel] (n)
linquilea|having many colours (adj)
linta|swift (adj)
linta-|to soothe (vb)
lintië|swiftness, speed; swiftly, *quickly (n adv)
linvainëa|onion, (lit.) many-sheathed (n)
linwa|musical instrument, device for making music (n)
linya|lean, thin, meagre (adj)
lio|much (adv)
lipsanë|lather (n)
lipta-|to drip (vb)
liptasar|dripstone (n)
liquis|clarity, transparence, limpidity (n)
liquistëa|transparent, *clear (adj)
lir-|to sing, [ᴹQ.] chant (vb)
liralë|merry singing (n)
lírë|song (n)
liru-|to sing (gaily) (vb)
lirulin|lark (n)
aimenal|lark (n)
lirusta|singing, chant (n)
lís|honey, *sugar, sweetener (n)
liscornë|any sweet fried bread, doughnut (n)
lissë¹|sweet (adj)
lissë²|grace (n)
lisselë|sweetness (n)
lissimat|dessert, (lit.) sweet-meal (n)
lissimatta|sweet, piece of confectionary (n)
lissimbas|(sweet) cake (eaten as dessert) (n)
lista-|to sweeten, make sweet (vb)
lita-|to multiply (vb)
litsëa|sandy; granular, gritty (adj)
litsëon|sandstone (n)
littë|ash (n)
liv-|to anoint (vb)
liyúmë|host (n)
-llë¹|feminine agent (suf)
-ldë²|feminine agent (suf)
-llo|(movement) from, [ᴱQ.] out of, [Q.] ablative suffix (suf)
-llumë|-times (suf)
-lma¹|our (exclusive) (suf)
-mma²|our (exclusive) (suf)
-lmë¹|we (exclusive) (suf)
-mmë²|we (exclusive) (suf)
ló|(away) from; by agent [of]; [ᴹQ.] ablative element (prep)
ollo|away from (prep)
löa|(seasonal) year, (lit.) (time of) growth, blooming (n)
löasta|season, (lit.) year-part (n)
löacasta|season, (lit.) year-quarter (n)
loc-|to loop, curl, ⚠️bend (vb)
locco|ringlet (n)
lócë¹|bight, bend, curl of hair (n)
locin|bent, *curled (adj)
loëndë|mid-year (Númenórean calendar), *(lit.) year-middle (n)
loi-|mistaken, mistake in ... (pref)
loica|failing, short, inadequate (adj)
loicarë|mistaken action (n)
loico|corpse, dead body (n)
loicolícuma|corpse-candle (n)
loima|mistake (n)
loiparë|mistake in writing (n)
loiquetë|mistake in speech (n)
loita-|to miss, fail, fall short of (transitive) (vb)
lolóca-|to crawl (vb)
lóma|moss (n)
lómaril|jade (n)
lomba|blind (adj)
lomba|blind (adj)
lómë|night, dimness, twilight, dusk, darkness, [ᴹQ.] night-time, shades of night, ⚠️gloom; [ᴱQ.] shadow, cloud (n)
lómëa|shadowed, gloomy, *dusk-like (adj)
lómelindë|nightingale, (lit.) dusk-singer (n)
lomentie|?journey away, departure (n)
lómivehtë|night life (n)
lóna|(deep) pool, mere, river-feeding well (n)
lón(ë)|deep pool, river-feeding well (n)
lú(n)|*deep pool (n)
lóna|soaked, drenched (adj)
londë|(land-locked) haven; [ᴹQ.] road (in sea), fairway, entrance to harbour; gulf (n)
londië|harbourage (n)
lónë|isle, [ᴹQ.] island, remote land difficult to reach (n)
lop-|to gallop, *lope, ⚠️[ᴱQ.] run (vb)
lopoldë|rabbit (n)
lorda|slumbrous, drowsy, *sleepy (adj)
lórë|[ᴹQ.] slumber, *sleep; [Q.] dream (n)
lórelot|poppy, *(lit.) flower of sleep (n)
lornata-|to put to sleep (vb)
lornatála|sleep-inducing (adj)
lorta-|to faint, swoon, become dazed (vb)
lortalë|swoon, faint, dizziness (n)
loru-|to fall asleep (vb)
lossë¹|snow, fallen snow; snow-white, snowy (n adj)
lossë²|[ᴹQ.] (white) blossom, flower, [ᴱQ.] (white) flower; [Q.] inflorescence (of white flowers); ⚠️[ᴱQ.] rose (n)
lossëa|snowy, (snow) white (adj)
losta-|to bloom, *blossom (vb)
lotarwa|[flower] garden (n)
lótë|flower, single blossom; ⚠️[ᴱQ.] bloom (n)
lótëa|full of blossom, *blooming, flowering (adj)
lótelas|petal, (lit.) flower-leaf (n)
lotella|floret (n)
Lótessë|May, *(lit.) Flower-ness (n)
lotsë|small (single) flower (n)
lottë|small flower (n)
loxo|mud (n)
loxor|swamp, bog (n)
lóya-|to leave (something: a place, a thing) (vb)
-lta|theirs (suf)
-ltya|theirs (suf)
-ltë|they (suf)
luc-|to haul, drag, [ᴱQ.] pull (behind) (vb)
lúcëarwa|enchanting, attractive (adj)
luhta-|to bow, *curve (vb)
luhtu|magic, spell (n)
luhtya-|extinguish, *quench (vb)
luicarnë|purple (adj)
luilë|sapphire, blue stone (n)
luimë|flood, floodwater, flooded land; flood tide, high tide (n)
luinë|blue (adj)
luinincë|bluish (adj)
luinion|lapis lazuli, (lit.) blue-rock (n)
luinyellë|bluebell (n)
luita-|to flood, inundate, drench (vb)
luitë|melancholic, (lit.) habitually being sad (adj)
(lu)lútië|cruise, (lit.) floating/sailing about (n)
lúma|clock (n)
lumba|gloomy (adj)
lumbo|cloud, [ᴱQ.] dark lowering cloud; [Q.] gloom, dark, shade (n)
lumbulë|dark shadow, heavy shadow; deep in shadow (n)
lúmë¹|time, period of time, hour (n)
lúmë²|darkness (n)
lúmëa|pertaining to time, temporal (adj)
lúmequentalëa|historical (adj)
lúmincë|minute, moment (n)
lúna|*dark (adj)
lunca|heavy transport wain (n)
luqua|heavy transport wain (n)
lungië|heaviness, gravity (n)
lungo|heavy (adj)
lungumaitë|heavy-handed (adj)
lungumë|weight, heaviness (n)
lunguntë|scales (n)
lungwë|pound (n)
luntë|boat, [ᴱQ.] ship (n)
lunwa|fin, (lit.) swim-thing (n)
luppo|clumsy piece or lump (n)
lupsë|nugget, (small) chunk, clump, tidbit (n)
lúrë|dark weather, bad weather (n)
lúrëa|overcast, dark [of weather] (adj)
lurwë|threat (n)
lussë|(verb) tense (n)
lustavë|in vain, emptily (adv)
lustië|in vain, emptily (adv)
lustindo|ennui (n)
lut-|to float, sail, *swim, ⚠️flow (vb)
lúta-|to have time pass (vb)
luttalan|raft, (lit.) floating platform (n)
lúva|bow (in forming tengwar), bight, bend, curve (n)
-lva|our (inclusive) (suf)
-lma²|our (inclusive) (suf)
-lwa|our (inclusive) (suf)
-lvë|we (inclusive) (suf)
-lmë²|we (inclusive) (suf)
-lwë|we (inclusive) (suf)
-lya¹|your (polite) (suf)
-lya²|imperfect participle (suf)
-l(yë)|you (polite) (suf)
-l|you (polite) (suf)
lye|you (polite) (pron)
lyenya|yours (polite) (pron)
lyéta-|to address somebody formally using lye (vb)
-ma|instrumental (suf)
má|hand (n)
ma¹|something, a thing; ⚠️anything (pron)
ma²|interrogative particle (adv)
mac-|to hew (with a sword), *swing (a sword); ⚠️[ᴱQ.] to slay; to die (vb)
maca-|to forge (vb)
macar|swordsman; †forger (n)
macca|article (for exchange), ware, thing (n)
macil|sword, forged sword blade, cutting sword, [ᴱQ.] broadsword (n)
macilindil|gladiolus, (lit.) sword lily (n)
máfastië|hand-pleasure, writing for pleasure of hand and eye (n)
mahalma|throne (n)
mahar|tradesman, trader, merchant (n)
máhis|maize, either sweet corn or field corn (n)
mahta-|to handle, wield, use, make use of; to manage, deal with, treat, control; [ᴹQ.] to wield a weapon, fight; to stroke, feel (vb)
mahtalë|fighting, battle (n)
mahtando|manager (n)
mahtasta|management (n)
mahtë|hold, grip, *grasp; ⚠️power, possession (n)
mahtéma|tournament, tourney, (lit.) battle-series (n)
mahtië|management, *handling (n)
mahtë|management (n)
mai|well; ⚠️[ᴱQ.] too much (adv)
mai-¹|excellent, admirable; *well, happily (pref)
amya-¹|excellent, admirable (pref)
mai-²|to have, possess (vb)
Maia|(angelic) spirit, the Beautiful (n)
Maiya|(angelic) spirit (n)
Máya|angelic spirit (n)
maica¹|sharp, piercing (adj)
maica²|blade of a cutting tool or weapon (especially sword-blade) (n)
maicámima|acceptable, (lit.) well-receivable (adj)
maicarindo|benefactor (n)
maicata-|to sharpen (vb)
laiceta-|to sharpen (vb)
maicatan|weaponsmith (n)
mailengaitë|well-mannered (adj)
mailitya|(greedily) wealthy, avaricious (adj)
maimun|monkey, ape (n)
maina|thing of excellence, treasure (n)
mainenta-|to brag, (lit.) make seem excellent (vb)
maira|admirable, excellent, precious, splendid, sublime (adj)
mairë|art, work of high and beautiful art, process of producing an art work (n)
mairëa|beautiful (of things made by art), *artistic (adj)
mairia|beautiful (of things made by art) (adj)
mairië|excellence, splendor, sublimity, ‘perfection’ (n)
maisinwa|well-known, notable, famous (adj)
maita|hungry (adj)
maita-|to make with art, design, compose (vb)
maitalë|act of doing [artistic] work (n)
maitar|artist; poet (n)
maitë|handy, skillful, [ᴹQ.] skilled; [Q.] shapely, well-shaped; (as suffix) having a hand, handed (adj)
maitië|hunger (n)
maitilë|skill, handicraft; legerdemain, sleight (n)
maitulië|welcome thing, happy arrival (n)
alatúlië|welcome (n)
amatúlië|blessed arrival (n)
maitulya|welcome (adj)
alatulya|welcome (adj)
amatulya|welcome (of something blessed) (adj)
maiwë|gull (n)
mal|but (conj)
ono|but (conj)
nó²|but (conj)
onë|but (conj)
mal-|to crush, squeeze; to hurt, pain (cause pain to) (vb)
malaqua|soft, yielding, tender (of meat, substances, etc.) (adj)
malatsar|chrysolite (n)
malda|pulp, paste, mash, mush (n)
malma²|pulp, paste, mash, mush; dough, grume (n)
malda-|to pound, ⚠️crush (vb)
málë|good health (n)
málëa|healthy, healthful (adj)
malicon|amber (n)
malicondëa|of amber (adj)
málimë|wrist, (lit.) hand-link (n)
malina|yellow, of golden colour (adj)
malda¹|yellow, of golden colour (adj)
malinornë|mallorn, (lit.) golden/yellow tree (n)
maldorne|golden/yellow tree (n)
malma¹|lemon (n)
malo|moth (n)
málo|friend, comrade (n)
malta|gold (metal), gold as material (n)
maltaina|of gold (adj)
maltalos|buttercup (lit.) flower of gold (n)
malumë¹|when (adv)
máma|sheep (n)
mámalin|sheepfold (n)
mamil|*mummy (n)
mammata-|to gorge (oneself), gobble up, [ᴹQ.] devour; [Q.] (lit.) to go on eating (vb)
man|who; ⚠️[ᴹQ.] what (pron)
mana|what; ⚠️[ᴹQ.] who (pron)
mána|blessing, good thing; ⚠️[ᴹQ.] blessed (n)
mánacestië|intercession, (lit.) boon-seeking (n)
manaitë|*blessed, having grace (adj)
manan|why (adv)
manaquenta|*blessed (adj)
mancamen|market, (lit.) trade-place (n)
mancanómë|market, market-place (n)
mancaro|tradesman, trader, merchant (n)
manco|wares (n)
manda-|to imprison (vb)
mandanië|struggle, wrestling, (lit.) hand-resistance (n)
mandano|prisoner, (lit.) imprisoned-one (n)
mando|custody, safe keeping; prison, duress (n)
mandontur|jailer (n)
manë|good (moral, not evil) (adj)
manen|how (adv)
mangwa|article for trading, goods (n)
manotë|how many, (lit.) what number (adv)
manta-|to bless (vb)
mantal|glove (n)
mantelë|gauntlet (n)
manwa|whose (adj)
mava|whose (adv)
manya|butter (n)
manya-|to bless (vb)
mapalin|plane tree [Platinus], sycamore, (lit.) hand-flat (n)
maptalë|seizure; robbery by violence; rape, ravishment, forcible seizure and carrying off (n)
maqua|hand-full, group of five (similar) things; hand (colloquial); ⚠️closing or closed [hand] (facing down) for taking (n)
maquanotië|decimal system (n)
caistanótië|decimal system (n)
maquet-|*to question, ⚠️ask (vb)
maquetta|question (n)
mar-|to abide, be settled or fixed, [ᴱQ.] dwell, live (vb)
már|home, dwelling, habitation; ⚠️[ᴹQ.] house; earth (n)
mára|good, proper; [ᴹQ.] useful, fit, good (of things), [ᴱQ.] excellent; ⚠️mighty, power, doughty (adj)
mar(da)|dwelling, (great) house, residence, mansion, a thing or place dwelt in, ⚠️home; [ᴱQ.] world (n)
mardaitë|homely, domestic (adj)
mardo|dweller (n)
márë|(moral) good, goodness (n)
márië|well, happily; goodness, good estate, being well, happiness (adv n)
máralë|goodness (n)
máriën|goodness (n)
marindo|settler (n)
marrum-|to move = change residence (vb)
marta-|to define, decree, destine; ⚠️[ᴱQ.] to happen (impers.), chance (vb)
umbarta-|to define, decree, destine (vb)
martan|dwelling-house (n)
martaman|dwelling-house (n)
martandë|decision (n)
marto|fortune, fate, lot, luck (n)
marto|tower (n)
marya-|to found, establish, settle (as dwelling) (vb)
maryë|at home, *indoors (adv)
masematica|mathematics (n)
massa|bread (n)
massë¹|bread (n)
massánië|Lady, breadgiver (n)
massë²|portion, share; capacity, [ᴹQ.] measure; the personal measure or capacity of a man, a talent; [Q.] †handful (n)
maxë|handiness (n)
masta|bread, cake, loaf, *baked good (n)
mastacornë|[bread] loaf (n)
mastasan|kitchen (n)
mat-|to eat (vb)
mátengwië|language of the hands (n)
mátima|edible (adj)
mastima|edible (adj)
matimar|restaurant, (lit.) eating hall (n)
matina|eaten (adj)
matta|food (n)
-matya|-eating (suf)
matya-|to feed (vb)
maura-|to need, require (vb)
mavaina|maple, (lit.) hand-clad (n)
maxa-|to cook (vb)
maxar|cook (n)
maxarma|software (n)
maxata-|to knead (vb)
maxë|sale (n)
maxo|mire, [ᴹQ.] sticky substance (n)
maxon|mudstone (n)
-më|abstract noun (suf)
me|us (exclusive) (pron)
mec-|to plead (vb)
mecin|please (adv)
mehar|gore (n)
mehta-|to aim at (vb)
mehtar|warrior (n)
mehtë|mark, aim, object (n)
mel-|to love (vb)
méla|loving, affectionate (adj)
mélacárië|pastime, hobby (n)
mélamar|(emotional) home (n)
melda|beloved, dear, [ᴹQ.] sweet (adj)
meldë|*friend (f.) (n)
meldo|friend, lover (n)
melehta|mighty (adj)
meletya|mighty (adj)
melehtë|might, power (inherent) (n)
melehtë|might, power (inherent) (n)
melesellë|love-sister (n)
meletheldë|love-sister (n)
meletya-|to magnify (vb)
mélië|*love, loving (n)
melima|[ᴹQ.] loveable, ⚠️fair; [Q.] loving, very affectionate (adj)
melinólë|philosophy (n)
mellaman|pet, (lit.) love-animal (n)
melmë|love (a particular case [between two people]) (n)
melotorno|love-brother (n)
melpo|gooseberry (n)
melta-|to enamour (vb)
melu|honey (n)
melu-|to fall in love (vb)
melumatya|honey-eating (adj)
meluquetya|sweet-speaking person, flatterer (n)
melya-|*to be in love (vb)
men|way; [ᴹQ.] place, spot (n)
men-|to go, proceed, move (generally); ⚠️to come, arrive (vb)
mén|beak, ⚠️nose (n)
mendar|station, (lit.) way-stop (n)
angamendar|train station, (lit.) iron way-stop (n)
mendë|*will (n)
menel|the heavens, firmament, sky (n)
meneldil|astronomer, *(lit.) lover of the heavens (n)
menelluin|cornflower (colour), *(lit.) sky-blue (adj)
menelwa|heavenly (adj)
Menelya|*Wednesday, Heavens-day (n)
menessë|instead, (lit.) in place (adv)
menesta¹|intention, *goal (n)
menesta²|motion, movement (n)
menta|sending, message (n)
menta-¹|to send, cause to go (in a desired direction) (vb)
menta-²|have as object[ive], (in)tend, proceed, make for, go towards (vb)
mentië|passage, journey, direction of travel (n)
menya|our (exclusive); [ᴺQ.] ours (pron)
mer-|to hope, [ᴹQ.] wish, desire, want (vb)
merenya-|to be festive, celebrate (vb)
merillë|rose (n)
mermë|wish (n)
mestanyatsë|suffixion (n)
métima|last, ultimate, final (adj)
metta|ending, end (n)
Mettelairë|August, *(lit.) End-summer (n)
Metterrívë|January, *(lit.) End-winter (n)
mi|in, [ᴹQ.] within (prep)
imi|in, [ᴱQ.] inside (prep)
micol-|to import (vb)
-mie|*noun ending (suf)
-men(d-)|a single action (suf)
mildë|pea (n)
milla|oily (adj)
millë|?ring (n)
millo|oil (n)
millumë|once, one time (adv)
milpialda|olive tree (n)
milpio|olive, (lit.) oily-berry (n)
miltë|semen (n)
mimírima|very beautiful (adj)
mimíre|very beautiful (adj)
min|one, [ᴱQ.] one (in a series), the first (cardinal)
mina|into, in, [ᴹQ.] to the inside (prep adv)
mína|desiring to start, eager to go (adj)
mína-|to desire to go in some direction, wish to go to a place, make for it; to have some end in view, *intend (vb)
minassë|fort, city (with a citadel and central watch tower) (n)
minassëa|inherent, innate, intrinsic (adj)
minasurië|enquiry, *research (n)
minaþurië|enquiry (n)
minasurindo|researcher (n)
minatec-|to record, (lit.) into-write (vb)
minaxanwa|enchained, bound, fettered (adj)
mindë|turret (n)
mindon|(lofty or isolated) tower; [ᴱQ.] turret (n)
mindórë|million (cardinal)
minima|special (positive) (adj)
minomë|instead, in place of, in exchange of (adv)
minquë|eleven (cardinal)
minquellumë|eleven times (adv)
minquesta|*one eleventh (fraction)
minquetyar-|to accentuate, (lit.) pronounce prominently (vb)
minquetyarmë|accentuation (n)
mintya-|to remind; ⚠️(impers.) it reminds me = I remember (vb)
minul(da)|ingot (n)
minya|first; eminent, prominent (ordinal adj)
miqu-|to kiss (vb)
miquë|kiss (n)
miquelë|kissing (n)
miquelis|(soft, sweet) kiss (n)
mírë|jewel, gem, precious thing, treasure; precious (n adj)
mírëa|jewelled, *gemmed (adj)
miriéla|?sparkling (adj)
mírima|very valuable, very precious, very lovely (adj)
mirma|value, *price (n)
mirmairë|jewelry, (lit.) jewel-art (n)
mirquet-|to persuade, (lit.) into-talk (vb)
mirquétala|persuasive (adj)
mirröanwë|incarnate (n)
mirta-|to value, esteem, treasure, cherish (vb)
miru|wine (n)
mirucarnë|wine-red (adj)
mirupio|grape, (lit.) wine-berry (n)
tiuma|grape (n)
mirúva|like wine, winy (adj)
miruvórë|mead, nectar, special wine or cordial, drink of the Elves, ⚠️(lit.) precious juice, [ᴱQ.] sweet drink (n)
miruvor|special wine or cordial (n)
mirwa|precious, valuable (adj)
mirya|beautiful, lovely (of works of art only) (adj)
míra|beautiful, lovely (adj)
mis|urine (n)
mísë|(light) grey (adj)
mista|grey (adj)
mistana|stray (adj)
mistë|drizzle, [ᴹQ.] fine rain (n)
mitië|interior (n)
mitsavëo|micro-organism (n)
mitta|[ᴹQ.] inwards, into, ⚠️[ᴱQ.] in;  [Q.] between (prep adv)
mitta-|to insert; [ᴹQ.] to come in, [ᴱQ.] enter (vb)
mittandë|infixion, intrusion, [ᴹQ.] insertion (n)
mittanya-|*to lead (into) (vb)
mittar(ë)|*entering (n)
miuro|cat (n)
miura|cat (n)
miurë|cat (n)
miuya-|to cry, whine (vb)
mixa|sharp-pointed (adj)
miχa|sharp-pointed (adj)
-mma¹|our (exclusive dual) (suf)
-mmë¹|we (exclusive dual) (suf)
-mmo|we (exclusive dual) (suf)
-nwë|we (exclusive dual) (suf)
-mo|agental suffix (suf)
mo|one, anyone, someone, somebody (pron)
möa|must (impersonal) (vb)
moia-|to be afflicted, *be laboured; ⚠️to labour (vb)
mol-|to labour (vb)
moica|soft, gentle (adj)
mól|slave, [ᴹQ.] thrall (n)
molda|big, large (adj)
mólë|labour, *work (n)
molië|labour, work (n)
tarassë|labour (n)
mólë|labour, *work (n)
moleculë|molecule (n)
móletyeller|career, (lit.) work-steps (n)
mólië|slavery, thralldom (n)
móna|*womb (n)
carva|*womb (n)
morë|dark, black; darkness, [ᴹQ.] blackness, [Q.] night (adj n)
morendë|midnight (n)
moricalca|obsidian, (lit.) black glass (n)
mórilanta|nightfall (n)
morilúpë|blackbird, (lit.) black plume (n)
morimaitë|black-handed (adj)
moritöa|ebony wood (n)
móriva|nocturnal (adj)
morna|black, dark; black of hair; [ᴹQ.] sombre, ⚠️gloomy (adj)
mornië|darkness, blackness (n)
móro|ink (n)
mórolingwe|squid, (lit.) ink-fish (n)
mortavar|ebony, ⚠️ivory (n)
morteccon|graphite, (lit.) black writing rock (n)
morumbar|dark-fated (adj)
mótamen|office (n)
mótaro|worker (n)
molindo|worker (n)
motto|fen, marsh; [ᴹQ.] blot (n)
múco|dung, *manure, muck (n)
muhta-|*to defecate, empty bowels (vb)
mul-|to grind, *pulverize (vb)
mulda|powdery (adj)
mulë|meal, *grist, ground grains (n)
mulessë|porridge (n)
mulma|fine flour (n)
mulmanen|mill (n)
mulmar|miller (n)
mulmin|mill (n)
mulondo|millstone (n)
mundo|bull, ox (n)
mondo|ox (n)
mundollë|calf (n)
munta|nothing, *zero (n)
muqua|filthy (adj)
mussë|soft (adj)
mut|dirt, filth (n)
-n²|dative (suf)
ná|yes, it is so, it is a fact (interj)
nása|yes, it is so (interj)
ná-|to be, ⚠️[ᴱQ.] exist (vb)
na-¹|plu- (pref)
ana-²|plu- (pref)
nac-|to hew [into], cut; ⚠️[ᴹQ.] to slay, kill; to hate (vb)
nácë|it may be seeming, *qualified yes (interj)
nacil|victor (n)
náha|narrow, *thin (adj)
nahta-¹|to slay; ⚠️[Q.] to hurt, injure, wound; [ᴱQ.] slay cruelly (vb)
nahta-²|to confine, oppress (vb)
nahtalë|slaughter (n)
nahtana|*slain (adj)
nahtar|slayer, murderer (n)
nahte|wounding, wound (n)
nai|maybe; be it that, may it be that; perhaps, it may be, there is a chance or possibility; ⚠️[ᴱQ.] remoter possibility (adv)
nai-|ill, grievously, abominably (pref)
naica|bitterly painful or grievous (adj)
naico|goat (n)
nainaima|lamentable (adj)
nainima|lamentable (adj)
nainala|lamenting (adj)
nainalindë|dirge, (lit.) lament-song (n)
nainië|lament, *lamentation (n)
naiquet-|to curse or blaspheme (vb)
naiquéto|blasphemer (n)
naira¹|vast, wide, empty (adj)
naira²|dreadful, horrible, unendurable, [ᴱQ.] dire, grievous (adj)
nairë|space (as a physical dimension) (n)
nairenyanna|unfortunately, (lit.) to my sadness (adv)
naita-|to oppress, cause great grief to (vb)
naitë|true (adj)
naitië|indeed, truly, *really (adv)
naitya-|to put to shame, abuse, *rebuke; ⚠️to damage, hurt (vb)
naityalë|shame (n)
naityana|shamed, ashamed (adj)
nalanta-|to attack, (lit.) fall upon (vb)
nalda|bright, polished (of metal) (adj)
nallamya-|to echo, sound back, reverberate (vb)
nalma|reflector, mirror (n)
nalta|radiance, glittering reflection (n)
alta|radiance (n)
naltalma|heliograph (n)
nalumë|sometime(s) (adv)
ailumë²|sometimes, at times (adv)
lúmelissen|sometimes, at times (adv)
malumë²|sometimes, at times (adv)
nam-|to judge, *think (have as an opinion) (vb)
náma|judgment or desire (n)
namárië|farewell, (lit.) be well, let it be well (to you) (interj)
nambírë|jasper (n)
námië|single judgment or desire (n)
námima|culpable, (lit.) judgeable (adj)
nammar|court, courthouse, (lit.) judgment-house (n)
namna|statute, *law (n)
namnasta|regulations (n)
námo¹|person, somebody (unnamed) (n)
námo²|judge (n)
námocombë|tribunal (n)
namoia-|to work (hard) for; to earn (vb)
námondur|court-attendant, (lit.) judge-servants (n)
nampaitya-|to pay back (vb)
nampaityalë|paying back, *restitution (n)
nan-|back (again); [ᴹQ.] backwards (pref)
nananta-|to give back, *return [something] (vb)
atanta-|to give back (vb)
nanca|*hewn, ⚠️slain (adj)
nancal-|to reflect, (lit.) shine back (vb)
nancam-|to receive back (vb)
nancar-|to undo, *destroy (vb)
nancárima|destructible (adj)
nancarindo|destroyer (n)
nancáro|destroyer (n)
nancarpa-|to talk back (vb)
nanda¹|?back (adj)
nan(do)|(wide) valley, vale; ⚠️[ᴹQ.] water-mead, watered plain; [ᴱQ.] woodland (n)
nan|valley, vale (n)
nanda²|vale (wide) (n)
nandë|valley (n)
nangwë|victory (n)
nangwesa|answer (n)
nanhalya-|to unveil, reveal (vb)
nanhat-|to cast back, reflect (vb)
nannem-|to disappear (vb)
nanomë|someplace, somewhere (adv)
nanquer-|to turn back, turn around (vb)
nanquer-|*to turn back (vb)
nanquet-¹|to talk back, speak against (vb)
nantar-|to stand back (vb)
nanwa¹|existing, actual (true), *real; ⚠️[️ᴱQ.] being (adj)
nanwa²|(large) bowl (n)
nanwavë|truly, actually (adv)
enwavë|actually (adv)
nanwë|ebb, lowtide (n)
lanwë|ebb-tide (n)
nanwen-|to return, go/come back (vb)
nanwenta-|to send back (vb)
nanwera|ransom (n)
nanwenda|ransom (n)
nanwerë|ransom (n)
nanwië|reality (n)
nanya-|to struggle, oppose, resist (vb)
nanyalë|resistance, opposition (n)
nap-|to take (hold), pick up, grasp (with fingers) (vb)
napan-|to add (vb)
nápo|thumb, (lit.) picker (n)
nápat|thumb and index [fingers] as a pair (n)
tollë²|thumb (n)
leptollë|*thumb (n)
tolpë|thumb (n)
toltil|thumb (n)
nappa|claw, talon (n)
namma|claw, talon (n)
náquet-|to assent, agree (on fact); (lit.) to say ‘it is’ (vb)
naqui|although, even though, (lit.) if it is in fact (conj)
nár|fire (as an element); ⚠️[ᴹQ.] flame (n)
narambo|bang, buffet (n)
narassë|pasture (n)
narasta-|to pasture, *graze, give to feed (vb)
narca|snappy, ill-tempered (adj)
narcë|*rend, tear; [ᴱQ.] snap of a dog; spiteful remark (n)
Nárië|June, *Fire-ness (n)
Narquelië|October, Sun-fading (n)
narrundo|torch (n)
nartaima|inflammable (adj)
nartanwë|firework (n)
Narvinyë|January, *New-fire (n)
narwa|ruddy, red of hair (adj)
nas-|to welcome, ⚠️accept (vb)
nasal|guest (n)
asa|guest (n)
nasumo|guest, visitor (n)
nasarta-|to entrust (vb)
násië|*amen, (lit.) may it be so (interj)
násan|*amen, (lit.) may it be so (interj)
san na|*amen, (lit.) may it be so (interj)
nasquë|bondage, durance (n)
nassë|nature, true-being, *essence; ⚠️person, individual; material (n)
nassëa¹|spiked, pointed, barbed (adj)
nassëa²|natural (adj)
nastaro|scorpion (n)
nastyapsul|turnip, (lit.) prickly/stingy/sharp tasting root (n)
nat|thing (n)
náto|it is that; *yes (emphatic) (interj)
natsemen|website, (lit.) web-spot (n)
nattir-|to look back (vb)
nattira-|to despise (vb)
nattírima|despicable (adj)
natto|affair, matter, ⚠️thing (n)
nauca|stunted, shortened, dwarf(ed) (adj)
nauco|dwarf (n)
naucon|Dwarf (n)
nauna-|to howl (vb)
nauro|werewolf, wolf (not wild wolves) (n)
nauya-|to conceive [of an idea] (vb)
nauta-²|to conceive (vb)
nav-¹|to judge, think [have as an opinion] (vb)
ham-|to judge (vb)
nem-¹|to judge (vb)
náva¹|hollow (adj)
náva²|*mouth (including tongue, lips and teeth), speech apparatus (n)
páva|mouth (n)
náva-tengwë|consonant (n)
pávatengwë|consonant (n)
návë|being (n)
návëa|consonant, *consonantal (n adj)
naxa|sour (adj)
naxa¹|bond, fetter (n)
naxa²|evil (adj n)
-nca|your (plural familiar) (suf)
-ncë|you (plural familiar) (suf)
-ndacil|-victor, -slayer (suf)
-ndë|feminine agent (suf)
-(n)dil|-friend, -lover; devotion, disinterested love (suf)
-dil|-friend, -lover (suf)
-nil|-friend, -lover (suf)
-ndo|(masculine) agent (suf)
-ndon|-like, -ily (suf)
-ndor|land, country (suf)
-nor|land, country (suf)
-(n)dórë|-illion, *large number suffix (suf)
-(n)duinë|(large) river (suf)
-duinë|(large) river (suf)
nuinë|river (suf)
-(n)dur|servant; ⚠️to serve (suf)
-dur|-servant (suf)
-nur|-servant (suf)
né|ago, behind (earlier time); yes (it was so) (adv)
nec-|without (pref)
néca|pale, vague, faint, dim to see (adj)
necel|thorn (n)
necermëa|insubstantial, immaterial (adj)
necestel|hopelessness, despair, desperation (n)
nef-|to breathe (air) (vb)
nefítë|air-breathing (adj)
nehta-|to deprive (vb)
nehtano|one deprived, exile whose rights and goods have been confiscated (n)
nehtar|slayer (n)
nehtë¹|spearhead, gore, wedge, narrow prominitory; angle (n)
neccë|angle (n)
nehtë²|honey; ⚠️[ᴹQ.] honeycomb (n)
nehtelë|honeycomb (n)
nelca|dense (adj)
neldë|three; ⚠️[ᴱQ.] four (cardinal)
neldëa|third (ordinal)
nel(d)esta|one third (fraction)
nelsat|one third (fraction)
nelta|one third (fraction)
nelecco|fork, (lit.) three-thorn (n)
nellon|granite, (lit.) tri-rock (n)
nellumë|thrice, three times (adv)
nelma|needle (n)
nelmasirpë|thistle, (lit.) needle-stalk (n)
nastalaima|thistle, (lit.) spear plant (n)
nelqua|cornered, *angled (adj)
nelquain|thirty (cardinal)
nelequain|thirty (cardinal)
nelequëan|thirty (cardinal)
nelquë|*thirteen (cardinal)
quainel|*thirteen (cardinal)
yunquentë|thirteen (cardinal)
yunquenta|thirteen (cardinal)
nelquëa|*thirteenth (ordinal)
nelquesta|one thirteenth (fraction)
neltë|corner (n)
nelya|third (ordinal)
nelya-|to thicken, congeal (vb)
nelya-|to thicken, congeal (vb)
lelya-³|?thick, thicken & congeal (vb)
nem-²|[ᴹQ.] to seem, appear (vb)
nemba|seeming, evident, probably but not necessarily so (adj)
nembalë|evidence (n)
nemesta|appearance, seeming (n)
-nen|instrumental (suf)
nen|nostril (n)
nén|water, ⚠️[ᴱQ.] river (n)
nenda|wet (adj)
néna|wet (adj)
nenya|wet (adj)
ninda|wet (adj)
nendalaurë|golden water-flower, yellow iris (n)
nendë|lake, [ᴹQ.] pool (n)
nendil|beast that lives in the water (n)
nendo|water mead, *watered plain (n)
nengarmo|otter, (lit.) water-wolf (n)
Nénimë|February, *Wet-ness (n)
nenquet-|to condescend, (orig.) speak down the nose (vb)
nenta-|to pretend, (lit.) make seem (vb)
nenungol|octopus, (lit.) water-spider (n)
nér|man, male person; [ᴹQ.] adult male; ⚠️[ᴱQ.] husband; warrior (n)
nercë|little man (n)
nerdo|large, strong man (n)
ne(re)sta|one ninth (fraction)
nersat|one ninth (fraction)
nernehta|man-spearhead (n)
nertë|nine (cardinal)
nertëa|ninth (ordinal)
nes|food, feed, fodder (n)
nésa|sister (n)
nessamelda|species of tree in Númenor, (lit.) beloved of Nessa (n)
nessë|past tense, (lit.) nē-ness (n)
nesselë|pasture, mead[ow]; pasturage (n)
nessornë|sapling (n)
nesta-¹|to graze, pasture, give to feed, feed (vb)
nesta-²|to heal (vb)
nestando|healer, physician (n)
nestië|(act of) feeding (n)
nesya|gay, lively, girlish (adj)
net-|to get (vb)
net(ë)|one more beyond (the middle) (n)
neterquain|ninety (cardinal)
neterquëan|ninety (cardinal)
neterquë|nineteen (cardinal)
neterquëa|nineteenth (ordinal)
netil|trinket, small thing of personal adornment (n)
netsë|little sister, ‘lil sis’ (intimate) (n)
nettë|(little) girl, ⚠️sister (diminutive), ️daughter, pretty little thing (n)
netto|big sister, ‘big sis’ (intimate) (n)
netya|pretty, dainty (adj)
netya-|to trim, adorn (vb)
nev-|to face, turn toward, *confront (vb)
nev-|to try, *seek opportunity, experiment (vb)
nav-²|to try (vb)
nevië|experiment (n)
riquë|experiment (n)
nexa|sharp, angular (adj)
nerca|sharp, angular (adj)
néya|once, at one time (adv)
nëa|once, at one time (adv)
-ngwa|our (inclusive dual) (suf)
-lma³|our (inclusive dual) (suf)
-nqua|our (inclusive dual) (suf)
-ngwë|we (inclusive dual) (suf)
-ngë|we (inclusive dual) (suf)
-ngo|we (inclusive dual) (suf)
-lmo|we (inclusive dual) (suf)
ni|me, I (pron)
ní|beneath, not touching, under (prep)
níca|little, small (adj)
nicë|little, a bit (adv)
nícë|little finger (n)
nienaitë|tearful (adj)
nieninquë|snowdrop, [ᴹQ.] (lit.) white tear (n)
nieninquëa|like a snowdrop (adj)
nier|(honey) bee (n)
nieres|hive (n)
niétë|oozing, dripping, exuding (n)
nihta|piece, bit (of indeterminate size) (n)
nihta-|to reduce, make small (vb)
nihtana|reduced, minor (adj)
nil-|to love, have special concern/care/interest for (vb)
nílë|a special concern with or love for (n)
nillë¹|silver glint; Valinorian imagines [images of real stars] (n)
nillë²|small [woman] (n)
nilmë|love, concern for things other than self for their own sakes (n)
nimba|facing, confronting (adj)
nimba-|to face, go forward (vb)
nimbë|gloom, sadness (n)
nimpa|drooping, ailing (adj)
nimulë|phantom, a seeming (n)
níma|phantom, a seeming (n)
nindornë|palm-tree (n)
ninquë|white; chill, cold; pallid (adj)
ninquelë|pallor (n)
ninquita-|to whiten, grow white, [ᴹQ.] make white; to shine white (vb)
ninteccon|chalk, (lit.) white writing rock (n)
nípa|small (usually with connotation of weakness) (adj)
niqu-|to be chill, cold, freeze (of weather), ⚠️snow (vb)
nicu-|to be chill, cold, freeze (of weather), snow (vb)
niquë|cold; ⚠️[ᴹQ.] snow (n)
niquessë|frost-patterns; snowflake, ice-flake; (lit.) chill feather (n)
niquis|snowflake, ice-flake; petal (loose) of a white flower; ⚠️frost-patterns, [ᴱQ.] snow (n)
nir-|to press, thrust, force (in a given direction); *to impose (with allative) (vb)
níra|will (as a potential or faculty), individual will (in potential) (n)
nírë|force (n)
nírítë|forceful, exerting great thrust or pressure, driving (adj)
nirmë|act of will, exercise of will (n)
nirmunqua|willful (adj)
nirya-|to lean against (vb)
nis-|*to smell sweetly (vb)
nís|woman (n)
nissë|woman (n)
nisilë|fragrance, perfume (n)
nisilëa|perfumed (adj)
nísima|fragrant (adj)
nisquë|incense, *(lit.) sweet smoke (n)
ussa|incense (n)
nista|thrust, push, shove (n)
nista-|to perfume (vb)
nisto|large woman (n)
niswa|censer (n)
níta-|to weep, cry [tears] (vb)
nitya|little (adj)
nityahan|little brother (informal/familiar) (n)
nityanet|little sister (informal/familiar) (n)
nívë|face (n)
nixë|frost; ⚠️ice-flake or snow-flake (n)
-nna|(movement) to, towards, onto, at (arriving at a point); allative suffix (suf)
nó|design (n)
nó-|to be born, ⚠️become (vb)
onya-|to be born, be begotten (vb)
nó¹|before (of time); at back (of place); [ᴹQ.] yester-; [ᴱQ.] after (of place), behind; ⚠️after (only of time); than (prep conj)
nöa|yesterday; former, *previous; ⚠️tomorrow (adj n)
noirë|tomb (n)
nólaimë|foreshadowing (n)
nólë|lore, knowledge, long study; [ᴹQ.] wisdom (n)
nólecöa|school, (lit.) house of lore (n)
nollo|already (adv)
nolmar|school, university, (lit.) wisdom-house (n)
nolmë|knowledge, philosophy (including science), department of wisdom (science, etc.) (n)
nolmo|wise person (n)
nolpa|mole (n)
nolta-|to teach, *educate, tutor, (lit.) make knowledgable (vb)
noltar|teacher (n)
nolya|dark-haired, *brown-haired (adj)
hróva¹|dark, dark brown (of hair) (adj)
loxa|brown of hair (adj)
nolya-|to study, ⚠️learn (vb)
cenya-|to study (vb)
nómë|place (n)
nómëa|local (adj)
nómessëa|local (adj)
nómessë|place-name (n)
-non|-place, -spot (forms place-names, area nouns) (suf)
nóna|born (adj)
nónarë|generation (n)
nonda|hand especially in (?clutching) (n)
nónië|birth (n)
nonóra-|to run on, run smoothly and hum, *keep on running (especially of machines) (vb)
nonwë|calculation, sum, *total (n)
nonwë|calculation, sum (n)
nópata-|to precede, (lit.) to walk before (vb)
nóquista-|to assume, make premature judgements (vb)
apacíta-|to assume, make premature judgements (vb)
nór|land (n)
nor-¹|to run (or leap, of animals or men) (vb)
nor-²|fear (pref)
nórarwa|economy, (lit.) country-wealth (n)
nórë|land, country, [ᴹQ.] region where certain people live, [ᴱQ.] nation; [Q.] †people, race, tribe, [ᴹQ.] folk, ⚠️[ᴱQ.] family (n)
nórëa|national (adj)
nórecáno|governer, (lit.) country-leader (n)
noremma|map (n)
nórihalmë|map (n)
noremmatan|cartographer (n)
nóretur|governer, (lit.) country-ruler (n)
norië|running, ⚠️race (n)
nóriecáno|president (n)
nórima|strong/swift at running, swiftly running a course (adj)
normë|race (running) (n)
norna|tough, stiff; hard, firm, resistant; thrawn, obdurate (adj)
Norno|Dwarf (n)
norno|oak (n)
nordo|oak (n)
nornolassëa|having oak-leaves (adj)
noroitë|(capable of) running (adj)
norolinda|*tripping lightly (adj)
norollë|cart (n)
norta-|to make run (specially used of riding horses or other animals), ride (vb)
norta-|to stay (vb)
nortil|cape (of land) (n)
nos(së)|kindred, family, [ᴹQ.] clan, ‘house’, ⚠️[ᴱQ.] folk, kin, people (n)
nossetur|patriarch, family head (n)
atartur|patriarch, (lit.) master-father (n)
nosta|birth, ⚠️birthday (n)
nosta-|to beget, [ᴱQ.] give birth to; [Q.] to be begotten, *be born [impersonal]; ⚠️[ᴱQ.] to cause (vb)
nostalë|species, kind, *type, sort; ⚠️nature (n)
nostar|*ancestor; ⚠️parent, begetter (n)
ontari(l)|*mother, (lit.) genetrix (n)
nostarë|birthday (n)
nostarenca|orphaned, (lit.) parent-less (adj)
not-|to count, [ᴹQ.] reckon (vb)
nótar|computer, calculator (n)
nonwa|computer, (lit.) implement for reckoning (n)
notil|calculator (n)
notessë|numeral (n)
notessëa|numeral, digital (adj)
nótië|*counting (n)
nótima|countable, limited in number (weight and measure); (colloquial) moderate in amount, some, few, several (adj)
-nquë|thou-and-I (dual) (suf)
-inquë|thou-and-I (dual) (suf)
-nta¹|their (suf)
-ntya|theirs (suf)
-nta²|they (neuter) (suf)
-ntë|they (suf)
nu|under, beneath (prep)
nú-|going down, setting (of sun), west (pref)
nuhta-|to stunt, prevent from coming to completion, stop short, not allow to continue (vb)
nuinerocco|hippopotamus, (lit.) river-horse (n)
núla¹|dark, occult, mysterious (adj)
núla²|under [beyond] (prep)
núlë|black arts, sorcery (n)
núlemo|(evil) sorceror, black magician (n)
ñulma|mystery (n)
numba|bent, humped (adj)
numbë|timidity (n)
numbëa|timid (adj)
númen|west, direction or region of the sunset, occident, (lit.) going down (n)
númë|west (n)
núna|western (adj)
(n)ungwar-|to undermine, weaken, hinder, sabotage, sap, (lit.) to under/down-fret (vb)
nungwë|cold (in the nose or head) (n)
nunya|lower (as in quality, rank or value) (adj)
nupattal|horseshoe (n)
nuqua|obstacle (n)
nuquerna|reversed, inverted, *(lit.) under-turned (adj)
nur|complaint, ⚠️growl (n)
nur-|to serve (vb)
núrë|maid servant, servant-woman (n)
núrie|depth (abstract) (n)
nurmë|subordination (n)
nurmea|subordinate, lesser (adj)
nurno|dark, deep (of hue) (adj)
núromolië|ministry, (lit.) servant-labour (n)
nurru-|to murmur, grumble, mumble (vb)
nurrulë|murmuring (n)
nurta-|*to hide (vb)
nurtalë|hiding (n)
urtu|death (n)
núrula|grumpy, (lit.) likely to growl/grumble (adj)
nurunyel|foxglove, (lit.) death-bell (n)
nus|smell (n)
nustaima|odorous, (lit.) able to be smelled (adj)
nustë|sense of smell (n)
núta-|to lower; [ᴹQ.] to set, sink (of Sun or Moon); [ᴱQ.] to stoop (vb)
andúta-|to lower (vb)
nútaite|?lowering (naturally), degrading (adj)
nutanwë|infrastructure (n)
nútil|under-point (n)
nútima|*lowerable (adj)
nutta|comma, (lit.) that what ties or binds (together) (n)
nuxo|Petty dwarf (n)
núya-|to descend (vb)
andúya-|to descend (vb)
-nwa|passive suffix; active participle (intransitive verbs); [ᴹQ.] perfective participle (suf)
nwal-|to suffer, feel (great) pain (vb)
nwalmastarmo|martyr, (lit.) torment-witness (n)
nwalmë|torment (n)
nwámë|wolvish howling (n)
nwar-|to fret, wear away, [ᴹQ.] erode; to gnaw (vb)
nwátengwë|irony, (lit.) disguise-token (n)
-nya|my (suf)
nyaira|claim (n)
nyanda-|to gnaw (vb)
nyar-|to relate, recite, [ᴹQ.] tell, ⚠️talk (vb)
nyarda|list, (lit.) product of recitation (n)
nyarda-|to preach (vb)
nyardar|preacher (n)
nyárë|history, account, [ᴹQ.] tale, saga (n)
nyarmë|storytelling (general/abstract) (n)
nyarna|(long epic) tale, story, legend, [ᴹQ.] saga (n)
nyarnamaitar|storyteller, composer of long epic tales, *author (n)
nyarrincë|mouse (n)
nyarvë|fiction (n)
nyarvëa|fictional (adj)
nyas|scratch, score, line, mark (n)
nyas-|to scratch (vb)
nyasta|snack (n)
nyat-|to talk idly, *gossip, chat (vb)
nyatil|idle talk, gossip (n)
nyatso|magpie, (lit.) chatterer (n)
-n(yë)|I (suf)
-n¹|I (suf)
nyé|bleat, cry of goat or sheep (n)
nyel-|to chime, to ring (like a bell) (vb)
nyelecca|onyx (n)
nyelet|nail (of the finger) (n)
nyellë|[ᴹQ.] bell, ⚠️[Q.] small bell (n)
nyéni|(she) goat (n)
nyenya|querulous, tearful, plaintive (adj)
nyenyë|weeping (n)
nyérë|grief (n)
-o|of; genitive ending (suf)
o|from (prep)
o-|together (pref)
wa-|together (pref)
ó|with (prep)
öa|away (of movement) (adv)
öa-|to possess, own, keep (vb)
auta-²|to possess, own, keep (vb)
öamo|owner (n)
öapsar-|to wipe away (vb)
aupsar-|to wipe away (vb)
öar|away from (adv)
öatarië|apostasy, (lit.) away-standing (n)
ocantië|pattern (n)
ocar-|to cooperate, work together, participate (vb)
ocaraitië|program, a set of activities (n)
occa|knee (n)
ócom-|to gather, assemble (vb)
(o)combë|gathering, assembly, assemblage, collection, *congregation (n)
combë|gathering, assembly, assemblage, collection (n)
(o)combëa|collective, assembled, cooperative, concerted, corporate, consolidated (adj)
ofelmë|sympathy, compassion, pity, *(lit.) together-feeling (n)
ohérë|government (n)
ohéressë|politics (n)
ohéressëa|political (adj)
ohlon|diphthong (n)
oholima|confidential (adj)
ohta|war (n)
ohtar|warrior (n)
ohtarië|martial ardour (n)
ohtë|egg (n)
oia(la)|everlasting, unceasing, without end, for ever (adj)
oialë|forever; everlastingly, eternally, in eternity; ⚠️[ᴹQ.] everlasting age (n adv)
oiavë|everlastingly (adv)
oialëa|eternal (adj)
oi(o)|ever, everlastingly; an endless period, *aeon (adv n)
oi|ever, everlastingly (adv)
oiolairë|ever-summer (a species of tree) (n)
oiwa|glossy (adj)
oiwië|gloss, glossiness (n)
ola-|to become; [ᴹQ.] to grow (up) (vb)
óla-|to dream (impersonal) (vb)
ólama|consonant (n)
ólamaitë|consonantal (adj)
olanwa|fully grown, adult, mature (adj)
olass(i)ë|foliage, collection of leaves (n)
olasta|growth (n)
ólav-|to compromise (vb)
ólavië|compromise (n)
olba|branch (n)
olca|bad, wicked (adj)
ólemë|elbow (n)
olië|company, people together (n)
ólië|society, (lit.) together-people (n)
ólëo|society, (lit.) together-people (n)
olindë|harmony (n)
olirië|concert (n)
olla|over [beyond] (prep)
ollë|*other one (adj)
olmen|growth-year (n)
olmië|growth (n)
olmos|chestnut tree, *chestnut (n)
oloirë|great flood (n)
oloiya-|to inundate, flood (vb)
olopsë|broom (n)
olor|dream, vision (n)
olos²|dream, vision (n)
olorda|dreamy, drowsy; in dreams (adj)
olorië|theory (n)
olos¹|inflorescence, mass of flowers (n)
lós|inflorescence, mass of flowers (n)
olosta|dreamy, *dreamlike (adj)
olótë|bloom, the flowers collectively of a single plant (n)
olotsë|collection of flowers (n)
olpë|bottle (n)
olva|plant, growing things with roots in the earth (n)
óma|voice, resonance of the vocal chords, vowel (n)
óman|vowel (n)
ómatailë|vowel lengthening (n)
ómataima|vocalic extension (n)
ómataina|vocalic extension (n)
ómatehta|vowel-sign (n)
óma-tengwë|vowel-sign (n)
ombari|company, dwellers together (n)
ómëa|vowel; [ᴹQ.] voiced (n adj)
omen-|to meet, move to a common point, *(lit.) move together (vb)
ómen|crossroads (n)
oment-|to meet (vb)
omentië|meeting (of pathways), (lit.) coming together of journey-path, meeting or junction of the directions of two people (n)
omírë|jewelry (collectively) (n)
omolmë|company, business, enterprise, firm (n)
omolmessë|corporation (n)
omya-|to resonate (of longer sounds) (vb)
-on¹|masculine suffix (suf)
-on²|augmentative, great (suf)
onda|creation, work (n)
ondo|stone (as a material), (large mass of) rock (n)
ondolë|(stone) monument or cairn (n)
ondolunca|stonewain (n)
ondomaitar|sculptor in stone (n)
ondomillo|petrol, petroleum, gasoline, gas (n)
ondopelet|pickaxe (n)
ondórëa|hard-hearted, pitiless (adj)
ondosercë|stonecrop, plant with red flowers, (lit.) blood of stone (n)
ondova|stony (adj)
ongolmë|geology (n)
ongolmo|geologist (n)
ongwë|crime (n)
ongwemo|criminal, transgressor (n)
onin|anvil (n)
onna|child, *offspring; ⚠️[ᴹQ.] creature (n)
onwë|child (n)
onóna|twin-born; one of a pair of twins (adj n)
onot-|[ᴹQ.] to count up, *reckon (vb)
(o)notasta|amount (n)
onótië|*reckoning (n)
onótimo|*reckoner (n)
onta-|to beget, *conceive (a child); [ᴹQ.] to create (vb)
ontalë|descent, *derivation, ancestry (n)
ontamo|mason, ⚠️sculptor (n)
ontar|parent (gender neutral) (n)
ontavalië|puberty, *(lit.) able to beget (n)
onya|my child (n)
ópa|mouth (opening of which the lips are the edges) (n)
or|above, [ᴱQ.] upon; ⚠️on (prep)
or-|to warn, urge, feel an urge/wish/desire (vb)
ora-|to warn, urge, feel an urge/wish/desire (vb)
oranar|noon, (lit.) above Sun (n)
órava-|*to have mercy (vb)
ócama-|*to have mercy (vb)
orco|Orc (n)
orda|profound (adj)
orda-|to threaten (vb)
órë|heart (inner mind), *conscience; warning, caution, (pre)monition (n)
orendë|(nuclear) family (n)
ori|grain, ⚠️seed (n)
oricon|heather (n)
óricuva|traitor (n)
óricuvoitë|uncommunicative, keeping one’s own counsel (not necessarily sinister) (adj)
orina|risen (adj)
óripanta|sincere, honest, open, (lit.) open-hearted (adj)
ormo|riser (n)
ornë|(tall) tree, [ᴹQ.] high isolated tree (n)
ornemalin|[tree] bearing yellow flowers (n)
ornendur|tree-keep, forester, woodsman (n)
oro|mount, mountain, ⚠️hill (n)
oro-|up, aloft (pref)
orohalla|superior (adj)
orolanda|upland, plateau (n)
oroman|mountain dweller (n)
oromar|lofty hall, high-mansion, high (lofty) dwelling (n)
oron|mountain (n)
oroparmen|high school, university (n)
orosta|ascension (n)
orotinga|mountain-top (n)
orpano|ridgepole (n)
orróna|eastern (adj)
orsa|upper, above (adj)
orta-¹|to raise, cause to rise, lift (up) (vb)
orta-²|to rise (vb)
ortil|up-point (n)
ortírië|*patronage, (lit.) watching over (from above) (n)
ortirmo|overseer (n)
orto|[ᴹQ.] mountain-top; ⚠️[Q.] mount, mountain (n)
ortosta|mountain range (n)
ortur-|to overpower, conquer, prevail (vb)
orva|apple (n)
orvamir|chrysoprase, (lit.) apple-jewel (n)
orwa|high, lofty (adj)
orna|high, lofty (adj)
orya-¹|to rise (vb)
orya-²|*to raise (vb)
oryandë|arising (n)
oryat|badger (n)
os|around, about, ⚠️round (prep)
osáma|common, joint, (lit.) together-having (adj)
ósana-|to counsel, think together (vb)
ósanwë|communication of thought, interchange of thought; (lit.) thinking together (dual) (n)
ósat-|to share (vb)
oscaita-|to surround, (lit.) around-lie (vb)
oscir-|to circumcise, (lit.) around-cut (vb)
ospor|chaff (n)
osquetië|context (n)
ossa|surrounding (adj)
ossië|surroundings (n)
ostar|community (n)
ostec-|to describe (vb)
ostimë|blend (n)
ostimmir|agate, (lit.) blend-jewel (n)
osto|fortress, stronghold, strong place; [ᴹQ.] city, town with wall round (n)
ostomo|citizen (n)
oswë|hip (n)
otarmië|colonnade (n)
otolmië|keyboard (n)
otoquain|seventy (cardinal)
otoquëan|seventy (cardinal)
otoquë|seventeen (cardinal)
otoquëa|seventeenth (ordinal)
otornië|company, association, alliance (n)
o(to)sta|one seventh (fraction)
otsat|one seventh (fraction)
otsëa|seventh (ordinal)
otso|seven (cardinal)
osco|seven (cardinal)
otos|seven (cardinal)
otsola|(seven-day) week (n)
otsolametta|weekend (n)
otsollumë|seven times (adv)
ovanta-|to meet (vb)
ovëa|(con)similar, alike (adj)
ovéa|(con)similar, alike (adj)
vávëa|(con)similar, alike (adj)
ovëanta-|to imitate, make like (vb)
ovëantainë|imitation (n)
ovëassë|resemblance; likelihood (n)
ovesta|contract, compact, treaty (n)
pá|touching, against, on (above but touching); as regards, concerning, [ᴹQ.] about (prep)
apa²|touching, against, on (above but touching) (prep)
pahta-|to speak, talk (intransitive) (vb)
pakta-|to speak, talk (intransitive) (vb)
pahta¹|closed, shut, private (adj)
pahta²|speech (n)
pahtalanga|interpretation (n)
pahtalanga-|to translate (speech), interpret (vb)
pahtando|orator (n)
carpando|orator (n)
paimë|vengeance taken, punishment, penalty, infliction (n)
paimenë|vindictiveness, vengefulness, cruelty (n)
paimesta|chastisement (n)
paimeta-|to exact or inflict a penalty, punish (vb)
pairë|vengeance, revenge (n)
pairemo|avenger (n)
paireta-|to avenge, take vengance (vb)
paitya-|to repay, requite (vb)
paityalë|reward, payment (n)
palallon|telephone, (lit.) far-sound (n)
palanóma|phone (n)
palampa|drum (n)
palan|far, wide, afar, distant; [ᴹQ.] to a great extent, over a wide space, to a distance (adj adv)
palancen|television, (lit.) far-sight (n)
palancenta|telecommunication (n)
palantilla|telescope (n)
palantir-|to watch/look afar (vb)
palantír|far-gazer, far-seer, (lit.) that which looks far away (n)
palanyantië|telepathy (n)
palantímië|telepathy (n)
palda|plate, dish, platter (n)
palda|wide, broad, *expansive (adj)
palis|sward, green, lawn (n)
paswa|sward (n)
palla|far beyond (prep adv)
palma¹|flat tool, flat plank, oar (n)
palo|plane (surface), the flat, *level, flatness; ⚠️plain (n)
palta|flat of the hand, *palm; [ᴱQ.] shelf (n)
palta-|to feel with the hand, stroke (vb)
paltalda|palm tree (n)
paluhta|table (n)
paluhtincë|tablet (n)
palma²|tablet (n)
palúna|swollen (adj)
palusta|shelf, bookshelf (n)
palwa|even, level, flat (adj)
pampilë|trembling (n)
pampilëa|tremulous (adj)
pampinë|tremor, earthquake (n)
pan|*since, because (conj)
pan|*since (conj)
pan-|*to arrange, set in order (vb)
panin|definite, planned, concerted, deliberate, prepense, meant (adj)
panna|arrangement, grouping; *plan, course; ⚠️book (n)
pantië|unfolding, opening, ⚠️revealing (n)
panwë|arrangement, plan; structure, ordering; (musical) theme (n)
panyalë|meaning, intention (n)
pap-|to tremble (vb)
par-|to learn (vb)
parahta-|to dry (vb)
parcata-|to dry something, dry up (vb)
parandë|(school) lesson (n)
parca|naked (of persons) (adj)
parco|towel (n)
parma|book, writing, composition, written document of some size; ⚠️[ᴱQ.] skin, bark; parchment (n)
parmacas|bookcase (n)
parmahenta-|*to read (vb)
parmahentië|(book) reading (n)
parmahto|author (n)
parmalas(së)|page, (lit.) leaf of book (n)
parma-resta|*book-fair (n)
parmasan|library [room] (n)
parmassë|literature, ⚠️library (n)
parmasson|librarian (n)
parmatéma|p-series (n)
parmen|school, place of study (n)
parmo|student, (lit.) learner (n)
nólemo|student (n)
parnë|bald, bare, ⚠️naked (adj)
parna|bare (adj)
parta-|to arrange, compose, order (vb)
partalë|order, orderliness, organization (n)
partië|arrangement, composition (n)
pas-|to smooth (vb)
pásë|linen (n)
páselanne|linen-cloth (n)
páselarma|linen-raiment (n)
pasta|smooth(ed), sleek, glabrous (adj)
passa|smooth, glabrous (adj)
pasta-|to smooth, iron (vb)
pat|step (n)
pat-|to step, take a (single) step (vb)
pata-|to walk, *stroll; [ᴱQ.] to rap, tap (of feet) (vb)
pataca|consonant (n)
patacë|clatter (n)
patahta-|to clatter; *to clap (+ instrumental of hands) (vb)
patinca|slipper, ⚠️shoe (n)
patta|smoothed, sleek (adj)
pattal|hoof (n)
patu-|to step to it, start off, start walking (vb)
pé|(closed) mouth; the two lips [as dual], ⚠️lip (n)
pëanta-|to give instructions to, enjoin, ⚠️give into one’s hands, *teach (vb)
pëantar|teacher (n)
pecco|nut (n)
peccuvo|squirrel, (lit.) nut-hider (n)
pehtë|cox-comb, *crest (of birds), ⚠️plume (n)
pel-|to go round, encircle; [ᴱQ.] to surround, fence in, pen in; ⚠️[ᴹQ.] to revolve, return (vb)
pelas|along, (lit.) by the boundary of (prep)
pelecco|axe (n)
pelin|fenced in, pent (adj)
pella|beyond (boundary or limit) (prep adv)
pellauca|lukewarm (adj)
pellopë|donkey, ass (n)
pelma|border, fringe, edge, limiting device; [ᴱQ.] pen (n)
pelo|boundary (fence) (n)
pelta-|to roll (vb)
peltas|fence of fixed stakes, a ‘pale’ (n)
pempë|lip (n)
pen|without, not having (prep)
pen-|not to have, *to lack (vb)
penda|sloping down, (steeply) inclined (adj)
penda-|to slope, incline (vb)
pendë|steep incline, hillside, [ᴹQ.] (down) slope, declivity (n)
penga-|to pout (vb)
pengëa|labial, of the lips (adj)
penië|lack, want, shortage (n)
penna|lacking; vowel (adj n)
penno|poor man (n)
penquanta|full to the brim, with mouth full (adj)
penta-|to lose (vb)
úhep-|to lose, (lit.) to un-keep (vb)
únet-|to lose, (lit.) to un-get (vb)
pentë|front (n)
hyámen|front (n)
pententa-|to mention, (lit.) indicate by mouth (vb)
pententalë|mention (n)
penya|lacking, inadequate; *poor (adj)
penyalë|poverty, deprivation (n)
pepella-|to circulate, orbit (vb)
pequ-|to comb, card wool, tease (vb)
pequen|comb (n)
per-|half, [ᴹQ.] semi (pref)
pérappa|bridle, (lit.) lip-rope (n)
antolatta|bridle, (lit.) mouth-strap (n)
percoron|hemisphere (n)
peresta|one half (fraction)
perta|one half (fraction)
peresta-|to disturb (vb)
perestië|disturbance (n)
Perian|Halfling (n)
permë|half; side (of person or shape) (n)
perranga|cubit (n)
persa-|to affect [sounds], ⚠️disturb, alter (vb)
persana|affected (adj)
persanië|affection (n)
pertol|peninsula (n)
perwaima|skirt, (lit.) half-robe (n)
pí|small insect, fly, *mite, gnat; ⚠️[ᴱQ.] speck, spot, dot, mote (n)
pia|little (adj)
pic-|to lessen, dwindle, wane (vb)
picara|leopard (n)
picina|little (adj)
pincë|little (adj)
piemillo|olive oil (n)
pihta-|to shrink (vb)
pil-|to steal (vb)
pilinehtar|a reed-like plant, (lit.) ?arrow thorn (n)
pilintan|fletcher (n)
pilu|thief, robber (n)
pilucca|stealthy, ⚠️secret (adj)
pilwë|robbery, theft (n)
pímótar|ant, (lit.) insect-worker (n)
pimpë|tail (n)
pimpilin|tassel, hanging tail (n)
pimpina|trailing (adj)
pio|berry, plum, cherry (n)
piopin|haws, fruit of hawthorns (n)
pirë|toe (n)
pirin|thin rod, pin (n)
pirina|juicy, oozy (adj)
pirindë|flower that opened and shut quickly with any change of light (n)
pirnë|flower that opened and shut quickly with any change of light (n)
pirindëa|cylindrical (adj)
pirinumbë|cylinder (hollow) (n)
pirucendëa|on the point of her toes (adj)
píta-|to reduce, decrease (vb)
pitya|petty, little (adj)
piuca|blackberry (n)
poco|bag (n)
pocollë|pouch (n)
poco(lle)nyarro|opossum, (lit.) pouch-rat (n)
poita-|to cleanse, *clean (vb)
poitië|(act of) cleaning, cleansing (n)
pol-|can, to be able to (vb)
polca|pig (n)
polda|big; [ᴹQ.] strong, burly; ⚠️[ᴱQ.] mighty, powerful (adj)
poldavë|strongly (adv)
pollië|hard, strongly (adv)
polë|meal, grist, [ᴹQ.] flour, [ᴱQ.] oats, grain (unground kernels of oats, wheat, etc.) (n)
polëa|able (adj)
polië|ability (n)
pollo|ram (n)
polondë|alder (n)
polta-|to (physically) enable (vb)
póna|forward (adv)
ompa|forward (adv)
popólu-|to practice, (lit.) slowly gain ability (vb)
porisalquë|corn, (lit.) flour-grass (n)
porocë|hen, barn fowl, *chicken (n)
poroton|proton (n)
Portucalëo|Portuguese (n)
poru|kernel (n)
psar-|to rub, [ᴹQ.] fret (vb)
pucco|cunnus, vagina (n)
puhta|coitus, *sex (n)
puhta-|to copulate, have sex (vb)
puhtëa|sexual (adj)
pulco|trunk, bole of tree, *torso, ⚠️body (n)
púlima|pourable, liquid (adj)
pulmaxë|leaven(ing), *yeast (n)
pulta-|to make swell, leaven (vb)
puncil|male organ, penis (n)
pupso|large fly, [ᴹQ.] blow fly (n)
púrëa|smeared, discoloured, bleared (adj)
quá|duck (n)
quaccas|tadpole, (lit.) frog head (n)
quácë|frog (n)
quáco|crow (n)
quaican|*fourteen (cardinal)
quaihúmë|ten thousand, myriad (cardinal)
quainëa|tenth (ordinal)
caina|tenth (ordinal)
quainque|*sixteen (cardinal)
quainyë|decade (n)
quaista|one tenth (fraction)
caista|one tenth (fraction)
cast|one tenth (fraction)
qual-|to die (vb)
qualmëa|deadly, deathly (adj)
qualöa(va)|annual, yearly, perennial (year as whole) (adj adv)
qualta-|to kill, murder (vb)
firta-|to kill (vb)
qualussë|perfect tense, (lit.) full tense (n)
quam-|to be ill, vomit (vb)
quámëa|sick, *nauseous (adj)
quamna|vomit (n)
quampa|peddlar-goods (n)
quampa-|to hawk goods (vb)
quampalë|chaffering, *haggling, bargaining (n)
quampo|pedlar, huckster (n)
qua(na)|all, complete, entire, full, the whole (adj pron)
quanta|full, filled; ⚠️[ᴱQ.] whole, all (adj)
quanta-|to fill [something], *(lit.) make full; [ᴱQ.] to complete, *fulfill (vb)
quantassë|fullness (n)
quantemma|facsimile, *(lit.) full-picture (n)
quantolië|maturity (n)
quap-|to chaffer, bargain, swap, barter (vb)
quapta|deal, bargain (n)
quapta-|to exchange (vb)
quaptalë|exchange (n)
quaptando|money-changer, (lit.) exchanger (n)
quaqua-|to quack, squawk, cackle, *croak (vb)
quaran|full-moon (n)
quár(ë)|fist, closed hand (n)
quas-|to shake, flap, nod, ⚠️rustle (vb)
quat-|to fill, *be filled (vb)
quëa|vegetable (n)
quëallumë|ten times (adv)
quëan|ten (cardinal)
cëa(n)|ten (cardinal)
cainen|ten (cardinal)
quain|ten (cardinal)
quëatarwa|vegetable or kitchen garden (n)
quel-|to fade; ⚠️[ᴹQ.] †to fail; [ᴱQ.] to perish (vb)
quelehtë|carcass (n)
quelehtië|rot, corruption (n)
quelehtima|corrupt, rotten (adj)
queletya-|to perish (vb)
quelië|*fading (n)
quellë|late autumn and early winter, (lit.) fading (n)
quelmë|ruin, utter end, perdition, ⚠️end, death (n)
quén|person, individual, man or woman; one, somebody (n pron)
Quendë|Elf, (lit.) One That Speaks (n)
quendi|female Elf (n)
quendu|male Elf (n)
Quenderin|Quendian, of the Quendi, belonging to the Elves as a whole (adj n)
quenelya|of the Elves (adj)
quenna|saying, proverb (n)
quenna|saying, proverb (n)
quennasta|syntax (n)
quenso|minstrel, reciter (n)
quenta|story, narrative, account, history, [ᴹQ.] tale (n)
quentalë|history, narration, [ᴹQ.] account (n)
quentaro|speaker, reciter; [ᴹQ.] narrator, minstrel (n)
quentasta|historical account (n)
Quenya|Elvish, High-elven, Elf-latin, †speech; ⚠️[ᴹQ.] belonging to the Qendi, Quendian (n)
Quendya|Elvish (n)
Quenyarin|*of Quenya (adj)
quequer-|to wag (vb)
quer-|to turn, *revolve (vb)
querda|turn (e.g. in a game) (n)
querë|revolution (n)
pelë|revolution (n)
queren|pivot, revolving centre (n)
querma|spinning wheel, turn-table, *wheel (n)
quermen|a turning, turn, corner (of a street) (n)
querna|*turned (adj)
quernamo|proselyte, convert (n)
quessamin|velvet, (lit.) downy silk (n)
quessë|feather (n)
quessehonda|frivolous; (lit.) feather-hearted (adj)
quessetéma|kw-series (n)
questa|speech, language (n)
quet-|to say, speak, tell, ⚠️[ᴱQ.] talk (vb)
quetië|words, *(lit.) saying (n)
quétima|speakable, pronounceable, [ᴹQ.] utterable, *able to be said (adj)
quetítë|having speech, able to talk, good at expression, glib (adj)
quetta|word (n)
quettacarmë|(art of) word-making (n)
quettalcar|renown, (lit.) word-glory (n)
quettalë|sentence; wording, expression, phrase (n)
quettapano|morpheme, (lit.) word-element (n)
quettaparma|wordlist, wordbook (n)
quetyar-|to pronounce, (lit.) cause vocal speech (vb)
quetyarmë|pronunciation (n)
qui|if (conj)
cé²|if (conj)
iqui|if (conj)
quí(ta)|if (conj)
quihta|shot, projectile (from a bow or a crossbow) (n)
quihta-|to shoot (vb)
quilda|quiet, hushed, still (adj)
quilda-|to stay quiet, be quiet, ⚠️rest (vb)
quildarë|bat (n)
quilde|quiet, rest, hush (n)
quilë|colour, color, hue (n)
quilëa|coloured, colored, -hued (adj)
quilin|adorned; (orig.) bright-coloured, *embellished; ⚠️embroidered (adj)
quilinoitë|[em]broidered (adj)
quilma|paint (n)
quilta|belt, ⚠️girdle (n)
quilta-|to gird, encircle (vb)
quiltaina|girdled, girt (adj)
quiltalannë|apron (n)
quiltassë|(em)broidery (n)
quilya-|to colour, color, embellish, *paint, ⚠️adorn (vb)
quima|whether (conj)
quin-|to speak high, squeak (vb)
quín(ë)|crest, ridge (n)
quínë|squeaking, *squeak (n)
quínëa|squeaking (adj)
quinga-|to twang, thrum (of strings, harps, etc.) (vb)
quinna|crested (adj)
quinqua|languid, *lazy, relaxed, ⚠️drooping (adj)
quinquelë|languor, *relaxation (n)
quinquelëa|languorous, *relaxing (adj)
quinquenna|Solomon’s-seal (n)
quint|loop, stitch (in knitting) (n)
quiquië|whenever (adv)
quië|whenever (adv)
quir-|to stir, make spin (vb)
quiril|spindle; [spinning] top, *whirligig (n)
quirilda|twirling, pirouetting (adj)
quirmë|cream (n)
quista-|to suppose (vb)
quit-|to knit (vb)
quitima|(for) knitting (adj)
quitin|knitted, joined tight (adj)
quitulma|scenario (n)
quol-|to ail, *be sick (vb)
quolimo|invalid (n)
quolina|ill, sickly, ailing (adj)
quolu|disease (n)
quolúva|pestilent, pestilential (adj)
quolúvië|pestilence (n)
quonda|choking smog, smoke (n)
quor-|to choke, suffocate, (esp.) drown (vb)
quorin|drowned, choked, speechless (adj)
quosta-|to choke, drown (trans.) (vb)
-r¹|plural suffix (suf)
-r²|motion to or towards a point, *archaic allative (suf)
rá¹|lion (n)
rá²|*for, on behalf of (prep)
hrá|*for, on behalf of (prep)
meter|*for (the purpose of), towards the end (prep)
atar²|*for (prep)
rac-|to break (vb)
rac-|to curse (vb)
racco|curse (n)
racina|stripped, deprived (adj)
rácina|broken (adj)
racon|cobblestone, (lit.) broken stone (n)
rácumbar|aconitum, wolfsbane, (lit.) wolf-doom (n)
raf-|[ᴹQ.] to snatch, seize; ⚠️to wave, brandish (vb)
rahta-|to stretch out, reach (vb)
rahtë|extent, reach; region, sphere, district, scope (n)
raica|crooked, [ᴹQ.] bent, wrong (adj)
raica-|to falsify (vb)
raicë|wrong (n)
raima|net (n)
raina¹|netted, enlaced, caught in a net (adj)
raina²|smiling, gracious, sweet-faced (adj)
rainë|*peace, good will (n)
raita-¹|to make network or lace; to catch in a net (vb)
rëa-|to make network or lace (vb)
raita-²|to smile (vb)
raitando|gospel (n)
raiwë|lace (n)
ral-|to return (intransitive) (vb)
ralya-|to return (transitive) (vb)
ráma|wing; ⚠️[ᴱQ.] arm (n)
rámaitë|winged, having wings (adj)
ramba|wall (n)
rambil|drum (n)
rambil(lë)|(small) drum (n)
ramma|lever (n)
ramna|wing (horn) (n)
ramya-|to fly, sail; to wander (vb)
Rána|Moon, (lit.) Wayward (n)
ránasta|lunar month (n)
ranga|yard, full pace (n)
rangwië|fathom(ing), spatial reckoning/consideration (n)
ranqua|armful (n)
ranta|course (n)
rantala|ladder (n)
rantarwa|partner (n)
rantie¹|party (n)
rantie²|tribute (n)
ranya|erratic wandering; ⚠️[ᴹQ.] free (n)
ranyaila|wandering (adj)
ranyar|wanderer (n)
rapa-|to snatch (vb)
rappa|rope (n)
nurda|cord, rope (n)
ráquen|representative, ambassador (n)
ras-|to stick out (vb)
rasillo|squirrel (n)
rassë|horn [of both animals and mountains] (n)
rassëa|horned (adj)
rassemunda|rhinoceros, (lit.) horn-snout (n)
rassulca|carrot (n)
rata|path, track (n)
rata-|to make a way, find a way (vb)
ráta-|to excel, surpass (vb)
ratta|street, course, river-bed (n)
ratta|track (n)
rattaraxa|tram, (lit.) track-wagon (n)
raucëa|demonic (adj)
rauco|demon, powerful hostile and terrible creature (n)
arauco|demon (n)
rauca|demon (n)
raumo|(noise of a) storm (n)
rauro|lion (n)
rav-|to roar (vb)
ráva|free, unfettered, uncontrolled, lawless (adj)
rávë|roaring noise (n)
rávëa|roaring (adj)
ravennë|she-lion, *lioness (n)
raxa|wain, *wagon (n)
raxasta|train (n)
raxë|*danger (n)
raxëa|dangerous (adj)
-rë|abstract noun (suf)
ré|day (period from sunset to sunset) (n)
rëa|single (adj)
recca|spittle, *saliva (n)
rehta-|to rescue, save (vb)
rehtië|rescue, saving (n)
rehto|savior (n)
rel-|to sow (vb)
relyávalda|fig-tree (n)
relyávë|fig (n)
rem-|to snare (vb)
remba-|to net, entrap (vb)
rembë|mesh, net (for catching), hunter’s or fisher’s net (n)
rembina|entangled, meshed, netted, woven (adj)
remma|snare (n)
rempamba(lë)|basketball (n)
ren-|to remember (vb)
renda|related, of the same kin or clan (adj)
rendë|kinship, kin, kindred, clan (n)
rendo|male cousin, kinsman, *relative (n)
rendolë|cousinship (n)
rénë|memory (n)
renta-|to remind (vb)
rëo|smile (n)
raila|smile (n)
rerestë|scattering, diaspora (n)
rerindo|sower (n)
res-|to remain in same place (vb)
ressë|female cousin, kinsman, *relative (n)
resta|sown field, tilled ground, acre; *fair (n)
restandië|furlong (n)
restassë|countryside, the country (n)
restë|endurance (n)
ret-|to climb (vb)
retto|*climber (n)
ría|wreath, garland (n)
rië¹|[ᴹQ.] crown, ⚠️[Q.] garland (n)
riendë|garland (n)
rianna|queen (n)
ric-¹|to try, put forth effort, strive, endeavour (vb)
rihta-|to strive (vb)
ric-²|to twist (vb)
ricítë|diligent (adj)
rië²|only (adv)
riel(lë)|garlanded maiden, maiden crowned with a festive garland (n)
rihta|effort (n)
ríma|fillet, snood, *headband, hairnet (n)
ríma|line of seeds planted, row, series, furrow (n)
rimbë|host, great number, [ᴹQ.] crowd (n)
rimpë¹|stripe, strip (n)
rimpë²|scratch (n)
rimpeccuvo|chipmunk (n)
rimperocco|zebra, (lit.) stripe-horse (n)
rimpina|striped (adj)
rimpion|gneiss, (lit.) stripe-rock (n)
rimpira|tiger, (lit.) stripe-lion (n)
-rin|-ian, racial-adjective, language (suf)
rína|garlanded, crowned (adj)
rína|scattered, ⚠️sown (adj suf)
rínata-|to crown, coronate (vb)
ríanta-|to crown, coronate (vb)
rincuma|task, charge, mission (n)
rindë|swift (adj)
ringa|cold, [ᴱQ.] chilly; ⚠️damp (adj)
Ringarë|December, *Coldness (n)
ringë|chill, cool (adj)
ringincë|cool, coldish (adj)
rinqua|revolving, returning, recurrent; ⚠️round, circular (adj)
rip-|to scratch (vb)
ripta-|to cut in strips, tear up; to stripe, mark in parallel lines; to flay, flog (vb)
rísima|scattered, ubiquitous, universal (adj)
rísimandë|passim [Latin]; *scatteredly, here and there, at random (adv)
rista-|[ᴹQ.] to cut (vb)
-r(o)|agental suffix (suf)
ro-|uprising, sunrise, east (pref)
hró-|east (pref)
orró-|uprising, sunrise, east (pref)
ró|the[?] [?next] (adv)
röa|dog (n)
roccë|mare (n)
rocco|horse (n)
roccotsë|cavalry (n)
rocindë|*debtor, one who trespasses (n)
lucindo|*debtor, one who trespasses (n)
lucando|debtor, one who trespasses (n)
rocollë|colt (n)
rohta|*debt, trespass (n)
luhta|*debt, trespass (n)
lucië|*debt, trespass (n)
lucassë|*debt, trespass (n)
rohtalië|*those who trespass, (lit.) trespass-people (n)
róma|[ᴹQ.] loud sound, trumpet-sound, *blare; [Q.] horn (n)
romba|horn, trumpet (n)
rómen|east, uprising, sunrise (n)
hróme(n)|east (n)
róme|east (n)
Romënórin|Roman (n)
romya|loud (adj)
ronda|solid, firm (adj)
rondo¹|vaulted or arched roof, vaulted hall; [ᴹQ.] cavern, ⚠️cave (n)
rondo²|staff (of hardwood) (n)
rondova|cavernous (adj)
ronga-|to hasten, hurry (vb)
ron(go)|soon (adv)
ronwa|block, solid piece (n)
roquen|knight, horseman, rider (n)
rossë|(fine) rain; [ᴹQ.] dew; *spray, shower; ⚠️[Q.] foam (n)
rosta-|to hollow out, excavate (vb)
rostaurë|rainforest (n)
rot-|to delve, excavate, dig (vb)
rotsë|pipe, tube (n)
rotsenca|waistcoat, vest (n)
rotta-|to bore (a hole or tunnel) (vb)
rotto|tunnel, small grot, [ᴹQ.] cave (n)
rua|steady, still, tranquil (adj)
ruc-|to feel fear or horror; *to flee (to) (vb)
rúcima|terrible (adj)
rúcina|confused, shattered, disordered, ruined (adj)
rúcinon|breccia, (lit.) ruined stone (n)
ruë|stillness, *steadiness, tranquility, ⚠️rest, remaining, steadfastness (n)
ruhta-|to terrify (vb)
ruical(a)|firelight (n)
ruihandë|genius, blazing intellect (n)
ruimen|fireplace, hearth (n)
ruimenya|fireside, by the fire (adj)
ruina|blazing, fiery (adj)
ruinë|blaze, fire (n)
rum-|to shift, move, heave (of large and heavy things) (vb)
rúna-|to free (vb)
runando|*redeemer (n)
runda|smooth, polished; *polite (adj)
rundië|smoothness; politeness (n)
runya|fiery red (adj)
rúnya|red flame (n)
runyaril|garnet, (lit.) fiery red radiance (n)
rusca¹|red-brown (adj)
rusco|fox (n)
ruscuitë|foxy (adj)
rúsë|wrath (n)
rúsëa|wrathful (adj)
russa|red-haired (adj)
russambos|robin (n)
russë|head or pelt of red hair (n)
ruv-|to burst, rupture (vb)
rúvina|burst, ruptured (adj)
ruxa|wroth (adj)
rusca²|wroth (adj)
ruxa-|to crumble (vb)
ruxöalë|Great Bear-dance (n)
-rya¹|his, her, its (suf)
-ssa|his, her, its (suf)
-rya²|their (colloquial) (suf)
sá|very good, all right, I will, I agree of course, of course I do (interj adv)
aþa|I agree of course, of course I do (adv)
þá|I agree of course, of course I do (adv)
sa¹|it (inanimate); that (pron conj)
sac-|to close (vb)
sac-|to hurt (vb)
sacillë|splinter (n)
sahta-|to induce (vb)
sahta-|to split (vb)
sahtië|pressure or force (to do something against one’s will or conscience) (n)
saicë|hunger (n)
saicelë|famine (n)
saicelëa|famished (adj)
saila|wise (adj)
sailiendil|philosopher (n)
saipo|boot (n)
saiqua|hungry (adj)
sairina|magic, *magical (adj)
saita-|to teach, *train, (lit.) make wise (vb)
saitalë|education (n)
saitar|teacher (n)
saitya-|to starve (vb)
sal-|[unglossed] (vb)
sála|gall, bile (n)
salca|scythe (n)
salca-|to mow, scythe, mow down (n)
salcessë|harvest [product], *produce (n)
salcima|ready for cutting, *harvestable (adj)
salpa|broth (n)
salpë|sip, ⚠️taste (n)
salquecápo|grasshopper (n)
salquecolca|manger, (lit.) grass-box (n)
salquenor|grassland, meadow (n)
salta-|to strain, winnow (vb)
saltama|winnowing-fork (n)
salyon(do)|hero, dauntless man (n)
sam-|to have (vb)
sama-|to bar, exclude (vb)
sámalórië|madness (n)
sambesta|flat, apartment (n)
sáme|salvation, saving, help (n)
samin|silk (n)
saminda|silken (adj)
sámo|helper (n)
sampa|spade, *shovel (n)
sampan-|to combine (vb)
sampanë|combination (n)
sampo|*cellar, vault; ⚠️cave, hollow (n)
san|*then, so, thus (conj adv)
yan|*as (conj adv)
san|bar, barrier (n)
sámo|bar, barrier (n)
sana|that very thing (already referred to) (adj)
sana-|*to think, reflect (vb)
sanar|mind, thinker, reflector (n)
sáma|mind (n)
sanasta|thinking, reflection, pondering (n)
sanastëa|mindful, cognizant, aware of, conscious of (adj)
sancon|schist, (lit.) split-rock (n)
sanda|shield (n)
sandanasto|turtle, (lit.) shield-being (n)
sandastan|shield-barrier (n)
sanga|press, pressure; throng, [ᴹQ.] crowd, pack; [ᴱQ.] tight mass; [ᴹQ.] crowded, packed (n)
sangarë|oppression (n)
sangarëa|oppressive, tyrannical (adj)
sahtaitë|oppressive, tyrannical (adj)
sangië|necessity, *pressing need or concern (n)
santa|garden, field, yard; apportioned/designated space (n)
santa-|to decide (vb)
santenta-|to concentrate, focus (vb)
santië|decision (n)
sanwë|thought, an act of thinking (n)
sanwecenda|thought-inspection, thought-reading (n)
sanwë-latya|thought-opening (n)
sanwelunga|serious, (lit.) thought-heavy (adj)
sanwelungië|seriousness (n)
sanwementa|thought-sending, mental message (n)
sányelóra|lawless (adj)
sanyelórie|lawlessness (n)
sanyengolmo|lawyer (n)
sanyesta|law [as a scholarly discipline] (n)
sap-|to dig (vb)
sappa|hollow, dug-out, excavated (adj)
sapsarrima|boring, tedious (adj)
sapta|(delved) hole, pit; [ᴱQ.] grave (n)
samna|delved hole, pit (n)
sapta-|to convince, (lit.) make believe (vb)
sáquet-|I will, to agree (to do); (lit.) to say ‘yes’ (vb)
þáquet-|to say ‘yes’, I will, agree (to do) (vb)
sáquetië|agreement (n)
essámalë|agreement, (lit.) one-mindedness (n)
sar|stone (small) (n)
sár|(incised) mark, notch, tally; (generalized) score (of game or contest) (n)
sar-¹|to cross (vb)
sar-²|to mark (i.e. by incision), notch, score; (by later extension) †to write [on] (vb)
sara-|to saw [wood] (vb)
sára|[ᴹQ.] bitter (adj)
sáralë|bitterness (n)
saramor|*writing-ink (n)
sarassë|hassock, footstool (n)
sarat|letter (of the Rúmilian alphabet) (n)
sarda|hard (*as stone) (adj)
sardanar|corundum, (lit.) hard sun (n)
sarma|saw (n)
sarmë|writing (n)
sarnië|shingle, pebble bank (n)
sarnincë|pebble (n)
sarnomo|banker (n)
sarnunta|diadem (n)
sarta|steadfast, trusty, loyal (adj)
sartë|note, jot, scribbling, (lit.) a little writing (n)
sarya-|to stone (vb)
sasta-|to put, place (vb)
sat-|to set aside, appropriate to a special purpose or owner (vb)
satar|trusty follower, loyal companion (n)
sarto|trusty follower, loyal companion (n)
satarya-|to trust, rely on (a person) (vb)
satta|part (of something) (n)
satya|private, separate, not common, excluded (adj)
sau-|very badly (pref)
saucarë|doing or making a thing very badly (n)
saucarya|evil-doing (adj)
saulengaitë|ill-mannered (adj)
sauluppo|cancer (disease)  (n)
saura|stinking, foul, [ᴹQ.] evil-smelling, putrid; [Q.] cruel, evil, vile; ⚠️[Q.] bad, unhealthy, ill, wretched (adj)
sauroryat|skunk, (lit.) stink-badger (n)
sav-|to believe (vb)
sávë|stench, stink, reek, foul odor (n)
savielóra|unbelieving, belief-less (adj)
savindo|believer (n)
sávula|credulous, gullible (adj)
se¹|he, she, it (animate) (pron)
se²|at, in (prep)
sel-|to intend, mean, plan (vb)
seldë|daughter; [ᴹQ.] child [f.], *girl (n)
selma|fixed idea, will (n)
þelma|fixed idea, will (n)
seltil|daughter [finger name] (n)
selya-|to intend, mean, purpose, resolve (vb)
selyë|daughter (diminutive) (n)
sen-|to let loose, free, let go (vb)
senda|bracket, (lit.) that what cramps, confines (n)
sendarë|sabbath, day of rest (n)
sendassë|inn, guest-house (n)
senna|short (adj)
sennacénëa|short-sighted (adj)
sintacénëa|short-sighted (adj)
senta-|to shorten (vb)
sentimeter|centimeter (n)
senwa|moment, instant (n)
senya¹|usual, *common, typical (adj)
senya²|*my child (n)
senyavë|usually (adv)
ser-|*to sew (vb)
serca-|to bleed (vb)
sercë|blood (n)
sercilixa|blood-thirsty (adj)
serciril|ruby, (lit.) blood-glitter (n)
sérë|peace, [ᴹQ.] rest, repose (n)
sérë|*peace (n)
sérenca|uneasy, unpeaceful (adj)
serindë|broideress, needlewoman, *seamstress (n)
sérinqua|peaceful, full of peace (adj)
serma|string, ⚠️cord (n)
seruinon|sedimentary rock, (lit.) settled-rock (n)
sesta-|to set, (lit.) to make rest (on) (vb)
séya-|to seem (vb)
sí|now (adv)
sír|now (adv)
si¹|this (adj pron)
sië|thus (adv)
sil-|to shine (white) (vb)
silima|crystal substance devised by Fëanor (n)
sillë|like this (adv)
silma|crystal (white); [ᴹQ.] silver, shining white (n adj)
silmë|starlight; [ᴹQ.] silver [light], ⚠️moonlight, light of Silpion (n)
silmë nuquerna|s-reversed (n)
silo|hence (adv)
sio|hence (adv)
silomë|tonight (n adv)
silta|sieve (n)
silta-|to sift, sort out, winnow (vb)
siltina|winnowed (adj)
silumë|now, at this time, *present (adv)
silúmëa|current, contemporary, modern (adj)
silussë|present tense, (lit.) here-and-now-tense (n)
síma|imagination, mind (n)
isima|imagination, mind (n)
simpa|pipe, flute, flageolet (n)
simpetar|piper, *fluter (n)
simpisë|piping, whistling (n)
sin|tin (metal) (n)
sin¹|*thus (adv)
sina|this (adj)
sinanwa|present, in a particular place, existing or occurring now (adj)
sinanwië|presence (n)
sinapio|mustard (n)
sinca|flint; *flinty (n adj)
sincahonda|flint-hearted (adj)
sincë|mineral [as in any solid inorganic substance], ⚠️gem, metal (n)
sinda|grey (adj)
sindë|grey, pale or silvery grey, [ᴹQ.] pale (adj)
Sindarin|Grey-elven (n)
Sindel|Grey-elf (n)
sindië|greyness (n)
sinen|by this means, so (adv)
singë|salt (n)
singwa|salt, *salty (adj)
sinilë|topaz (n)
sinomë|here, (lit.) in this place (adv)
sintamo|smith (n)
sintë|esteem; estimate, computation (n)
sinwa|known, certain, ascertained (adj)
sinyar|news (n)
sinyarna|novel (n)
sinyemat|dinner, evening meal (n)
sip-|to pipe (vb)
siqu-|to sigh (vb)
siquilë|sighing, ⚠️lament (n)
siquilissë|weeping willow; ⚠️lamentation (n)
sir(a)|hither (adv)
simen|hither (adv)
síra|*today, this day (n)
siar(ë)|*today, this day (n)
hyárë|*today, this day (n)
hyázë|*this day (n)
sinar|today, [ᴹQ.] this morning (n)
sír(ë)|river, ⚠️[ᴱQ.] stream (n)
sirëa|flowing, liquid (adj)
sirpë|stalk, slender tube, ⚠️stem (n)
sirya-|to flow [smoothly] (vb)
sis-|to scorch, singe, fry (vb)
sís|here (adv)
si²|here (adv)
sissë|here (adv)
sisíla-|to shine (frequentative) (vb)
sisin|parched, scorched (adj)
sistë|ulcer, sore, boil (n)
sistina|ulcerated, sore (adj)
sítë|of this sort (adj)
sitina|habitual, customary, accustomed, usual, ordinary, common (adj)
sito|custom, habit (n)
sitta-|I am used to, I do habitually (vb)
situ-|to be accustomed [to] (vb)
sitwa|pan, fryer (n)
sívë¹|*as (prep)
sívë²|peace (n)
sívë³|knowing, knowledge (n)
söa|filth (n)
sohta-|to give to drink, drench (vb)
soica|thirsty (adj)
soicië|thirst (n)
sól|?helmet, ?top (n)
solma¹|?helmet, ?top (n)
solos|?helmet, ?top (n)
sóla|tide (n)
solma²|[main or entry] hall, chamber (n)
solta-|to wave, heave, surge (up and down) (vb)
sónanwa|water basin (n)
sónë|pine tree (n)
songa|mouth (interior cavity behind the teeth containing the tongue) (n)
sono|pine (n)
sánë|pine (n)
sononel|pine-needle (n)
sor-|to provide, equip, furnish (vb)
sorastarwa|furnished, equipped (adj)
sorna|steadfast (adj)
sornion|eyrie (n)
soron|eagle (n)
sorno|eagle (n)
soroncë|kite, (lit.) little eagle (n)
sortöa|aloe, (lit.) eaglewood (n)
sorya-|to dread, feel fear (vb)
þorya-|to dread, feel fear (vb)
sossë|fear (n)
þossë|fear (n)
sossëa|fearful, afraid (adj)
sosta-|to put to fright, terrify (vb)
þosta-|to put to fright, terrify (vb)
sótë|refuge (n)
sov-|to wash, *bathe (vb)
sovalda-|to cleanse, purify (vb)
sovallë|washing, bathing, purification (n)
sovalwa|cleansing, *purifying (adj)
sovamorco|raccoon, (lit.) wash-bear (n)
-s(sa)|3rd person singular neuter (suf)
-s(së)|he, she, it; him, her, it (suf)
-s|he, she, it (suf)
-së|he, she, it (suf)
-ssë¹|locative ending (suf)
-ssë²|abstract noun (suf)
-ssë³|himself, *herself, itself (suf)
-sta¹|*part; [ᴹQ.] close grouping, ⚠️land (suf)
-sta²|verbal noun suffix (suf)
-sta³|your (dual) (suf)
-lda²|your (dual) (suf)
-lla²|your (dual) (suf)
-s(të)|3rd person singular animate (suf)
-stë¹|you (dual) (suf)
-ilco|you (dual) (suf)
-(i)llo|you (dual) (suf)
-llë³|you (dual polite) (suf)
-stir|face (suf)
sú|sound of wind, [ᴱQ.] noise of wind (n)
súcë|resinous tree, pine or fir (n)
sucul|sticky matter, slime, ⚠️gum (n)
suhta-|to drain (vb)
suhtë|resin, gum (n)
suhtina|resinous (adj)
suila-|to greet (vb)
suilanta-|to give greeting (vb)
suilië|greeting (n)
suiva|soughing, moaning [of wind] (adj)
súlë|breath; (movement of) spirit, emission of power (of will or desire) (n)
þúlë|spirit (n)
súlendil|kite, (lit.) friend of the wind (n)
Súlimë|March, *Windy-one (n)
sulpa|soup (n)
súma|hollow cavity, bosom (n)
sumba-|to submerge, *baptize (vb)
sumbando|baptizer (n)
sumbanwa|sink (for washing) (n)
súna-|to be spiritually affected, inspired (vb)
súnalë|inspiration (n)
sundo|base, root, [ᴹQ.] root-word (n)
sundoharmar|capital [funds], (lit.) base treasures (n)
sundóma|determinant vowel, root-vowel, [ᴹQ.] vocalic determinant (n)
sundon|bedrock, (lit.) base-rock (n)
súnë|bath, small pool (n)
sur-|*to seek (vb)
þur-|*to seek (vb)
súrë|wind, breeze (n)
surië|*(an act of) seeking (n)
þurië|*(an act of) seeking (n)
súriellë|windflower, anemone (n)
súriquessë|species of grass, (lit.) wind feather (n)
surya-|to blow (intr.) (vb)
surya-|to hiss (vb)
súsa|bath water, hot water (n)
sussë|puff (of air) (n)
susta-|to blow (tr.) (vb)
susta-|to stink (vb)
súta-|to blow (tr.) (vb)
suv-|to sink (esp. in water) (vb)
súyel|niece (n)
súyon|nephew, ⚠️daughter’s son (n)
-t¹|dual ending (suf)
-t²|they (object suffix) (suf)
-ta|causative verb suffix (suf)
tá|then (adv)
tai³|then (adv)
ta¹|that, there, ⚠️[ᴹQ.] it (pron)
ta³|so, like that, also; and also, then; etcetera (adv conj)
tai¹|them (inanimate) (pron)
sa²|them (inanimate) (pron)
ta²|them (inanimate) (pron)
tailë|lengthening, [ᴹQ.] extension (n)
taima|extension (n)
taina²|extension (n)
taina¹|stretched, elongated; [ᴹQ.] lengthened, extended, prolonged (adj)
taitë|of that sort (adj)
tál|foot; [ᴹQ.] bottom, [ᴱQ.] lowest part (n)
talaitë|footed (adj)
talan|flat space, platform; [ᴹQ.] floor, ⚠️ground (n)
talca|post, mark (n)
tal(da)|to the bottom (adv)
taldëa|bottom (adj)
tallë|like that (adv)
tallimë|ankle, (lit.) foot-link (n)
talma¹|basis, [ᴹQ.] foundation, base, ⚠️root; [ᴱQ.] end (n)
talma²|flat space, platform (n)
talmacasta|upside down (adj)
talmata-|to base (on), found (vb)
talma-|to found (vb)
talmondo|foundation stone (n)
talo|thence (adv)
tó|thence (adv)
talta|tottering, unsteady, [ᴱQ.] shaky, wobbling; [ᴹQ.] sloping, tilted, leaning, inclined, [ᴱQ.] slanting (adj)
talta-|to slip, slide down, collapse, fall, [ᴹQ.] slip down, slope (vb)
taltil|toe, *(lit.) foot-tip (n)
talumë|at that time (adv)
talya|stalwart, steady, firm (adj)
tama|that matter (pron)
taman|thing made by handicraft (n)
tambë|*as, so (prep)
tier|*so (prep)
tér|*so (prep)
tambë|bronze, ⚠️copper (n)
tambin|cauldron (n)
tambina|of bronze, ⚠️[ᴱQ.] of copper (adj)
tamin|forge (n)
tamma|tool (n)
tamna|artificial; artifact (adj n)
tamo|smith, builder, wright, artificer (n)
tampo|well (n)
tamuril|yew (n)
tan-|to make, fashion (vb)
tana|that (adj pron)
tana-|to show, indicate (vb)
tanar|indicator, [linguistics] demonstrative (n)
tanastë|presentation (n)
tanca|fastening, rivet (n)
tancal(a)|brooch, ⚠️clasp, [ᴹQ.] fastener, pin (n)
tancarya-|*to become firm (vb)
tancata-|to make firm, fix, confirm (vb)
tancavë|certainly (adv)
tanen|in that way (adv)
taniquelassë|*high-white-leaf (n)
tanna¹|sign, token (n)
tanwa|sign, token (n)
tanna²|thither (adv)
tanomë|there, (lit.) in the place (referred to) (adv)
sanomë|there (adv)
tanta-|to bounce, bound, rebound (vb)
tanta-|to play a harp (vb)
tantal|shuttle (n)
tantara|bouncing, resilient (adj)
tant(il)a|harp (n)
tapta|impeded (adj)
-tar|honorific (suf)
tar|honorific, sir, madam (n)
tar-¹|high; [ᴹQ.] king or queen (in compounds) (affix)
tar-²|to stand (vb)
tar(a)|thither; ⚠️[ᴹQ.] beyond (adv)
tamen|thither (adv)
tára¹|lofty, tall, high (adj)
tára²|wise (adj)
taranna|shire, county (n)
tararan|emperor, (lit.) high-king (n)
taras|great towering building (fort/city/castle), tower; ⚠️[ᴹQ.] mount, hill (n)
tarasta-|to harass, trouble (vb)
tarastië|trouble (n)
tarhanwa|throne, (lit.) high seat (n)
arcanwa|*throne (n)
tári|queen, ⚠️[ᴱQ.] mistress, lady (n)
tárië|height (n)
Tárion|alternate name of the last day of the Eldarin six-day week (n)
táris(së)|queenship (n)
tarma|pillar (n)
tarmë|state, status, condition (n)
tarmen|vertical direction (n)
tarmenya|vertical (adj)
tarminas|great towering building (fort/city/castle), tower (n)
tarmon|basalt, (lit.) pillar-rock (n)
tarolwen|sceptre, (lit.) royal branch (n)
tarqua-|to dry, preserve; to pickle (vb)
tarquin(a)|salt meat; salted, dried, *(orig.) preserved (n adj)
tarwa|garden, enclosure (n)
tarwandur|gardener (n)
tarwë|cross, crucifix (n)
tarwesta-|to crucify (vb)
taryalangova|stiff-necked, obstinate (adj)
taryalanca|stiff-necked, obstinate (adj)
taryalangwa|obstinate, stiff-necked (adj)
taryassë|stiffness, toughness, difficulty (n)
tasar(ë)|willow (n)
tassa|(a) trouble, troublesome event/thing/circumstance (n)
tassa|index finger (n)
tassë|there (adv)
tás|there (adv)
tastë|fringe (n)
tata|*daddy (n)
tatya|second (ordinal)
atya²|second (ordinal)
tauca|stiff, wooden (adj)
taucolca|(wooden) chest (n)
taura|(very) mighty, masterful; vast, of unmeasured might or size (adj)
taurë|forest, (great) wood (n)
taurëa|forested (adj)
tauron|forester (n)
tautamo|carpenter, [wood] carver (n)
tav-|*to endure (vb)
táva|great tree (n)
tavas|woodland (n)
te|them (pron)
tëa-|to indicate (vb)
tëalë|meaning (n)
tëangolmë|semantics (n)
teccelma|scroll, parchment, (lit.) writing-skin (n)
toluparma|scroll, (lit.) roll-book (n)
tecemma|drawn image, drawing, painting (n)
tecil|pen (n)
tecindo|writer (n)
tengwo|writer (n)
tehta|(written) mark, sign, symbol, [ᴹQ.] diacritic, [Q.]  †written letter (n)
tehtalë|art of writing, script; writings, documents, papers, scriptures (n)
tel|end (n)
tel-|to end, finish (intr.) (vb)
telco|leg; stem (n)
telcohan|trousers, pants, (lit.) leg-clothing (n)
telconta-|to stride, *(lit.) to leg it (vb)
telda|last, final (adj)
teldavë|finally (adv)
telepta|silver, *silver-coloured (adj)
telima|final (adj)
telluma|dome, cupola, vault (n)
telma|conclusion, anything used to finish off a work or affair; [ᴹQ.] ending (n)
telmëa|conclusive, ⚠️final, end, last; extreme (adj)
telpë|silver; [ᴱQ.] money (n)
tyelpë|silver (n)
telpetan|silversmith (n)
telpevistando|money-changer (n)
telpilin|silver piece, *silver coin (n)
telpina|like silver (in hue or worth), [ᴹQ.] of silver (adj)
telperin|like silver (in hue or worth) (adj)
telpingwë|silverfish (n)
telu|last; ⚠️end (fate), close (adj)
telumbë|mushroom (n)
telumë|roof, canopy, [ᴹQ.] vault, dome (of heaven); [Q.] heaven, sky, [ᴱQ.] firmament (n)
telusta|outer, extreme, ultimate (adj)
telustë|extremity (n)
telwa|late, ⚠️last (adj)
telya-|to finish, wind up, conclude (trans.) (vb)
telyanta-|to allure, *attract (vb)
telyantalya|alluring, attractive (adj)
telyantassë|allurement, attraction (n)
téma|series, [ᴹQ.] row, line (n)
tenca|letter (epistola) (n)
tenna²|letter (epistola) (n)
tengessë|address, (lit.) indication-name (n)
tengwa|(written) letter; sign, token, indicator; ⚠️[ᴹQ.] writing, grammar (n)
tengwa-|to read written matter (vb)
tengwacilmë|spelling (n)
tengwalóra|unlettered (adj)
tengwassë|alphabet (n)
tengwë|sign, token, indication; writing; ⚠️[ᴱQ.] knowledge, understanding; idea, notion, thought (n)
tengwelanga|transcription (n)
tengwelanga-|to transcribe (vb)
tengwelë|language (general term); ⚠️[ᴱQ.] sense (n)
tengwesta|grammar, morphology, system or code of signs, collection of matter concerning writing, *language structure (n)
tengwestië|language [as a concept] (n)
tengwië|reading; language (*signing) (n)
tenna¹|until, up to, as far as, to the point, to reach (prep)
tenna³|thought, notion, idea (n)
tennoio|forever[more] (adv)
tensi|already, still, up to now/here; yet [from present] (adv)
tenta|still, yet [past], *up until then (adv)
tenta-|to point (to/out), indicate; to direct toward, be directed toward; to go forth towards (with object) (vb)
tentaparma|recipe book, instruction book (n)
ter|through (prep)
ter-|to pierce (vb)
térala|piercing (adj)
térata-|to straighten (vb)
tératië|correction, (lit.) straightening (n)
tercáno|herald (n)
tercara|thorough, elaborate, comprehensive (adj)
tercen|insight, *(lit.) through-sight (n)
tercénima|transparent (adj)
tercenya|of insight, *perceptive (adj)
tercol-|to endure, carry through (vb)
terendel|lathe (n)
teret|auger, borer, gimlet (n)
termar-|to stand, *endure, last, (lit.) through-abide (vb)
tervanta-|to traverse (vb)
tesar|brick, tile (n)
tev-|to hate, dislike (vb)
tevië|hatred, dislike (n)
tevin|hated (adj)
tevinqua|hateful (adj)
thar-|[unglossed] (vb)
ticuta-|to smelt, (orig.) make melt (vb)
tië|path, road, way, line, [ᴹQ.] course, direction, [ᴱQ.] route (n)
tihta-|to blink, peer (vb)
tildë|fine sharp point, [ᴹQ.] spike; (mountain) horn, [ᴱQ.] tip, ️peak (n)
tillë|tip, point; [within compounds] finger, toe; [ᴱQ.] eyelash (n)
tilma|point (n)
timbarë|forehead (n)
tin-|to spark, glitter, [ᴹQ.] glint, [ᴱQ.] gleam, shine as a star (vb)
tinco|metal (n)
tincoina|metallic (adj)
tincotéma|t-series (n)
tindómë|(starry) twilight, time near dawn, [ᴹQ.] starlit dusk (n)
tinga-|to go (for a long while) (vb)
tinta-|to kindle, cause to spark, [ᴹQ.] make to spark (vb)
tintila-|to twinkle, sparkle, glitter, give tremulous light, †tremble (vb)
tintilië|sparkling, twinkling (n)
tinwë|spark, [apparent] star (n)
tinwerúmë|starling, (lit.) abundance of stars (n)
tinwírë|diamond, (lit.) sparkling gem (n)
tiqu-|to melt, thaw (vb)
tiquilë|melting, thawing, thaw (n)
tiquilin|thaw, melting snow, slush (n)
tiquilindëa|thawing, slushy (adj)
tir-|to watch (over), guard, heed; to look (at), gaze, observe; ⚠️[ᴱQ.] to keep, preserve (vb)
tirila|watching (something) (adj)
tírima|able to be watched, observable (adj)
tirion|watch-tower, tower, [ᴱQ.] (great or mighty) tower; ⚠️city on a hill (n)
tiris|watch, vigil, ward (n)
tirista|*watch, guard (n)
tirítë|watchful, vigilant (adj)
tirma|spyglass (n)
tirmë|steadfast regard, stare, *gaze (n)
tirmen|theater (n)
tirmo|watcher (n)
titinwë|small star, sparkle of dew, *small sparkling thing (n)
tittë|breast [of a woman], ⚠️teat (n)
tiucata-|to fatten, to feed up (vb)
tiura|compact (adj)
tiuta-|to corroborate, confirm; to comfort, console, *(orig.) to make firm; ⚠️to strengthen (vb)
tiutaila|comforting, consoling, easing (adj)
tiutalë|confirmation; comfort, consolation, easement; ⚠️strengthening, reinforcement (n)
tixipi|ladybug, (lit.) insect of [many] dots (n)
to|on, above; [ᴹQ.] in (prep)
töa|wood (as material) (n)
töallë|blanket (n)
töasta|grove (n)
toc-|to appraise, tax, assess, assay; ⚠️to try, test, essay, endeavour; to feel with the hand, handle (vb)
tocot|cock, *rooster (n)
toina|wood, *wooden, made of wood (adj)
tolbo|big toe; stump, stub; ⚠️thumb (n)
taltol|big toe (n)
toldëa|eighth (ordinal)
toltëa|eighth (ordinal)
toldo|eight (cardinal)
tolto|eight (cardinal)
toli|doll, puppet (n)
tolipincë|little doll (n)
tollë¹|island, (steep) isle (n)
tol|island, (steep) isle (n)
tollesta|archipelago (n)
tolloquen|islander (n)
tolma|knob, (short rounded) handle, protuberance contrived to serve a purpose (n)
tolmen|boss (of shield), isolated round hill (n)
to(lo)sta|one eighth (fraction)
tolsat|one eighth (fraction)
tolpo|bowl (n)
tolquain|eighty (cardinal)
toloquain|eighty (cardinal)
toloquëan|eighty (cardinal)
tolquë|eighteen (cardinal)
tolya|prominent (adj)
tolyo|sticker-up (n)
tollo|sticker-up (n)
tombo|gong (n)
tomba|[unglossed] (n)
tompa|(small) drum (n)
tompa-|to bang, *drum (vb)
tompë|*pulse, beat (n)
tompo-tompo|noise of drums (or guns) (n)
tomya-|to resonate (of shorter sounds) (vb)
tontilla|cymbal, *tambourine (n)
Torco|Troll (n)
torna|hard (adj)
tornanga|iron hard; hard-iron, *steel (adj n)
torya-|to strengthen (vb)
tótal|sock, (lit.) wool-foot (n)
totonna-|to type (on computer/phone) (vb)
-tta|their (dual) (suf)
-sta⁴|their (dual) (suf)
-twa|their (dual) (suf)
-tya²|their (dual) (suf)
-ttë¹|they (dual) (suf)
-stë²|they (dual) (suf)
-sto|they (dual) (suf)
-ttë²|themselves (suf)
tu|them (dual) (pron)
tucië|drawing, pulling (n)
tuë|fleece (n)
tuilë|spring, [ᴹQ.] spring-time, ⚠️[ᴱQ.] (lit.) a budding; buds, new shoots, fresh green (n)
tuilérë|*spring-day (n)
tuista|twig, shoot, ⚠️sprout, spray (n)
tul-|to come, ⚠️[ᴱQ.] move (intr.); to bring, carry, fetch; to produce, bear fruit (vb)
tulca-|to set up, establish, *found; ⚠️to fix, stick in,  (vb)
tulcarpa-|to rebuke (vb)
tulcarpië|rebuke (n)
túlima|[ᴱQ.] bringable, worth bringing, able to be brought (adj)
tulla|rudder (n)
tullu-|to occur, happen (i.e. come in time) (vb)
tulta-|to send (from point of view of receiver), [ᴹQ.] to send for, send hither, fetch, summon, (lit.) cause to come (vb)
tultaima|*fetchable, summonable (adj)
tuluhta-|to support, prop (up), uphold (vb)
tulumaitië|probably (adv)
tulussë|future tense, (lit.) coming tense (n)
tulusta|advent, arrival (n)
tulya|coming, approaching, future (adj)
tulya-|*to lead; [ᴱQ.] to bring, ⚠️send (vb)
tulyaitë|able to bring (adj)
tulyandë|fetching (n)
tulyando|leader (n)
tumba|[ᴹQ.] deep, lowlying; ⚠️[Q.] deep valley (adj)
tumba-|to cast down; *to dive (vb)
tumbalë|depth, deep valley (n)
tumbo|deep vale, valley, [ᴱQ.] dale (n)
tumpo|shed, barn (n)
tumya-|to dip, ⚠️baptize (vb)
tumyando|baptizer (n)
tundo|firewood, fuel (n)
tungwë|tax (n)
hótocië|tax (n)
túrëautocië|tax (n)
tungwemen|tax-office (n)
tungwemo|tax-collector (n)
tunta-|to notice, perceive, ⚠️see (vb)
tuntaitë|bright, witty, smart; *perceptive (adj)
tunto|notice, regard, perception; quickness of perception, wit (n)
tuorva|peach, (lit.) wool-apple (n)
tup-|to cover, [ᴱQ.] put a lid on, put hat on, ⚠️roof (vb)
tupattal|horse-boot (n)
túpelë|roofing, tiles, ⚠️roof (n)
tupin|roofed, having a lid, having hat on (adj)
tupina|covered (adj)
túpo|cover, lid, ⚠️roof (n)
-tur|master, lord, ruler, ⚠️[ᴹQ.] victor (suf)
tur-|to master, conquer, dominate, win; [ᴹQ.] to control, govern, *rule; ⚠️to wield; [ᴱQ.] can, to be able (vb)
túra|great, ⚠️big (adj)
turca|strong, powerful (in body) (adj)
turco¹|chief (n)
turco²|*stronghold (n)
túrë|[ᴹQ.] mastery, victory; [ᴱQ.] might, strength, power (n)
turëa|influential (n)
túrëa|mighty, masterful, *having political power (adj)
túrin|lord (n)
turindo|purposeful mind, strong will (n)
turindura|done necessarily (adj)
túrion|palace (n)
arcöa|palace, (lit.) noble-house (n)
turmë|governing power, strength (n)
turmen|realm (n)
turu-|to defeat, have victory over, master (vb)
turúna|mastered (adj)
turutyalmë|contest, competition (n)
turwa|powerful [in a general sense] (adj)
turya-|[ᴹQ.] to strengthen (vb)
turyandë|fortification, [ᴹQ.] strengthening (n)
tusturë|tinder, chips, ⚠️firewood (n)
tusturin|match (n)
tutulla-|to keep on coming (and going) (vb)
tuv-|to find, discover (vb)
túvima|discoverable (adj)
tuxa|hundred; ⚠️gross, 144 (cardinal)
tuxainen|thousand (cardinal)
tuxainenëa|thousandth (ordinal)
tuxantur|centurion (n)
tuxasta|one hundredth, *one percent (fraction)
-tya¹|your (familiar) (suf)
tyal-|to play (vb)
tyalië|mirth, [ᴹQ.] play, game, sport (n)
tyalindo|player (n)
tyallas|(playing) card (n)
tyalma|toy, plaything (n)
tyalmë|game (n)
tyar-|to cause (vb)
tyaraitë|effective, productive, effectual, efficacious (adj)
tyarda|result, *effect (n)
tyarwë|reason (n)
tyas-|to test, try [out], pick, choose (vb)
tyasta-|to (put to the) test, *verify (vb)
tyastaima|testable (adj)
tyestima|testable (adj)
tyausta|savour, flavour (n)
tyav-|to taste; [ᴱQ.] (impersonal) to taste of, reminds one of (vb)
tyavasta|sense of taste (n)
tyávë|*taste (n)
tyávelassë|spice, (lit.) taste-leaf (n)
-tyë|you (familiar) (suf)
-t³|you (familiar) (suf)
tye|you (familiar), thee (pron)
tyelca|hasty; [ᴹQ.] agile, swift (adj)
tyellë|grade, step (in a stairway or ladder), ⚠️order (n)
tyellesta|ladder (n)
tyelpetéma|palatal series (n)
Tyena|China (n)
tyenya|yours (familiar) (n)
tyet-|to suckle, nurse (vb)
tyéta-|to address somebody informally using tye (vb)
tyetsë|teat, *nipple (n)
tyocolat|chocolate (n)
tyos|cough (n)
tyosta-|to cough (vb)
tyuc-|to chew (vb)
tyul-|to stand (vb)
tyulma|mast (n)
tyulta-|to rear up, stick up (vb)
tyulya-|to rise (vb)
tyur-|to curdle (blood, milk, etc.), *congeal (vb)
tyurda|curdled (adj)
tyurmë|cheese (n)
tyustyuhta-|to chew the cud; to reflect, reminisce (vb)
tyuxë|cud (n)
þolon|helmet (n)
-u|dual ending (suf)
ú-|no, not, un-, in-; hard, difficult, bad, uneasy; hardly, with difficulty, ‘badly’ (pref)
ú¹|without, destitute of (prep adv)
ú²|not (particle)
úcalima|dim, murky, *not bright (adj)
úcar-|*to trespass, do wrong, sin (vb)
naiqua-|*to sin (vb)
úcarë|*sin, debt, trespass (n)
úcárima|*undoable, unmakeable; ⚠️hard to do, difficult (adj)
úcarindë|sinner (f.) (n)
úcarindo|*sinner (n)
naico|*sinner (n)
naicando|*sinner (n)
ulcarindo|*sinner (n)
úcarnë|not red (adj)
úcarunqua|sinful (adj)
úcénima|invisible (adj)
úcim-|disregard (vb)
úfailië|unrighteousness (n)
úfantima|not concealable (adj)
úfantuma|not concealable (adj)
úfanwëa|not veiled, unveiled (adj)
úhandë|unreason, incomprehension (n)
úhandëa|witless (adj)
úχarin|unmarred (adj)
úharin|unmarred (adj)
úhepië|loss (n)
uhta-|to dislike, feel disgust with, avoid as painful or nasty (vb)
ui|no, it is n[ot] (interj)
ui-|to not be, to not do (vb)
ua-|to not be, to not do (vb)
uito|it is not that (interj)
ui(y)a|no, not any, not (a); none (adj pron)
ul-|to rain (vb)
-ula|likelihood or aptitude (suf)
úlaita-|to dishonour (vb)
úlaitima|disgraceful, dishonourable (adj)
úlanwa|infinity, infinite (n adj)
ulca|evil; dark, gloomy, sinister; [ᴱQ.] bad, wicked, wrong (adj)
ulcarindo|evil-doer (n)
ulco|evil (n)
ulculóra|without evil (adj)
úlévima|paralyzed, ⚠️lame (adj)
ulma|flagon, *pitcher (n)
ulo|rain (n)
ulquet-|to accuse (vb)
ulquetië|accusation (n)
ulquéto|accuser (n)
úlumë|ever, at all times (in a series or period) (adv)
ulumpë|camel (n)
ulumpembë|caterpillar, (lit.) camel worm (n)
ulunda|monstrous (adj)
ulundië|monstrosity (n)
ulutelme|umbrella, rainshade (n)
úma-|to teem (vb)
úmaia|demon, devil (n)
úmaitë|clumsy(-handed), unskilled (adj)
úmara|bad, ill-used, evil, sinister (adj)
úmárë|not good = evil (n)
um(ba)-|[unglossed] (pref)
umba|swarm (n)
umbacarin|[unglossed] (n)
umbar|fate, doom, curse (n)
ambar|fate, doom, [ᴱQ.] lot (n)
umbarwa|fateful (adj)
umbë|imminence, threat; premonition, fear, unwelcome expectation (n)
umbo(n)|lump, clump, mass, ⚠️hill (n)
-úmë|[large], of quantity (suf)
úmë|great collection or crowd of things of the same sort; [ᴹQ.] abundance, ⚠️great quantity; [Q.] throng (n)
úmëa|abundant, swarming, teeming; ⚠️[ᴹQ.] in very great number, very large, [ᴱQ.] large (adj)
úna¹|deprived of, destitute, forlorn (adj)
únat|thing impossible to be or to be done (n)
unda|lower, beneath (adj)
undalasar|stalactite, (lit.) down-growing stone (n)
undo|less (adj pron)
undómë|twilight, time near evening (n)
undu|down, under, [ᴹQ.] beneath (prep adv)
undulav-|to drown, swallow, submerge, (lit.) lick down (vb)
undumë|abyss (n)
únehta|*atom (n)
ungol|(monstrous) spider (n)
ungwë|spider’s web; ⚠️[ᴱQ.] spider; [ᴹQ.] gloom (n)
únomë|nowhere (pron)
únotë(a)|not counted, uncounted (adj)
aunotë(a)|not counted, uncounted (adj)
únótima|numberless, innumerable, countless, difficult/impossible to count (adj)
urnótima|*difficult to count (adj)
urunóte|*difficult to count (adj)
unqualë|death agony, torment, [ᴹQ.] agony, death (n)
anqualë|*death agony (n)
unquë|hollow, [ᴹQ.] cavity, hole (n)
untup-|to cover (over or up), (lit.) to cover down (vb)
únut-|to untie (vb)
avanut-|to untie (vb)
únyárima|impossible to recount (adj)
uo|together (adv)
uo|together (adv)
uomë|community (n)
úpa|dumb [unable to speak] (adj)
úpa-|[unglossed] (vb)
úpahtëa|speechless (adj)
úpartalë|unorder, *disorder (n)
úperima|indivisible (adj)
úpoica|unclean (adj)
ú pusto|immediately, at once, (lit.) without pause (adv)
úqua|nothing (pron)
úquen|nobody, no one (pron)
úquétima|unspeakable, impossible to say or put into words, unpronounceable (adj)
úra¹|nasty (adj)
úra²|torrid, sultry, unpleasantly hot (adj)
urco|bogey, orc (n)
urda|difficult, arduous, hard (adj)
úrë|heat (n)
úr|heat (n)
Úrimë|August, *Hot-one (n)
úrin|(blazing) hot (adj)
urna|oven (n)
úro|*evil, nastiness (n)
urpalda|stove plate (n)
urra|bad (adj)
urruxa|livid, furious, enraged, incensed, (lit.) hot-wroth (adj)
ursa|rage (n)
ursa-|to rage (vb)
urta-|to burn (vb)
ur(u)-|difficult, hard (pref)
urucárima|hard to make / do (adj)
urcarne|hard to make / do (adj)
urucarin|made with difficulty (adj)
uruhanyaima|complicated, enigmatic, cryptic, hard to understand (adj)
uruhta-|to (cause to) smoke; to belch smoke (vb)
urulanya|wick, (lit.) fire-thread (n)
urulócë|fire-serpent, fire-drake, [ᴹQ.] fire-dragon (n)
ur(u)ma|coal, charcoal (n)
hyulma|coal (n)
urus|copper (n)
urusta|of copper (adj)
urustamitta|copper-piece (n)
urustan|copper-smith (n)
úruva|fiery, [ᴱQ.] like fire (adj)
urwa|on fire, afire (adj)
urya-|to be hot; ⚠️[ᴹQ.] to blaze, [ᴱQ.] burn (intransitive) (vb)
us-|[wrong] with a bad sense; unsuitable, bad, improper, useless, wrong (pref)
us-|to escape, get out (vb)
úsahtando|tempter (n)
sahtando|tempter (n)
úsahtië|inducement to do wrong, *temptation (n)
insangarë|*temptation (n)
terpellië|*temptation (n)
terfantië|*temptation (n)
uscil(lë)|cigarette (n)
úsië|on the contrary (conj)
úsir|on the contrary (conj)
lasir|rather the reverse (conj)
usquë|[ᴹQ.] reek, *smoke; ⚠️[Q.] dusk, dim light, [ᴹQ.] twilight; [ᴱQ.] fog (n)
ussar|sulphur, (lit.) fire-stone (n)
ustat-|to misappropriate, supplant, usurp (vb)
ustya-|to smoke (intr.) (vb)
uswë|escape, issue, outlet (n)
útancië|uncertainty (n)
útulma|accident, (lit.) bad-event (n)
útulya-|to mislead (vb)
útulyando|deceiver, (lit.) mis-leader (n)
útúrima|unruly (adj)
uv-|*to be going to (vb)
-uva|future tense suffix (suf)
úva-|to impend, be imminent, draw near (vb)
úvana|marred (adj)
úvanë(a)|without beauty (adj)
auvanëa|without beauty (adj)
úvanima|not fair, ugly; hard to call beautiful, hideous (adj)
úvanimo|monster, corrupt or evil creature (n)
úvano|monster, corrupt or evil creature (n)
uvassë|future tense, (lit.) uva-ness (n)
úvië|pondering, consideration, [ᴹQ.] considering a matter (with a view to decision) (n)
uxarë|doing wrong, *misdeed (n)
uscarë|doing wrong (n)
-va|possessive or adjectival ending (suf)
va|(away) from, [ᴹQ.] away, [ᴱQ.] gone forth; ⚠️with (prep)
vá|will not, do not, shall not (interj adv)
ava²|strong or curt refusal (interj)
vacco|jacket, coat (n)
vailë|[strong] wind, *gale (n)
vaiwë|wind (n)
váva|*wind (n)
vëa²|wind (n)
vailima|windy (adj)
vaima|wrap, robe (n)
vaimata-|to robe, *clothe; to get dressed, put on clothing (vb)
vaina¹|blonde, fair of hair (adj)
vaina|blonde, fair of hair (adj)
vaina²|clad (adj)
vainë|sheath, pod (n)
vainolë|quiver (n)
vaire|?wavy (adj)
Vala|(Angelic) Power, Authority, ⚠️God (n)
vala-|to have [divine] power (vb)
Valanya|*Friday, Vala-day (n)
valatë|pride (n)
valatëa|proud (adj)
valca|fierce, ferocious (adj)
valda|worth; worthy, dear (n adj)
valda|excited, wild (adj)
walda|worth; worthy, dear (adj)
valda-|to matter; to be of significance, worth, moment; *to cost (vb)
valdëa|of moment, important (adj)
valdima|essential, imperative (adj)
válë|divine power/authority (n)
Valië|Female Vala (n)
valma|[divinely or righteously] powerful (adj)
valmë|authority (n)
valmë|excitement, emotion (n)
walmë|excitement, emotion (n)
valta-|to excite, rouse, stir up (vb)
walta-|to excite, rouse, stir up (vb)
valwistë|change of mind (n)
walwistë|change of mind (n)
valya-|to be excited (moved) (vb)
walya-|to be excited (moved) (vb)
vanda|oath, pledge, solemn promise (n)
vandil|staff (n)
vanë|fair, [ᴱQ.] lovely (adj)
vanessë|beauty (n)
vanga|staff (n)
vangwë|storm, *gale; ⚠️blow (n)
vanië|beauty (n)
vanima¹|beautiful, fair, *handsome; ⚠️[ᴱQ.] proper, right, as it should be, fair (adj)
vanima²|beautiful one, fair one (n)
vanimelda|beautiful and beloved, elven-fair (adj)
vanimalda|thou beautiful; ⚠️most beautiful, exceeding fair (adj)
vanita-|to grow/become fair; to beautify, make fair/beautiful (vb)
vanwa|gone, lost, departed, vanished, past, over, no longer to be had, passed away, dead, [ᴹQ.] gone for good; ⚠️[ᴱQ.] on the road (adj)
vanwalussë|past tense (n)
vanwë|loss (abstract/general) (n)
vanwiémar|museum, (lit.) hall of the past (n)
autamar|museum, (lit.) hall of the past (n)
combemen|museum (n)
vanya|fair, beautiful, unmarred; ⚠️fair-haired (yellow to golden); [ᴱQ.] good (not evil), holy (adj)
vana|fair-haired (yellow to golden) (adj)
vanya-|to pass, [ᴹQ.] go, depart, disappear (vb)
váquet-|to refuse, forbid, prohibit; (lit.) to say no, to say ‘I will not or do not’ (vb)
var|*from, away to (adv)
var-|to yield, give way, surrender (vb)
varanda|sublime (adj)
varassë|cliff (n)
varasta-|to tower up, loom (vb)
váravalmë|scandal (n)
vardarianna|fragrant evergreen tree (n)
varma|armour, armor (n)
varnë|brown, russet; [ᴹQ.] swart, dark brown (adj)
varno|protector, guard (n)
varta-|to betray (vb)
vartando|betrayer (n)
vartië|betrayal (n)
varto|betrayer (n)
varyalë|defense (n)
varyando|protector (n)
vasar|veil (n)
vasarya-|to veil (vb)
vata|beaten track, pathway (n)
vatta-|to trample (vb)
váya|ocean, [stormy] sea (n)
waya|ocean (n)
váya-|to blow (vb)
-vë|abstract noun, adverb (suf)
ve¹|as, like, similar, after the manner [of]; ⚠️[ᴹQ.] with (prep)
ve²|us (inclusive) (pron)
vi|us (inclusive) (pron)
vëa¹|seeming, apparent; ⚠️[ᴱQ.] similar, like (adj)
vëalta-|to resemble (vb)
vëasta|comparison, ⚠️resemblance (n)
vecca|active (adj)
vehtë|[a span of] life; habitat, haunt (n)
vehtequentalë|biography (n)
vel-¹|to boil, bubble (vb)
vel-²|to meet (vb)
véla|*alike, having a likeness or similarity (adj)
vélamë|similarity (n)
velca|large, great, big (adj)
velet|boil, tumor (n)
velu-|to unfurl (vb)
veluntë|sail (n)
velupantië|revelation (n)
velva|boiling, bubbling (adj)
velvë|bubble (n)
velyávë|gourd, Cucurbitaceae, the gourd family (n)
vembë|worm (n)
vendë|maiden, ⚠️*virgin (n)
wendë|maiden (n)
vendelë|maidenhood (n)
wendelë|maidenhood (n)
vendelis|nun (n)
vendesta|convent (n)
venë|dish, [eating] vessel, ⚠️small boat (n)
vénë|*virgin; ⚠️[ᴹQ.] girl (n)
vénëa|*virginal (adj)
vennassë|angle (n)
venta|chin (n)
venwa|lime (fruit) (n)
venya|ours (inclusive) (pron)
vëo|living creature, *living being, ⚠️[ᴹQ.] man (n)
vequi|as if, as though (conj)
véra|personal, private, own (adj)
vératanna|signature, (lit.) personal token (n)
vercála|sudden, violent (adj)
veri|wife (n)
verin|married (adj)
verinu|married pair (collective-noun)
verrendo|brother in law, kinsman by marriage (n)
verressë|sister in law, kinswoman by marriage (n)
verta-|to give in marriage (a) to (b), take as husband or wife (to oneself) (vb)
veru|husband (n)
verulóra|widowed; widow (adj n)
verya-|to marry (of husband and wife), be joined to (vb)
veryandë|adventure, undertaking (n)
veryanwë|wedding (n)
vesquen|spouse (gender neutral) (n)
vesta-|to swear (to do something), contract, make a compact (vb)
vestaracië|adultery, (lit.) marriage-breaking (n)
úpuhtië|adultery (n)
véta-|to compare, liken (vb)
vétaima|comparable (adj)
vetta-|to witness (vb)
vettë|(act of) witnessing (n)
vettëa|witnessing (adj)
vetto|witness (n)
veuma|server (n)
veumë|service (n)
veuro|follower, vassal (n)
veuya-|to serve (vb)
veuyalë|service (n)
vev-|to serve (vb)
vevië|service (n)
vielóra|eunuch (n)
vílë|gentle breeze (n)
vilina|airy, breezy; light [weight?] (adj)
vilva|fluttering to and fro (adj)
wilwa|fluttering to and fro (adj)
vilvarin|butterfly (n)
wilwarin|butterfly (n)
vilvarindëa|like a butterfly (adj)
wilwarindëa|like a butterfly (adj)
vilwis(të)|weather, (lit.) turn of air (n)
vilya|air, sky (n)
wilya|air, sky (n)
vin|just, just now, only just, already (adv)
vínë|youth, *childhood (n)
vingë|foam, spindrift, spray, [ᴹQ.] wave crest, [ᴱQ.] froth, scud; ⚠️wave (n)
wing(a)|foam, spray (n)
wingë|foam, spindrift, spray (n)
vingil|[ᴹQ.] nymph, mermaid, foam-maid (n)
wingil|*nymph, mermaid, foam-maid (n)
vin(i)-|neo- (pref)
vinima|childish (adj)
winima|childish (adj)
vinimetta|end of youth, *reaching middle age (n)
vinimo|baby, little-one (n)
win(i)cë|baby, little-one (n)
winimo|baby, little-one (n)
vinquetta|neologism (n)
vinta-|to scatter, blow about (vb)
winta-|to scatter, blow about (vb)
vinya|young, new (adj)
vinyahan|younger brother (n)
vinyamo|youngster (n)
winyamo|youngster (n)
vinyanet|younger sister (n)
vinyanóna|new-born (adj)
vinyar|news (n)
vinyarë|youth, *young adulthood (n)
vircolca|basket, (lit.) woven-box (n)
virda|outcome, result (n)
etetulië|outcome (n)
Víressë|April, *Freshness (n)
vírina|woven (adj)
virítë|various, variable (adj)
virittë|gravel (n)
virya-|to change, alternate (vb)
vista-|to change (transitive) (vb)
vistë|change (n)
wistë|change (n)
volta|volt (n)
voltië|voltage (n)
vor-|to endure, survive (vb)
vorë|*always (adv)
vórima|faithful, *(lit.) able to endure; [ᴹQ.] continuous, enduring, repeated; ⚠️[ᴱQ.] everlasting (adj)
vorimyalë|monotony (n)
voronda|faithful, steadfast (in allegiance, in keeping oath or promise) (adj)
voron(do)|trusty man, faithful vassal (n)
voronwë|steadfastness, loyalty, faith(fulness) (n)
vorotailë|procrastination, (lit.) ever-extension (n)
vorotaita-|procrastinate, (lit.) ever-prolong (vb)
vorta-|to preserve, make lasting (vb)
vortalë|preservation, maintenance (n)
voruhta-|to shun, (lit.) ever-avoid (vb)
voruva|age long (adj)
-wë|ancient name suffix (usually but not always masculine) (suf)
wenya|fair, beautiful (adj)
were-|to weave (vb)
winë|baby, little-one, ⚠️child not yet full grown (n)
hinyë|baby (n)
hintil|baby (finger) (n)
wirnë|change (n)
-xë¹|reflexive verbal inflection (suf)
xéya-|to pass (of time, intransitive) (vb)
xiétë|passing, impermanent (adj)
xíta-|to pass, spend (time, transitive) (vb)
ya|which, that (relative pronoun) (pron)
yá|when (conj)
-ya¹|adjective suffix (suf)
-ya²|suffix of endearment (suf)
-ya³|his, her, its (colloquial) (suf)
-ya⁴|verbal suffix (suf)
yac-|to offer, sacrifice (vb)
yacië|offering, [act of] sacrificing (n)
yácina|sacrificed (adj)
yaimë|wailing (n)
yaimëa|wailing (adj)
yaiya-|to wail, cry in pain, cry grievously (vb)
yal-|to summon, *call (out to) (vb)
yallë|as, in the same way as, like (adv)
yallo|whence (adv)
yalta|yoke (n)
yána|wide, vast, huge (adj)
yanda|wide (adj)
yonda²|wide, roomy, extensive (adj)
yanca|sacrifice (n)
yanen|whereby (adv)
yangwa|altar (n)
yanna|whither, whereto (adv)
yanta|bridge (n)
yanta-¹|to join (vb)
yanta-²|to add to, enlarge, increase, augment (vb)
yantaina|joined (adj)
yanwë|joining, [ᴹQ.] isthmus, ⚠️bridge (n)
yára|old, ancient, [ᴹQ.] belonging to or descending from former times (adj)
yárahan|older brother (n)
yáranet|older sister (n)
yáraquetta|archaism, archaic word (n)
yarië|antiquity (n)
yarra|️growl, snarl (n)
yarra-|to growl, snarl (vb)
yausta|crop (n)
yav-|to bear (fruit), *yield, bring forth, produce (vb)
yava|whose, of which (adj)
yavannamírë|Jewel of Yavanna (n)
Yavannië|September, *Yavanna-ness (n)
yávë|fruit (n)
yáva|*fruit (n)
yávelóra|fruitless (adj)
yávië|autumn, harvest [time or act] (n)
yáviérë|*autumn-day (n)
yávinqua|fruitful (adj)
yaxë|cow (n)
-ye|and (pairs) (suf)
ye|who (pron)
yé|lo!, what a ..., what is more (interj)
yëa|what is more (interj)
yeldë|daughter (n)
yén|Elvish long year (144 solar years) (n)
yénië|annals (n)
yeniquanta|age (with no connotation of weakness) (adj)
yermë|sexual desire (for marriage and procreation) (n)
yessë|beginning (n)
yesta|beginning, *start (n)
yesta-|to begin, *start (vb)
yestanyatsë|prefixion (n)
yestië|beginning (n)
yo|both ... and (conj)
yo-|together (used in words describing the union of three or more things) (pref)
yocar-|to assemble, compose, construct (vb)
yol-|to smoulder (vb)
yola|neither, nor (adv)
yúla|neither, nor (adv)
yó(m)|[together] with (prep)
yomencöa|synagogue, (lit.) meeting-house (n)
yomenië|meeting, gathering, *congress (n)
yonávë|company, *companionship, camaraderie (n)
yonda¹|enclosed (adj)
yonna|enclosed (adj)
yondë|region, any fairly extensive region with well-marked natural bounds (n)
yón|region (n)
yondo|son, ⚠️boy; [ᴱQ.] male descendant, (great) grandson (n)
yontil|boy, son [finger name] (n)
yonwa|fence, border, boundary (n)
yonyo|(big) boy, son (n)
yor-|to enclose, set bounds to/about; *to include, contain (vb)
yosanwë|(pl.) congruence (n)
(y)otulma|coincidence, concurrence, simultaneity, synchronicity (n)
yu-|both, [ᴱQ.] twice (pref)
yuhta-|to use, employ (vb)
yuhtaimalë|usefulness (n)
yungwë|usefulness (n)
yuhtaina|used (adj)
yunca|used (adj)
yuitë|dual (adj)
yul-|to drink (vb)
yulda¹|drink, draught, thing drunk; ⚠️cup (n)
yulda²|drunk (adj)
yúlima|drinkable (adj)
yullas|tea (n)
yullumë|twice, two times (adv)
yulma|cup, drinking vessel, drinking implement, ⚠️goblet (n)
yulmë|drinking, carousal (n)
yulmo|drinker (n)
yulmon|chalice (n)
yuluitë|drinking (as a habit), *aquatic (adj)
yulunefítë|amphibious, *(lit.) drinking-breathing (adj)
yungwa|appliance (n)
yuqua|appliance (n)
yunquë|twelve (cardinal)
yunquëa|twelfth (ordinal)
yunquesta|*one twelfth (fraction)
yuquain|twenty (cardinal)
yúquëan|twenty (cardinal)
yuquain tuxa|one hundred twenty (cardinal)
yur-|to run (vb)
yutya-|to lend, loan (vb)
yúyal|twilight (n)
úyalë|twilight (n)
yúyo|both (adj)
ezel(la)|green (adj)
