-at|verb ending (like a participle) (suf)
-hai|folk (suf)
-ul|3rd-person-pl-object, them (suf)
-um|particularizing suffix (article)
-ûk|the whole, all (suf)
Golug|Noldor (n)
Nazgûl|Ring-wraith (n)
Oghor-hai|Wose-folk (n)
Olog-hai|Troll-folk (n)
Uruk-hai|Orc-folk (n)
agh|and (conj)
ash|one (cardinal)
bagronk|cesspool; torture chamber (n)
burzum|darkness (n)
búbhosh|great; dung-heap, muck heap (adj n)
búrz|dark (adj)
durb-|constrain, force, dominate (vb)
ghâsh|fire (n)
gimb-|to seek out, to discover (vb)
glob|fool; filth (n)
goth|lord or master (n)
gûldur|sorcery (n)
gûl|phantom, shadow of dark magic, wraith; †black arts, sorcery (suf)
ishi|in, inside (prep)
krimp-|to tie, to bind (vb)
lûg|fortress, lock-up, prison (n)
nazg|ring (n)
olog|Troll (n)
pushdug|dungfilth; stinking (n adj)
sharkû|old man (n)
sha|with (prep)
skai|interject[ion] of contempt (interj)
snaga|slave (n)
tark|man of Gondor (n)
thrak-|to bring by force, to hale, to drag (vb)
uruk|Orc (n)
u|to (prep)
