(a)cainu-|to wed (vb)
(a)cainusta|wedding, marriage (n)
(a)malda|tender, soft, kind, gentle (adj)
(a)rauca|swift, rushing (adj)
(a)rauce|demon, fiend (n)
(ana)tarwesta|crucifix(ion) (n)
(en)no|*then, next (adv)
(es)sa|*that (there) (pron)
(h)áva|*its; 3rd sg. neut. possessive emphatic (adj)
(h)íva|*her; 3rd sg. fem. possessive emphatic (adj)
(h)úva|*his; 3rd sg. masc. possessive emphatic (adj)
(m)ambe; ama; amaimi; ambi; amis; ammi; âmi|mother (n)
(or)tande|above (of motion upwards) (adv)
(uru)purnie|conflagration (n)
-(a)r|masculine/agental suffix (suf)
-(l)inta; -(w)inta; -(w)inte; -inya; -itsa; -itse; -linte; -litse; -lla; -lle; -pi(t); -pin(ce); -tsa; -íne(a)|diminutive (suf)
-(n)dóra|million (suf)
-(n)dóre|-illion, *large number suffix (suf)
-(u)ma|a, an; some, certain (suf)
-(v)ando; -(y)ando; -yanda|augmentative (adj)
-a; -ea; -ina; -ra|adjectival suffix (suf)
-alca; -elca; -olca|able to (suf)
-alima; -ima|-able, possible (suf)
-co; -to|reflexive suffix (suf)
-cto|reflexive (suf)
-i; -r|plural suffix (suf)
-ica|partitive (suf)
-ie; -le; -me; -sse|abstract noun (suf)
-ilda; -lda; -umea; -umya; -úme|augmentative (suf)
-ilqua|-ly or -like (suf)
-il|*(feminine) patronymic (suf)
-ince|*diminutive (suf)
-ine; -lin; -lis; -re; -rin|noun suffix (suf)
-inen|of, out of; partitive suffix (suf)
-inya|worthy to be - (suf)
-ion; -yon|-son (suf)
-issa; -quet(se)|language (suf)
-ite|adjective ending (suf)
-li|many, multiplicative suffix (suf)
-llo|from, out of; ablative suffix (suf)
-llume; -luxe|-times (suf)
-lta|?causative (suf)
-l|dative suffix; plural [verb] (suf)
-léni; -lénu|long (suf)
-mas (-mast-)|-ton, -by (suf)
-matwa|*-eating (suf)
-ma|a; some, certain; passive participle (suf)
-mo|agental suffix (suf)
-n (-nd-)|active participle (suf)
-ndo; -nu|masculine suffix (suf)
-ndon|-ly, -ily; manner suffix (suf)
-ngwe|*together (suf)
-ni; -si; -sse; -tsi (Mankind)|feminine suffix (suf)
-noina; -noite; -se; -voite; -wa; -ya|adjective suffix (suf)
-nta; -tta|to, at, towards; allative suffix (suf)
-nto; -sto|fraction suffix (suf)
-n|genitive suffix (suf)
-oran; -uran(do)|town (suf)
-o|genitive ending (suf)
-quil(e)a|-hued (suf)
-quilna|-pied (suf)
-r (Grammar)|impersonal [verb] (suf)
-r (Spatial Relations)|*allative (suf)
-sse (Grammar)|at, in, by; inessive suffix (suf)
-sta|verbal noun, infinitive, gerund (suf)
-tenda|having fingers (suf)
-tule (tuli-)|bearing, etc. (suf)
-tya|causative; comparative (suf)
-t|dual (suf)
-u|adverb suffix (suf)
-valta; -vilte (-vilti-)|-less (suf)
-va|adjectival (suf)
-více|as (suf)
-wen|*number suffix (suf)
-we|a, an (suf)
Ahúra|Sun (n)
Aini|(pagan) goddess (n)
Aino|one of the great Valar (n)
Ainu|a (pagan) God (n)
Ambalar; Ambustar|the East (n)
Amillion; Sovalwaris|February (n)
Avestalis (Avestaliss-)|January (n)
Eldalie|People of the Elves, Elf-folk (n)
Eldarin; Eldarinwa|Elfin (adj)
Eldarissa|Language of the Eldar (n)
Elda|Elf; beach-fay (n)
Enu|God Almighty, Almighty Creator (n)
Narquelion (Narqeliond-)|Autumn (n)
Noldorinwa|Goblin; Gnomish (adj)
Noldorin|Gnomish (adj)
Noldorissa|Language of the Noldoli (n)
Quen; Quende (Qend-)|Elf (n)
Quenyarin|*Elvish (n)
Quenya|Elvish (n)
Rána|Moon (n)
Sil (Sill-)|Moon; Rose (n)
Tuilére|Spring (n)
Vala|God (n)
Valde; Valis; Valme; Valsi|female god (n)
Valmo; Valon|male god (n)
a-|*intensive prefix; it; 3rd sg. neut. pronoun (pref)
aca-; are-; ari-; ole-; oli-; sa-|intensive (pref)
aca; are; olóle|very, intensive (adv)
acaire (akairi-)|‘living beside’, wedded life (n)
acairis (akairist-)|bride, wife (n)
acairisan (akairisamb-)|bride chamber, thalamus (n)
acca|too (adv)
aci|extreme, vehement, excessive (adj)
acta|notion (n)
ahúrasilqui; ránuringwi|sun and moon (n)
aicasse; aicor|pine-tree (n)
aica|broad, vast (adj)
aico (aiku-)|cliff (n)
aicuvoite|cliffy, rocky (adj)
aile; marmale; soracte|beach (n)
ailin; ailo (ailind-)|lake, pool (n)
ailinon|water lily (n)
ailin|shore (n)
aimactar; aimactu|martyr (m.) (n)
aimaxin (aimaksi-)|martyr (f.) (n)
aimo|saint (m.) (n)
ainar (ainast-)|temple [body part] (n)
aina|holy, revered, worshipful (adj)
aipio|cherry (n)
aiquaire|fir, pine (tree) (n)
aiquale|a steep, steepness (n)
aiquasse|precipice (n)
aiqua|steep, tall; high, lofty, sublime; chief (adj)
aiquie|highness, height (n)
aira|holy, worshipful (adj)
aire (adj)|old (adj)
aire (n)|saint (f.) (n)
ais (aist-)|good name (n)
aistalea|worshipful (adj)
aistale|worship (n)
aista|honour, reverence (n)
aiwe; oi(we); oive; vilin|bird (n)
ai|o!, ha! (interj)
al-|form of the negative particle (pref)
ala (interj)|behold, look (interj)
ala (prep)|beyond, after; before (prep)
ala-|?to grow (vb)
ala; vasse (n)|wing (n)
alalme (alalmi-)|elm (tree) (n)
alanda; halda; landa|wide, broad (adj)
alantya|*shielded, protected (adj)
alapumba; lapumba|drum (n)
alas (alast-)|marble (n)
alasca; alaswa; alaxe|like marble (adj)
alasta|of marble, marble (adj)
alatya-|to shield, ward off, protect (vb)
alayambo|hurrah! (interj)
alcana-; canda-|to blaze (vb)
alcanta-|to make shine (vb)
alcar (Emotion)|glory (n)
alcar (Sense Perception)|shining, light of day (n)
alcar (Warfare and Hunting)|shield (n)
alcar(in)|temple, shrine (n)
alcara|brilliant, bright, shining (adj)
alca|ray (of light), light of day; shining (n)
aldamo; almo|shoulder(s), back (n)
aldare|wood (n)
alda|tree, branch (n)
aldea|tree-shadowed (adj)
aldeon (aldeond-)|avenue (of trees) (n)
allu-; alnu-; sovo-|to wash (vb)
allume|washing (n)
alluva; sauna; soina|clean (adj)
alma; yéma|face (n)
alqua; alque; siloine|swan (n)
alu|dressed leather (n)
alva|?lofty (adj)
am(u)-|up(wards) (pref)
amapta-; mapta-|to ravish, seize and carry off forcibly (vb)
amarto|fate (n)
ambapenda|uphill; arduous, difficult, tiresome (adj)
ambar (ambart-)|fate, lot (n)
ambar (ambas-)|breast, bosom (n)
ambarin (ambarind-)|lark (n)
ambarta|fated (adj)
ambasse|breast-plate, hauberk, byrne, cuirass (n)
amba|up (adv)
ambo; amun; oro; oron|hill (n)
ambos (ambost-)|breast (n)
amu-; orto-|to raise (vb)
amunta|up, risen (of the sun) (adj)
amunte|sun-rise, (lit.) lifting (n)
amu|up(wards) (adv)
an(a)|to(wards); until (prep)
an-|re- (pref)
an; áno (and-)|gift (n)
ana-|?towards (pref)
anai; anî; nyél; nî|woman (n)
anaina|womanly (adj)
anar (anard-)|giver (n)
anarie|liberality (n)
anc (anq-)|loop, handle, ring (n)
ancar (ankas-)|ear (of men) (n)
ancasse(a)|lofty, tall, (lit.) up-headed, high-headed (adj)
anda-lepta|long-fingered (adj)
anda-ráma|long-arm(ed); long-wing(ed) (adj)
anda; andra|long (adj)
ande(a) (andi-)|long (of space) (adj)
andesilque|long-haired, long-tressed (adj)
ando; posta; tarnon|door (n)
andon (andond-)|door, gate (n)
anga; tongo|iron (n)
angaina; tong??a; yeraina; yereva|of iron (adj)
angaisin(i)e|torment (n)
angaitya-|to torment (vb)
angayanda|miserable (adj)
angayasse|misery (n)
anqua(r); quan|ear (n)
anquin|bunch (n)
anta-|to give (vb)
anta|cheek; jaw(s) (n)
anto; câ; maquar|jaw (n)
antulu-|to return (vb)
anuon; anustar|monk (n)
anusta|monastery (n)
anuvoite|male, masculine (adj)
anu|a male, man (n)
anwa|high up, place high (adj)
anúre|manliness, masculinity (n)
anúva|doughty (adj)
anúvie|manhood, doughtyness (n)
apaica; apaira|conquering (adj)
apaire|victory, conquest, reduction (n)
apaitya-|to conquer (vb)
apanta-|to open, reveal, show, display (vb)
apantie|display (n)
apsa|hole, opening (n)
apta-|to open (vb)
apte (*apti-)|open (adj)
aqua-|to seize (vb)
aqui|a brace, a couple of, both (adj)
ar (as-)|to, against, next, on (wall) (prep)
ar(a)|but; and (conj)
ar; arne; hil(de) (arn-)|child (n)
aracte|(stony) beach (n)
arac|shingle, piles of stones (n)
arda|place, spot (n)
arean (areand-)|wilderness, deserted place (n)
are|beside, along (adv)
arin; purin|hearth (n)
arinya|fireside (adj)
aris (arits-)|daughter, maid (n)
arm-|to gather, collect (vb)
arma|flock of sheep (n)
arqua|arid, parched, dry (adj)
arquilis|desert (n)
artan; petl; tartan (artam-)|hammer (n)
arta|across, athwart (prep)
aru|in addition, as well, besides (adv)
arwa|field (n)
aryúlima|equal, equivalent (adj)
as; hón(a) (ass-)|bone (n)
asampe(a)|cavernous (adj)
asesta-; sesta-|to liken, compare, make like, model on, assimilate, imitate (vb)
asesta; aseste; seste|similarity (n)
asestaine|assimilation, imitation (n)
assea|bony (adj)
astuvu-|to begin (vb)
aswa; axa|of bone (adj)
at-; att(a)-|bi-, twi- (pref)
atar; atto; attu; tatto|father (n)
atempa|(strong) dislike (n)
atta (n)|father (child’s word) (n)
atta (pron)|they (emphatic); 3rd sg. neut. pronoun (pron)
atta; casse; orta|above (prep)
attahwi|parents (n)
attala-|?double (vb)
attalaite|biped (adj)
attalin|biped (n)
atwen; uiven; yucainen|twenty (cardinal)
auc|fool, clumsy fellow (n)
aule (auli-)|shaggy (adj)
aulo; fanya|cloud (n)
auqua|awkward, clumsy (of things), difficult (adj)
aure (auri-)|sunlight, sunshine, gold light, warmth (n)
aurea|sunny, sunlit (adj)
aurinca|sunny (adj)
aurinde|summer, pleasant warmth (n)
aurin|warm (adj)
auriquilea; aurquila|golden, sunlit (adj)
auro|sun (n)
ausi-|well (pref)
ausie; milcin|wealth (n)
austalende|mid-summer’s day (n)
austa|(high) summer (n)
aute; malce (ausi-)|rich (adj)
aute|goods, property, wealth, money (n)
au|away from (prep)
ava-|to depart (vb)
avalta-|to strip, despoil, denude (vb)
avande|get hence! (interj)
avanwa|going, passing, nearly gone (adj)
avarna|very rich (adj)
avealta-|to resemble closely (vb)
avesta|opening, beginning, overture; summer (n)
avíca|very much alike (adj)
axa (n)|waterfall (n)
axe; yaisa; yaxe (aksi-)|steel (n)
axína|[of] steel (adj)
a|it (pron)
ca-|cause (pref)
cabu; cart (*karp-)|bunch, tuft (n)
caca-|to laugh (vb)
cacil; catl|chuckle (n)
caicta-|to strangle (vb)
caile; cilma; cilme|lip (n)
cailen|throat, gullet (n)
caima-|to lie quiet (vb)
caimasambe|bed-chamber (n)
caimasan (kaimasamb-)|bed-room, bed-chamber (n)
caimassea|confined to bed, a-bed, bedridden (adj)
caima|couch, bed (n)
caime|dwelling, home (n)
caina (Emotion)|done, actual, real (adj)
caina (Quantity and Number)|whole (adj)
cainella; cainendan|fortnight (n)
cainen; cea; lempe (cardinal, Quantity and Number)|ten (cardinal)
caino|whole (n)
caita-|to place, lie down (vb)
caitoile|rest (n)
caivo; quelet|corpse (n)
caiya; ceanya; ceatya|tenth (ordinal)
cai|ten; (lit.) all fingers (cardinal)
cal(l)u-|to illuminate, to light up (vb)
cal-; cala-|to shine (vb)
cala (Physical World)|light, daytime (sunlight), 12 hours (n)
cala; cále|morning (n)
calain(e)a|serene (adj)
calaine|serenity, serene (n)
calar|lettuce (n)
calas (kalass-)|brass (n)
calasca; calassina|brazen (adj)
calasse|brilliance, clarity (n)
calca|sickle (n)
calce (kalki-)|brilliant (adj)
cale; lá|day (n)
calenda|of the day, opposite to night; daily (adj)
calende|festival, a special day (n)
calimbarie|barbarity (adj)
calimbo|a savage, uncivilized man, barbarian; monster, giant, troll, goblin (n)
calla; casien; casquar(in)|helmet (n)
calleva; callevoite|fair (weather or complexion) (adj)
calle|fair weather, clear sky, blue sky (n)
callo|off, from off, from on top of, from on (adv prep)
calmar (kalmarn-)|child of light (n)
calma|(day)light; candle (n)
calon (kalong-)|(large) bell (n)
calongalan; calongale (kalongaland-)|ringing or jangling of (large) bells (n)
calonga|large bell (n)
calonya-|to ring, peal (vb)
calpa|bucket, vessel (n)
calta-|to kindle, set light to (vb)
calumet (kalumett-)|lamp (n)
calume|an (artificial) light (n)
calwa|fair, beautiful (adj)
cama-|to lie down; (c. loc.) to endure, suffer (vb)
camanta-; camáta-|to make eat, give to eat (vb)
camba|bed (n)
cambo|cellar, cave, vault (n)
camillo|large poppy (n)
camilot|red clover (n)
camo|ram (n)
campilosse|wild-rose (n)
campin|hips, (wild-rose) berries (n)
campo (*kampu-)|flea (n)
camu-|to lay down, bend down, reduce (vb)
can(ta)cainen|forty (cardinal)
cana|young (adj)
cancaiya; canceanya|fourteenth (ordinal)
cancale-malina|daffodil, (lit.) yellow laughter (n)
cancale|laughter (n)
cancea|fourteen (cardinal)
candóla|crown of head (n)
candóra|bright dawn, red sky in morning (n)
canga-|to weave, spin (vb)
cangale|web (n)
cangaris; ungwe (kangarist-)|spider (n)
cangavinda|cobweb (n)
cantala-|?to harp (vb)
cantallume|*four times (adv)
cantast(y)a; cantasto|quarter, one fourth (fraction)
canta|four (cardinal)
cantele|harping; repetition (n)
cante|edge (n)
cantl|(large) harp (n)
cantóra|*four million (cardinal)
cantóre|quadrillion (cardinal)
canu; núle|lead (n)
canuina|of lead (adj)
canuva|leaden (adj)
canwa|dark red; lurid (adj)
canya|fourth (ordinal)
can|four times (adv)
cap-; capa-|to jump, leap (vb)
capalima|bounding, leaping (adj)
capalinda|spring of water (n)
capanda|jump (n)
capta- (Emotion)|to startle (vb)
capta-; halta- (Motion and Transportation)|to leap (vb)
car (kas-)|head (n)
cara-|to do, make (vb)
carape|cloak, outer garment (n)
carca-|to snarl (vb)
carcanel|fang (n)
carcapolca|boar, *(lit.) tusk-pig (n)
carcaras; carcasse|row of spikes or teeth (n)
carcara|toothed (adj)
carcasarma|large saw (adj)
carca|fang, tooth, tusk (n)
carco (karku-)|alimentary canel (n)
carda-|to admire, have affection or respect for (vb)
carina|finished (adj)
carmalin(da)|russet, orange-red (n)
carma|shape, fashion; act, deed (n)
carneambara|*red-breasted (adj)
carneambar|robin, (lit.) red-breast (n adj)
carne|red (adj)
caron|crow (n)
caro|deed, act, action (n)
carp-; carpi-|to pluck (vb)
carpale|a plucking, tugging, wrenching; deceiving, tricking (n)
carpalima|tricky, clever, willy (adj)
carpan|hank (of wool etc.) (n)
carwalin|russet (n)
cas (kast-)|head, top, summit (n)
casientule|with helm on (adj)
casondo-; casóro-|to make sit, set (vb)
casta|cause, motive, ultimate reason (n)
castea|of the head; head-, capital, chief (adj)
cate (kati-)|gleam, ray (n)
catinca|candle (n)
cauca|crooked, bent, bowed, humped (adj)
cauco (kauku-)|humpback (n)
caune|grave (n)
caurea; caurenoina|timid (adj)
caure|timidity, fear (n)
cauta-|to bend (vb)
cav-; cava-; sap-; sapa- (Agriculture and Vegetation)|to dig (vb)
cava- (Emotion)|to bow, make obeisance (vb)
cay-; caya-|to lie (vb)
ce; ena; tye|that by you (pron)
cea tuxa; minquecainen|one hundred ten (cardinal)
ceacai(li); cecainen|hundred (when not multiplied) (cardinal)
ceallume; cellume|*ten times (adv)
ceatto; ceatya; cesto; cestya|one tenth (fraction)
cecet (kekekt-)|pheasant (n)
cecta|jet, spring (n)
cectecet (kektekett-)|clucking (n)
cectele; ectele; vascelu|fountain (n)
cectelu-|to bubble up (vb)
celeta|trickle (n)
celta-|to draw water (vb)
celu(me)|stream; fountain, spring (n)
celu-|to flow (vb)
celusindi|river (near its source) (n)
cemen|soil, earth (n)
cemi|earth, soil, land (n)
cenqua; cenyeva|sharp (of points) (adj)
cent|a sharp point (n)
ceny-; coli-|to prick (vb)
cen|*earth, soil (n)
cere-|to turn (vb)
ceres (kerest-)|earthenware (n)
ceresca; cerexa|of earthenware (adj)
ceresto|potter (n)
cere|earthenware; earthen jar (n)
cetya|*your; 2nd sg. possessive emphatic (adj)
ce|you; 2nd sg. pronoun (pron)
cie|path (n)
cilapi; cilapinc|robin (n)
cilapitya-|to chirp (vb)
cilc-|to gather, reap (vb)
cili-|to see, heed (vb)
cilince; cilintl|small bell (vb)
cilincele|jingling of (small) bells (n)
cilintya-|to ring, tinkle (vb)
cilin|bell (n)
cilti-|to jerk, tuck (vb)
cilt|tuck (n)
cim-|to heed (vb)
cinca-|to hang (intr.) (vb)
cincata-|to hang (tr.) (vb)
cinda|splinter (n)
circis; ciris (kirist-)|cleft, crack (n)
ciri-|to cleave; *to sail (vb)
cirme|cleft, gully (n)
cirya; lunte|ship, boat (n)
ciryassea|what is on board ship (adj)
cisin|cleft (adj)
citya-|to tickle (vb)
cityale; cityasta|tickling (n)
cityalea|ticklish, susceptible, sensitive (adj)
civ-|*to germinate, impregnate (vb)
ci|may; particle of uncertainty (particle)
coi; coile; coire; laume; loa|life (n)
coina|living, alive (adj)
coirea|alive, lively (adj)
coiresta-|to spend one’s life (vb)
coisimatl|animal food (n)
coisimatwa; mimbematwa|carnivorous (adj)
coisiva|animal, bodily (adj)
coite (koisi-)|living thing, being, animal (n)
coito|*life (n)
coiva|awake; lively, living (adj)
coivie|awakening; liveliness (n)
colca|box (n)
colimen|prick (n)
colman|peak, summit (n)
colmecta|pointed (adj)
colme|point, tip (n)
colosilde|long thin point (n)
colosta|cucumber (n)
coluce|strainer (n)
colume|body (n)
colwa|narrow, thin (adj)
condasse|dragon’s lair (n)
condo; fenume|dragon (n)
condor; ohtar|warrior (n)
condorie|martial ardour (n)
conta-|to roll up, roll, pack (vb)
cor; ohta|war (n)
corda|temple (n)
cordon|idol (n)
corima; verin(a)|round (adj)
corin|circular enclosure, great circular hedge (n)
cormasta; corne|loaf (n)
corma|cake, lump (n)
cos (kost-)|quarrel, dispute, the matter disputed, legal action (n)
cosar; mahtar (kosard-)|soldier (n)
cosima|debatable (adj)
costa-|to debate, dispute (vb)
cote (kotsi-)|nut (n)
cotsia|nutty (adj)
cotsivoite|nut-bearing, nutty (adj)
cottule; cotulwe|hazel (n)
culmarin (kulmarind-)|orange (n)
culmarinda; culurinda|orange-coloured (adj)
culp-|to contain (vb)
culuin (kuluind-)|goldfish (n)
culuina; culuvoite; culuxa; laurea; laurina (kuluvoisi-)|golden (adj)
cululta; culuva|of gold (adj)
culurin|orange; piece of gold (n)
culusta|gold coin (n)
culu|gold (n)
cum-|to pile up (vb)
cumba|burdened, laden (adj)
cumbe; cúme|pile, heap; load, burden (n)
cumpo|pile (n)
cunta|full (adj)
cuo|a pain (n)
cupta-|to hump up, look lumpy (vb)
cuptulo; ulumpe; ulun|camel (n)
curdu|sin, wickedness, evil (n)
curuni; felusi|witch (n)
curuvar (kuruvard-)|wizard (n)
curu|magic, wizardry (n)
cut (kupt-)|lump, ball (n)
cu|dual 1(b) (pron)
cáma|guilt, responsibility (n)
cá|deed, act, fact (n)
céto; téco|you (emphatic); 2nd sg. pronoun (pron)
cíla|edge, rim (n)
cólemaina|patient (adj)
cólemaine|patience (n)
cólema|patience, endurance; hardship (n)
cóleta-|to endure, last (vb)
cóleva|passive (adj)
cóle|passivity, endurance, patience; a passive individual (n)
cóma|a ball (n)
cómea|globe-shaped, round (adj)
cópas|haven (n)
cópa|harbour, haven, bay (n)
cúne|crescent, bow, arch (n)
cú|crescent moon (n)
die; yenye(n)|yesterday (n)
dienda; yendiéra|day before yesterday, (lit.) yesterday’s yesterday (n)
diéra|yesterday’s; (mostly in sense) bygone, over, passed (adj)
e- (pref)|that by you (pref)
e-; ó- (vb)|to be (vb)
ea(r)|(young) eagle (n)
earen (earend-)|eyrie, (young) eagle (n)
ea|a cry of pain or woe (interj)
eccala; ectala|tomorrow morning (n)
ecce; ehta (Agriculture and Vegetation)|thorn (n)
eccia|thorny (adj)
ectaquilta; exiquilta; macilquilta|swordbelt (n)
ectar; macillar; mectar (ektard-)|swordsman (n)
ectar|hawthorn, thorn (n)
ecte (eksi-)|sword (n)
ehta (Warfare and Hunting)|sword-point (n)
ehtar (ehtard-)|swordsman, warrior; sword (n)
ehtaráma|having a wing like a sword (adj)
ehtil|spring, fount, source (n)
elben; elwen; hon; honde; hondo; londa|heart (n)
elc; elt|spear (n)
eldanyanda|*fairy tale (n)
eldaquetse; eldarisse|in the language of the Eldar (adv)
eldaquet|language of the Eldar (n)
eldasilque|maidenhair fern, (lit.) elf tress (n)
ele-|to drive; to come (vb)
ellume|*one time (adv)
elmenda|wonder, wonderment (n)
elta-|to drive (vb)
elta|a thrust (n)
elte-|to thrust in (vb)
el|one (adj adv)
en(ec)cea|sixteen (cardinal)
en(we) (emb-)|name (n)
en-|to be called (vb)
encen; entan; tyen|then (adv)
ence|that by you (emphatic) (pron)
enda; enna|by name, named, called (adj)
ende; enexe; enque (cardinal)|six (cardinal)
endl|plain, vale (n)
eneccainen|sixty (cardinal)
eneccaiya|sixteenth (ordinal)
enecto; enquesto; enquetto|one sixth (fraction)
enectya; enquest(y)a; enquetya|one sixth (adj)
enetya|sixth (ordinal)
ene|look (at what you have)! (interj)
enga|mead (n)
engetor|fate, hap, luck (n)
enget|a hap (n)
enque (enqi-)|plane, level (n)
enque (prep)|without (prep)
enquellume|*six times (adv)
enquendóra|*six million (cardinal)
enquendóre|*sextillion (cardinal)
enquin; quin; quí; sí|*now (adv)
enqui|this (emphatic) (pron)
enta|that there (emphatic) (pron)
ento|next (adv)
ent|notion, plan, idea (n)
enwa; non(n)o; nua(n); nuo|tomorrow (n)
enyarin|device, escutcheon, blazon (n)
enya|device (method, trick), machine, engine (n)
enye-|to think out, plan, devise (vb)
en|that by you; thereupon (pron adv)
er (adj adv)|one, only, alone, a single (adj adv)
er (adv conj)|only, but, still (adv conj)
er-; har-|to remain (vb)
erda|solitary, deserted (adj)
ere(n)|iron, steel (n)
ere- (pref)|out (pref)
ere-; tie- (vb)|to go (vb)
erefainu; erevainu|release (n)
eresse (eressi-)|alone, by oneself, singly, only; once (adv)
eressea|lonely (adj)
eru (Quantity and Number)|once (adv)
eru (Spatial Relations)|outward (adv)
erumaite|one handed (adj)
erus(ta)|outside (adj n)
erya|only, single (adj)
erúmea|outer, outermost (adj)
es-|*out (pref)
esca|spear, spike (n)
esta-|to send (vb)
est|outwards (adj)
et(t)amíne; tamíne|today (n)
etil; etl|ivy (n)
ettani; ettaresse; ettaréndo; ettaréro|female cousin (n)
ettanu|male cousin (n)
ettarendi; ettaresta; rendole|cousinship (n)
etta|cousin (n)
ettele|family, kindred (in the wide sense) (n)
ettui|tomorrow night (n)
etya|other (of two) (adj)
etyo|other (of two) (n)
eule|lamb (n)
eulitse|*little lamb (n)
evandilyon|gospel (n)
evandl|Christian missionary (n)
fa-; hwa-|his; 3rd sg. masc. possessive (pref)
faica (Emotion)|bad, worthless, useless (adj)
faica; faire (Social Relations)|free (adj)
faicar|destroyer, slayer; bane (n)
faino|freeman (n)
fainu-|to release (vb)
fairie|freedom (n)
fal(a)toisi|meadow, grassland (n)
falas(se) (falass-)|shore, beach, surf (n)
falasta-|to surge, make a sound like surf (vb)
falca (Body Parts and Functions)|naked, bare (adj)
falca; quarda (Emotion)|bad (adj)
falcasse(a)|bald (adj)
faldi|free, open, wide (adj)
falin|bare, nude, fallow, wild (of land) (adj)
falmarin|sea-fay (male), spirit of the sea foam (n)
falmar|wave (as it breaks), foamcrest (n)
falma|foam, wave (n)
falmo; hoiye; uilosse|foam (n)
falquan|large sword (n)
falqua|(mountain) pass, ravine, cliff, cleft (n)
falque|cleft, ravine (n)
famba|belly, fat body (n)
fambo|fat man (n)
fan; huan (huand-)|dog (n)
fandelu; fandor; fandos; fantor; úvanimo|monster (n)
fandelwa; fandelúva; ulbanima|monstrous (adj)
fandelúvie|monstrosity, immoderation, violence, barbarity, grossness (n)
fando|portent, omen (n)
fange; poa; vanga; velte|beard (n)
fansa|swoon (n)
fanta-|to fall asleep, go dazed, swoon (vb)
fantl|vision, dream, hazy notion, imaginary idea (n)
fanwe; olor; olóre|dream (n)
fanórea; fanóriva|absent-minded (adj)
fanóre|day-dream (n)
fara|fur, fell (n)
fas; fatse (fats-)|tassel (n)
fascalan|bath (n)
fatsale|(tasseled) fringe (n)
fatsevoite|tasseled (adj)
fauca|fat, large (adj)
fausta-|to get smell of (vb)
fausta|*smell (n)
faustima|*odorous, able to be smelled (adj)
fauta-; niquista-; niquisya-|to snow (vb)
felda|worse, worst (adj)
felu|bad magic (n)
fel|worse, worst (adv)
fen (feng-)|reed (n)
feng-; vilci-|to cut (vb)
feng|serpent (n)
feno; heno (henu-)|venom, poison (n)
fenqua|keen, cutting (adj)
fent; lingwin|serpent, dragon (n)
filima; filwa|fine, thin (adj)
filimpe; filinque; filque|fern (n)
filma|fine hair, line (n)
filume; filumin|gossamer (adj)
finde; finie|cunning (n)
findil; laxa|tress (n)
findl|lock of hair, tress (n)
fine; pimpevinne|larch (n)
fingil|narrows, straits, gulf (n)
fingwa|narrow (adj)
fint|a trick, notion (n)
finwa|acute, sagacious (adj)
fion; hilmo; hilu; ion; vondo; vô; yon; yó (fiond-)|son (n)
firin (Clothing and Adornment)|necklace (n)
firin (Physical World)|ray of sun (n)
firinga|carcanet, necklace (n)
foalóce|*serpent that guarded a treasure (n)
foa|hoard, treasure (n)
foina|hidden, secret (adj)
fui; móri|night (n)
fuiva|*murky (adj)
fuiyáru|deadly nightshade (n)
fum-|to sleep (vb)
fumella|(red) poppy, *(lit.) flower of sleep (n)
fundu(na)-|?to thunder (vb)
furin; hurin|hidden, concealed (adj)
furu|lie (n)
fustúma|*able to be smelled (adj)
fáse|gulf, gap (n)
fáwe; niquis|snow (n)
fé|last hour, last breath, (act of) death (n)
fóle|stealth, a secret, secrecy (n)
fólima|secretive (adj)
fúmelot|poppy (n)
fúme|(deep) sleep (n)
ha-|*its; 3rd sg. neut. possessive (pref)
haca-|to squat (vb)
hacca|the hams, buttocks (n)
halcin|frozen (adj)
halis; halisce (haliss-)|rush (n)
halme|drawing (n)
haloisi|the sea (in storm) (n)
haloite|leaping (adj)
hamba; hambanoite|on the ground (adj)
hampa-; tantila-|to hop (vb)
han (hamb-)|ground, earth (n)
hanta|a blow with an axe (n)
hant|down, to the ground (adv)
hapta-|to eject, ejaculate (vb)
har(e)|near (adv)
hara(nda)|flesh-meat (n)
haranwa|fleshly, carnal (adj)
hari-; moc-|to hate (vb)
hari; vísi|blood (n)
haruni|grandmother (n)
haru|grandfather (n)
hata-|to hurl, fling (vb)
hatsea|rushing, rapid (adj)
hatse|headlong movement (n)
haura|old, aged, ancient (adj)
ha|it; 3rd sg. neut. pronoun (pron)
hea|it (emphatic); 3rd sg. neut. pronoun (pron)
helca|ice-cold (adj)
helce; yalca|ice (n)
helilocte|wisteria, (lit.) purple cluster (n)
helinillea|*violet [colour] (adj)
helinille|violet (n)
helinquila|mauve (adj)
helinwa|of pansies; (of colour) a blue-violet (adj)
helin|pansy (n)
hempa|cord (n)
hen; sinda (hend-)|eye (n)
henuva|venomous, poisonous (adj)
hepe-; lim-|to bind (vb)
herendo; heréro; hestaner; hestanoinu; hestanu|brother (n)
heresse; hestani; hestanoini; hestaquin|sister (n)
heri; heruni|lady (n)
heritse|an Inwe (n)
herivesti; veri; veruni; vesse; vestin|wife (n)
heru-; varda-|to rule (vb)
heruvesto|husband, (lit.) lord husband (n)
heru|lord (n)
hes (hest-)|brother, sister, *sibling (n)
hesin; yelin|winter (n)
hessa|dead, withered (adj)
hesta-; narqua-|to wither (vb)
hesta; hestale|the nearest consanguinity (n)
hestanoina|bearing the nearest consanguinity (adj)
hetl|bond (n)
hie|she (emphatic); 3rd sg. fem. pronoun (pron)
hilc-|to freeze (vb)
hilmie|offspring (n)
hilmi|family, offspring (collective-noun)
hir (hird-)|inwards, interior, inside, heart (n)
hista-|to fade (vb)
histe-|to hiss (vb)
histe|dusk (n adj)
hiswa|dim, fading (adj)
hi|she; 3rd sg. fem. pronoun (pron)
hohye|fluff (n)
holle|shout (n)
holtȯ-|to call out (vb)
holwe|stench (n)
holále; hulále|babble, chatter, conversation (n)
hon; ondo|stone, rock (n)
hont (honty-)|sneeze (n)
hontosse|a loud sneeze (n)
horinel (horinell-)|pine-needle (n)
horma|horde, host (n)
hos(se) (host-)|folk, people, tribe (n)
hos(t) (host-)|dwelling, hamlet (n)
hosse (Warfare and Hunting)|army, band, troop (n)
hosse; ossa|wall and moat (n)
hosta (Social Relations)|folk (n)
hosta-|*to gather (vb)
hosta; hostar (Warfare and Hunting)|walled tower (n)
hostalca|able to gather (adj)
hostar|tribe (n)
hototyosse|a cough and a sneeze (n)
hotyo-|to sneeze (vb)
hualque; tolcea|eighteen (cardinal)
hualquenya; hualquetya; hualtya; tolcaiya|eighteenth (ordinal)
hucaiya|nineteenth (ordinal)
hue; olme(t)|nine (cardinal)
huecainen|ninety (cardinal)
huest(y)a; huetya|one ninth (adj)
huesto; huetto|one ninth (fraction)
huiva|murky (adj)
hui|dark, murk, fog; night, evening (n)
hulin; hulqua|naked (adj)
hum-|*to sleep (vb)
humetya|*thousandth (ordinal)
hunda|low, lowly (adj)
hunto|elephant (n)
hur-|to speed (vb)
hus-; usta-|to burn (tr.) (vb)
hu|he; 3rd sg. masc. pronoun (pron)
hya (prep)|by (prep)
hya (pron)|this by us (pron)
hya-; sia-|*their; 3rd pl. fem. possessive (pref)
hya-|*her; 3rd sg. fem. possessive (pref)
hyal-|to ring, resound (vb)
hyalin|paper (n)
hyalme|loud ringing noise (n)
hyalta-|to strike, make ring (vb)
hyan-|to injure (vb)
hyanda (Agriculture and Vegetation)|blade, share (n)
hyanda (Possession and Trade)|harm, damage (n)
hyanda-|to mow, cleave (vb)
hyapa|shoe (n)
hyar-|to plough (vb)
hyar; hyarma (hyarm-)|plough (n)
hyasse|rushing ?hence (?noise) (n)
hyasta-|to rush, rustle (vb)
hyecca|jerk (n)
hyehta-|to jerk (vb)
hyelle; lalle|pebble (n)
hyuxo|hiccup (n)
hyá-|to stand (vb)
hyá|here by us (adv)
hyúne|deep blue (adj)
hére; maxilis|lordship (n)
híse|dusk, mist, haze; bleared (n adj)
hóre (hóri-)|pine, stone pine (n)
hô|owl (n)
húcea|nineteen (cardinal)
húme|thousand; †great number (cardinal)
húro|storm (n)
húta-|to whoop (vb)
hútatyosta|whooping cough (n)
húya|ninth (ordinal)
húyo|he (emphatic); 3rd sg. masc. pronoun (pron)
i (pron)|*those, whom (pron)
i-|she; 3rd sg. fem. pronoun (pref)
i; in (article)|the (article)
ice; ni; qui; quinda; si; sinda; táma (iki-)|this (adj)
ici|look! (what I have) (interj)
icto; ixo|reflexive 3rd sg. (pron)
ielúme; yúye|long ago (adv)
ie|ago, †long ago (adv)
il(l)aica|blunt (adj)
il(l)oite|withered, dead (adj)
il-|un-; negative prefix (pref)
ilc-|to seem (vb)
ilcala|*nighttime, darkness (n)
ilcarna|unfinished (adj)
ilca|reflexive 3rd sg. pl. adj. (adj)
ilce|appearance (n)
ilco|reflexive 3rd sg. pl. (pron)
ile; necte|honey (n)
ilimba|milky (adj)
ilin (ilim-)|milk (n)
ille (illi-)|throng, crowd (n)
illia|in multitudes (adj)
ilma (Physical World)|air (n)
ilma; millo|oil (n)
ilqua|oily, smooth, glossy (adj)
ilsa|(mystic name of) silver (n)
ilt-|to thrust home, come in (vb)
iltanca|unsteady (adj)
ilt|dig, stab (n)
iluin(do); ilumar (iluind-)|dwelling beyond the stars for the blessed (n)
iluquinga; uccu|rainbow (n)
ilu|ether (n)
ilweran(ta)|bridge of heaven, rainbow (n)
ilwe|sky, heavens (n)
imbe; nierwe; nierwes|hive (n)
imbile|swarm, flock (n)
imbilinc|sparrow (n)
iminqua; inquavíca|exactly alike, identical (adj)
imi|in, inside (adv)
indoite|indoors, at home, homely, domestic (adj)
indolis|domicile (n)
indor|master of house (n)
indositsina|domestic(ated) (adj)
indo|house (n)
ingwe (ingwi-)|fish (n)
ingwil(in) (ingwiling-)|eel (n)
inqua|same (adj)
inquile|sameness (n)
inta-|to go (indefinite), fare, proceed (vb)
int|inwards (adv)
inwetelumbe; telumbe|mushroom, (lit.) fairy-canopy (n)
inwilitse|little fairy (n)
inya; titta|tiny (adj)
inye-|to imitate, make like (vb)
io; miru|wine (n)
iqu-|to beg, ‘pray’ [ask earnestly] (vb)
iquis (iqist-)|requirement (n)
iquista-; iquisya-|to ask for, request (vb)
iquista|a request; if you please, please (n)
ir (ird-)|interior, centre, inwards, inner parts (n)
irin; pelle|town (n)
irmin|the inhabited world (n)
irt (irty-)|peck, pinprick (n)
irty-|to peck, prick (vb)
irya|wish (n)
is (iss-)|light snow (n)
iscane|pallor (n)
isca|pale white (adj)
isqua; iswa|wise (adj)
isqualea|clever (adj)
isquale|cleverness (n)
isse|knowledge, lore (n)
ista-|to know (vb)
istaléra|*knowledgeable, wise (adj)
itisin|itching (adj)
itisya-|to itch, irritate (vb)
itis|a fly bite (n)
itse|small fly (n)
ixa|reflexive 3rd sg. adj. (adj)
iye; luin|ago (adv)
lac (laq-)|snare (n)
lahta-|‽ (vb)
laica; laiqua|green (adj)
laica|keen, sharp (adj)
laicelastea; lastalaice|sharpsighted (adj)
lailexe; tasarin; tassarin|willow (n)
laiquasse|greenness (n)
laira-|to wear out, break up (vb)
laire|meadow (n)
laisi; laito|youth, vigour, new life (n)
laivar|ocean (n)
laiwa; níva|pale (adj)
lala-; lalla-|to chatter, babble (vb)
lalar (lalard-)|babbler (n)
lalta-|to smooth out; stroke (vb)
lalta; lilt; tantare|dance (n)
lamandar|herdsman, shepherd (n)
lamanwa; laminya|animal-like, beastly, stupid (adj)
lama|animal, beast; head of cattle or sheep (n)
lambe|tongue of body but also occasionally of land or even = speech (n)
lampa-|to beat, hit (vb)
lamáre; lámarin|flock (n)
lango|neck, throat (n)
lanqu-|to get by lot or luck, find (vb)
lanqua|piece of fortune, lot, luck, happen, hap (n)
lant-|to fall, drop (vb)
lanta-|to fall (vb)
lanta|fall, falling; fallen, falling (n adj)
lapa-|to wrap, swathe, wind (vb)
lapatl|leveret (n)
lapatte (lapatsi-)|rabbit (n)
lapil|swathe, flowing cloth (n)
lappa|loose-end, end of rope, hem of robe (n)
lapta-|?to relax, loosen (vb)
laqua-|to catch, seize, snare (vb)
larmavoite; larmea|roomy, spacious (adj)
larma|area, space, room (n)
laruce|fat, rich (adj)
laru|fat, grease (n)
lar|region, place (n)
larúva; lisiva|greasy (adj)
lassea|with leaves, leafy (adj)
lasselanta|the Fall, Autumn (n)
lasse|leaf; petal (n)
lasta|sight (n)
lat (latt-)|flap, small hinged door, lid (n)
lata-|to be able to (used of opportunity, permission) (vb)
latsina|level, smooth (adj)
latta|year (n)
lattin; lattulis|window (n)
latucenda|of tin (adj)
latwa|smooth, glossy (adj)
latúcen|tin (n)
lauce (lauki-)|vegetable, plant (species) (n)
laucien (laukiend-)|vegetable or kitchen garden (n)
laule; lauste|life, mode of life (n)
laulema|inhabiting (adj)
laulemo|inhabitant (n)
laulemuine|people of the neighborhood, population (n)
laulesta-; lausta-|to lead a life, gain a living (vb)
laulesta|livelihood (n)
laumea|dark, stormy (adj)
laume|storm, overcast sky (n)
laupe|tunic, shirt (n)
laure (lauri-)|(mystic name of) gold (n)
lausimatl|vegetable food (n)
lausimatwa|vegetarian (adj)
lausiva|living (of plants) (adj)
lausta-|to roar, rush [making a rushing sound] (vb)
lausto|*noisily (adv)
laute (lausi-)|living thing, (esp.) vegetable (n)
lava-|to lick (vb)
la|before; than (prep)
le (prep)|with (accompaniment) (prep)
le (pron)|you (plural) (pron)
lea-|*your; 2nd pl. possessive (pref)
lea|smooth, slippery (adj)
lecte-|to join together, dovetail, fit in, splice (vb)
lehe-|to ride (vb)
lehesta|ride, riding, raid (n)
lehta-|to ride, move (tr.) (vb)
lehtasta|ride (n)
lelco|you (emphatic); 2nd pl. pronoun (pron)
lelya|*your; 2nd pl. possessive emphatic (adj)
lemillume|*five times (adv)
lemincainen|fifty; twenty three (cardinal)
lemincaiya|fifteenth (ordinal)
lemincea; lencea|fifteen (cardinal)
lemindea|quintuple (adj)
lemindóra|*five million (cardinal)
lemindóre|*quintillion (cardinal)
leminto; lemintya|one fifth (fraction)
leminya|fifth (ordinal)
lemin|five; (lit.) half the fingers (cardinal)
lempe (cardinal)|five (cardinal)
lempe (fraction)|one half (fraction)
lempe (n)|crook, hook (n)
lempea|decimal; half (adj)
lempessea|tenfold (adj)
lemya; lenya|half (adj)
lenc (lenq-)|limb (n)
lenca|slow, dull, stiff; left (hand) (adj)
lenquelénu|(daddy) long-legs (n)
lenu-|to stretch (vb)
lenuva|tight, narrow (adj)
lenwa|long and thin, straight, narrow (adj)
lep-|to take (vb)
lepsa|liver (n)
lepsile (lepsily-)|tendril (n)
lepta; let; tenge; tenna (lept-)|finger (n)
lepta|hooked (as a tendril) (adj)
lequet; oxa (leqett-)|joint (n)
lerendi|brotherhood, association, college (n)
lese-|to come together, gather (intr.) (vb)
lesta-|to collect (tr.) (vb)
lesta|gathering, assembly (n)
letinwesse|constellation (n)
leuce (leuki-)|sick, ill; pallid, wan (adj)
leume|sickness (n)
lev-|to move (intr.) (vb)
li(n)-; ola-; olli-|many (pref)
lia(r); limba; olli|many (adj)
lia-|to entwine (vb)
liantasse|vine (n)
liante|tendril, vine (n)
lia|twine (n)
licinda-|to blow a trumpet (vb)
licinda|trumpet (n)
licinde; licinne|blowing of horns (n)
licin|horn, curled horn (n)
lielesta|folk moot (n)
liende|the folk, people (n)
lie|people, folk (n)
lilda; lildo(s); olda (Quantity and Number)|more (adj)
lilt-|to dance (vb)
liltie|dancing, dance (n)
limbelu|*long (adv)
limbe|a number (n)
limil|chain (n)
limna|sheaf (n)
limpa(pa)lasse(a); limpalassea|much roaring (adj)
limpalasse|much roaring (n)
limpelis|*fairy-drink (n)
limpe|drink of the fairies, fairy-drink, elfwine (n)
lin; linde (lind-)|melody, air, tune, musical voice (n)
lin; lingo; oqui|snake (n)
linda (Emotion)|gentle, kind; soft (adj)
linda (Language and Music)|singing (adj)
lindea|singing, *musical (adj)
lindelea|melodious (adj)
lindele|music, song (n)
lindelin|melody, tune (n)
lindelocte|laburnum, (lit.) singing cluster (n)
lindo|singer (n)
lindórea|singing at dawn (esp. of birds) (adj)
linga-|to hum like the string of a harp (vb)
lingwe|snake, worm (n)
lingwilla|coil, spire (n)
linquea|watery (adj)
linque|water, stream; flowing, wet (n adj)
lint (linty-)|fluff, down, soft stuff (n)
linta(ta)sarind(e)a; lintasarindea|having many willows (adj)
linta-|to soothe (vb)
lintitinwe|having many stars, many-starred (adj)
lintu(tu)lussea; lintutyulussea; lintyulussea|having many poplars (adj)
lintuilinda|many-swallows of autumn (adj)
lintuilindórea|of autumn; when many swallows congregate and sing at dawn (adj)
linya-|to run or flow smoothly (vb)
lipil|a tiny (fay-)glass (n)
lipsa|*liver (n)
lipte-|to drip (vb)
lipte; litl|tiny drop (n)
liquilitl|icicle, *(lit.) clear drop (n)
liquilla|(clear) pool (n)
liquilta|pellucid (adj)
liquin(a); nenda; úqua|wet (adj)
liquis (liqist-)|clarity, transparence, limpidity (n)
liquistea|transparent (adj)
liri-|to sing (vb)
lirilla|lay, song (n)
lirit(ta)|poem, lay, written poem (n)
lis (list-)|grace, blessing (n)
lisce|sedge, reeds (n)
lise (lihy-)|grease, butter (n)
listea; listevoite|full of grace, blessed (adj)
listya-; salistya-|to bless (vb)
lititinwe|many-starred (adj)
locta-|to sprout, bud, put forth leaves or flowers (vb)
locte (loksi-)|blossom (of flowers), (flower) cluster, bunch (n)
loima|parched, dry (adj)
loimea; loire|thirsty (adj)
loime|thirst (n)
loista-; loita-|to refresh (vb)
loite|fresh (adj)
lom-|to hide, lurk (vb)
lomba|secret (adj)
lon(de) (lond-)|loud noise (n)
londa-|to boom, bang (vb)
lopeta-|to amble, lop (vb)
lopo-|to gallop, run (of animals) (vb)
lopo; lópa|horse, mare (n)
lopsi|mare (n)
loquo-|to run (of human beings) (vb)
lor-|to slumber (vb)
lorda|slumbrous, drowsy (adj)
losille|rose (n)
lossa; ninque|white (adj)
losse|rose; (white) flower (n)
lotarwa|garden (n)
lotella|floret (n)
lotórea|flourishing (adj)
lotóre|blooming, flowering, best time, flower (n)
loxe (loksi-)|bunch, cluster (n)
loyo-|be thirsty (impers.) (vb)
luc-|to pull (vb)
lucta-; lúta-|to have time pass (vb)
lucta|period (n)
luhtu|magic, spell (n)
luina|ago (adj)
lumbo|dark lowering cloud (n)
lunde|(lunar) month; (lit.) period (n)
lunga(na)-|to sag, bend (down), hang heavy, lean (vb)
lunga; lungo; talca|heavy (adj)
lur-|?to be dark (vb)
lusta-|to bathe in warm water (vb)
lusta|warm water (n)
lut-|to flow, sail (vb)
lutl|gum, paste, sticky matter (n)
lutta-|to flow, float (vb)
lutto-|to swill, wash (vb)
lutu-|to flow, float, sail (vb)
luvu-|to lower, hang, brood (vb)
luxima|fleeting, fading, temporary (adj)
luxo (luksu-)|mud (n)
luxor|swamp, bog (n)
lu|dual 2 (pron)
láta-|to spread, extend, lie (of country) (vb)
lávear (láveard-)|glutton (n)
lá|moor, heath, open space (n)
lé-|to come, be sent, approach (vb)
lé|a sward, glade (n)
límen|thong, band (n)
líneneldora|having many beeches (adj)
líne|thread, cotton (n)
líse; sutya; suxa|sweet (adj)
lísele|sweetness (n)
lóce (lóki-)|snake, dragon (n)
lóme (lómi-)|dusk, gloom, darkness; shadow, cloud (n)
lómea|*gloomy (adj)
lómina|shadowy (adj)
lómin|shade, shadow (n)
lótea|full of blossom (adj)
lótequilna|broidered with flowers (adj)
lóte|flower, bloom, blossom (n)
lóto-|to bloom (vb)
lúce|slime (n)
lúcima|slimy (adj)
lúlea|sapphirine (adj)
lúle|blue stone, sapphire (n)
lúme (lúmi-)|time (n)
lúmen|year, period (n)
lúmia|pertaining to time, temporal (adj)
lúne (lúni-)|blue, deep blue (adj)
lúnelinque|flowing; *blue-water (adj)
lúrea|overcast, dark [of weather] (adj)
lúre|dark weather, bad weather (n)
lúsina|warm, glowing (of things); affectionate, hearty (of people) (adj)
lúto|flood (n)
lúvin(a)|dark, overcast (adj)
lú|24 hours, day (n)
ma (adv)|*interrogative particle (adv)
ma (prep)|*by (prep)
ma-|together, in one (pref)
mac-|to slay (vb)
maca-|to slay; to die (vb)
macca|slaughter (n)
macil; malt|sword, broadsword (n)
macta-|to slay, slaughter (vb)
macte; mahte (maksi-)|hold, grip, power, possession (n)
macte; má|hand (n)
mactya-|to kill (vb)
mai (Mind and Thought)|if; do? (adv)
mai; máye (Quantity and Number)|too much (adv)
maica|cruel (adj)
mailina|beautiful (adj)
maira|excessive, strong (adj)
mairo|*horse (n)
mairu|(horse) mane, flowing hair; charger (n)
maisilanda|sycamore (n)
maisinto; maisintya; maisitto; maisitya|one thousandth (fraction)
maisinya; tuxainenya|thousandth (ordinal)
maita|maimed (adj)
maite (adj)|handed (adj)
maite (n)|maple (n)
maite; tuxa cainen; tuxainen (maisi-)|thousand (cardinal)
maivoine|great longing (n)
maivoita-|to long exceedingly after (vb)
mal-|to crush, squeeze (vb)
mala- (Physical Acts and Materials)|to be able to (used of capacity, ability) (vb)
mala- (Possession and Trade)|to hurt, pain (vb)
malaqua|soft, yielding, tender (of meat, substances, etc.) (adj)
malasta; malda|tender (adj)
malcane; valcane|torture (n)
malcasta|lordship, province (n)
malca|giving pain, hurtful (adj)
malco (malku-)|lord, sir (n)
malcor|castle (n)
malcuvoite|lordly, noble (adj)
mald-|to pound, crush (vb)
malda (Emotion)|better, best (adj)
maldor|agony (n)
malenca|left handed (adj)
malicon (malikond-)|amber (n)
malicondea|of amber (adj)
malin(d); malina|yellow (adj)
malle|street, road (n)
malo (malu-)|moth (n)
malo|rust (n)
malu-|to devour (vb)
malwa|pale, yellowish (adj)
mal|better, best (adv)
manca|few (adj)
manda-|to dwell, remain (vb)
mande; vande|well (adv)
mandu|hell; abyss (n)
mane (mani-)|good (moral) (adj)
mange (mangi-)|grease (n)
mange|lack, want, shortage (n)
manimo|holy soul (n)
manta|eaten (adj)
mantele|gauntlet (n)
mantl|glove (n)
manwa-|to prepare (vb)
manwa|ready (adj)
manya (adj)|good (not evil) (adj)
manya; mingwe; telpe; úle|butter (n)
man|who (pron)
map-|to seize, take (vb)
mapa-|to seize, take; to ravish, seize and carry off forcibly (vb)
mapalin|plane [tree], sycamore (n)
maptale-lehesta|(robbing) raid (n)
maptalesse|rapine (n)
maptale|seizure; robbery by violence; rape, ravishment, forcible seizure and carrying off (n)
mapta|ravishment, seizure, (usually =) rape (n)
maqua; maqualea|handy, skilled (with hands) (adj)
maquale; maquile|legerdemain, sleight (n)
mar (mard-)|grit, coarse grain or powder (n)
mar (mas-)|house, home, dwelling (of men); -land, the Earth (n)
mar-|to get ripe, come to ripeness, get ready, grow up, get mellow (vb)
mara- (Dwelling and Furniture)|to dwell, live (vb)
mara-; masta-|to tarry, linger (vb)
marcirya|ark (n)
marc|ripe juice, sap, ooze, moisture (n)
mard(a)-|to grind, pulverize (vb)
marda|world (n)
mardo|dweller (n)
maricta|wrist (n)
marilla|pearl (n)
marin(a)|ripe, mature (adj)
marinde; marinne|fruit tree (n)
marin|(ripe) fruit (of apple type) (n)
marma; tyusse|sand (n)
marqua|oozy, juicy, moist (adj)
mart-|to happen (impers.) (vb)
marta-|to chance (vb)
marto|fortune, fate, lot, luck (n)
mart|a piece of luck (n)
maru|pulp (n)
mas-|to bake, cook (vb)
masca|dusky, misty (adj)
masce|dusk (n)
mastacorne|[bread] loaf (n)
masta|bread (n)
masto; ruella; vasto|village (n)
maswa|soft, cooked, ripe (adj)
mat (matt-)|meal, meal time (n)
mat-; mata-|to eat (vb)
matl; matso|food (n)
matsa|good to eat, nice (adj)
matsile|bear (n)
matsima|edible (adj)
matu|the mouth (inside) (n)
maule|crying, weeping (n)
mauya-|to cry (vb)
mavar(do); moar(do)|shepherd (n)
mavoisi|chestnut (n)
mavoite (mavoisi-)|having hands (adj)
maxa-|to cook (vb)
maxar|cook (n)
maxella|mesh (n)
maxeta-|to enmesh (vb)
maxe|net (n)
maxilistea; maxima|powerful, having possession of or authority over (adj)
me (pron)|we; 1st pl. exclusive pronoun (pron)
me; men (prep)|?with, in(to), on (prep)
mea-|*our; 1st pl. exclusive possessive (pref)
mear (mearn-)|gore, blood (n)
mecilwa|central (adj)
mecta|centre (adj)
mecte-|to aim at (vb)
mecte|heart; centre (n)
mel(i)na|dear (adj)
mel-|to love (vb)
meles(se) (meless-)|love (n)
melie|*love, loving (n)
melin; santa (melind-)|dear, beloved (adj)
melitsa|beloved, favourite (adj)
melitse|darling, sweetheart (n)
mella|girl (n)
melmo|we (emphatic); 1st pl. exclusive pronoun (pron)
melpo|gooseberry (n)
melwa|lovely, fair (adj)
men (mem-)|nose, beak (n)
mente|peak, tip (n)
menya; quenya|*our; 1st pl. exclusive possessive emphatic (adj)
meoi; yaule|cat (n)
mequa|middle (adj)
meril|flower (n)
mesta|bye (n)
met (mekt-)|mark, aim, object (n)
metl; tóle (mekil-)|centre (n)
mi(e)-; mice-; mici-|diminutive (pref)
mice|little, a (little) bit; diminutive (adv)
mie (Physical World)|mist, drizzle (n)
mie (Spatial Relations)|bit, small piece (n)
milc(i)-|to possess, have, keep (vb)
mild(i)-|to pound (vb)
mildi|pease (collective-noun)
mile (mili-)|seed (n)
milin|grain of seed (n)
milnar(wa)|sown field (n)
milt|semen (n)
mimbe|flesh (n)
min (mind-)|bit, piece (n)
min yucainen; minya yucainen; yucainen min|twenty one (cardinal)
min-yucainen(ya); minya yucainen(ya)|twenty first (ordinal)
minda-|to diminish, fade, lessen, vanish (vb)
mindl|piece of flesh (n)
mindon|turret, tower (n)
mindorinya; mindóranya; mindóratya|millionth (ordinal)
mindoritto; mindórinto; mindórintya|one millionth (fraction)
mindóra; mindóre|million (cardinal)
minga|waning (adj)
minquellume|*eleven times (adv)
minquenya; minquetya|eleventh (ordinal)
minquest(y)a; minquesto; minquetto; minquetya|one eleventh (fraction)
minque|eleven (cardinal)
minti|memory, remembrance, mindfulness (n)
minty-|to remind; (impers.) it reminds me = I remember (vb)
mintya|reminding, ‘memoryful’ (adj)
minu-|to make less, decrease, spoil, alter for worse (vb)
minwa; pinilya; pínea|small (adj)
minya (adj)|fine, slender (adj)
minya (ordinal)|first (ordinal)
minyallume|firstly (adv)
min|one (in a series); the first (cardinal)
miqu-|to kiss (vb)
miquele|kissing (n)
mique|kiss (n)
miquilis|gentle or soft kisses (n)
miquilitse|little or tender kiss (n)
mirc; mirt (mirty-)|grin (n)
mirde; quosse|mist (n)
mire; mirin|smile (n)
miri-|to smile (vb)
mirilla|faint smile (n)
mirmila|rippling (adj)
mirmile|ripple of laughter (n)
mirtya-|to grin (vb)
mirucarne (mirukarni-)|wine-red (adj)
miruvor|drink of gods (n)
miruvóre (miruvóri-)|nectar, drink of the Valar, sweet drink (n)
mir|one (cardinal)
mirúva|like wine, winy (adj)
mis (mist-)|urine (n)
mitta (n)|piece, bit (of indeterminate size) (n)
mitta (prep adv)|in, into, inwards (prep adv)
mitta-|to enter (vb)
mitya|little (in quantity) (adj)
mi|*in (prep)
moa; sauve|sheep (n)
moalin|sheepfold (n)
moica|soft, gentle (adj)
moile|tarn (n)
moina|safe, secure (adj)
mordo|warrior, hero (n)
morinda|of the night, nightly (adj)
morna; morqua|black (adj)
morquilea|of the hue of night (adj)
moru-|to hide, conceal, lurk (vb)
morwa|unclear, secret (adj)
mucta-|cacare [Latin], *to empty bowels (vb)
mui; yaxe; yaxi|cow (n)
mul (muld-)|fine powder (n)
mul(u)-|to grind (vb)
mulda; mulina|powdery (adj)
mulmar|miller (n)
mulma|fine flour (n)
mulmin|mill (n)
munqua; muqua|filthy (adj)
munta|nothing (n)
mure (mury-)|heat, close weather (n)
murmea|slumbrous (adj)
murme|slumber, sleep (n)
muru-|to slumber, sleep (vb)
murya|close, muggy (adj)
mut (mukt-)|dirt, filth (n)
mu|dual 1(a) (pron)
máca|each, every (adj)
málea|able (adj)
mále|ability (n)
málos; taure; taurie|forest (n)
mána; narca; qualna; varda|dead (adj)
máne|spirit of the air (n)
mára (adj)|mighty, power[ful], doughty; good, excellent, useful (of things) (adj)
mára (n)|*world (n)
máwar|*shepherd (n)
máwe (máwi-)|gull, seamew (n)
mírea|smiling (adj)
mírien|mirth (n)
móle; tarca|root (n)
móre (móri-)|night, darkness; black, dark (n adj)
mórilanta|nightfall (n)
móriva|nocturnal (adj)
móro|ink (n)
múco|dung, stercus [Latin], *manure, muck (n)
múna|?without (prep)
nac (naq-)|anything stolen, a theft, a trick (n)
naca-|to bite (vb)
nahta-|to slay cruelly (vb)
nahúa; nauva|giant (n)
naica (adj)|stricken ill, sick (adj)
naica (n)|dagger (n)
naice; narwe; ongwe (naiki-)|pain (n)
naicelea|agonizing (adj)
naicele|anguish (n)
naice|would [that] (adv)
naico; noico|*sickly (adv)
naiqua|painful (adj)
naique|?sword (n)
naira|dire, grievous (adj)
naista-|to oppress, cause great grief to (vb)
naitya-|to damage, hurt; to put to shame, abuse (vb)
nai|remoter possibility, might (particle)
nal; umbe|dale, dell (n)
nala-|to sing or ring (vb)
nalba; nalda|lowly, valley (aj.), dale (aj.) (adj)
nalie|playing of tunes, ringing of bells (n)
nalle|dell (n)
nan (nand-)|woodland, *land (n)
nandin|dryad (n)
nang-|I have a cold (vb)
nanquete|speaking down the nose (n)
nanwa|being (adj)
napsa; naus (naust-)|suspicion (n)
naqua-; pili-|to steal (vb)
naquar|thief (n)
nar (nard-)|an odour, fragrance (n)
nara-|to snap, quarrel (vb)
nara|strife (n)
narca|snappy, ill-tempered (adj)
narc|spiteful remark, snap of a dog (n)
narda-|to smell sweetly (vb)
nardilea|perfumed (adj)
nardile|fragrance (n)
narqua|faded, shrivelled (adj)
narquele|fading, withering (n)
narte; píqua (narti-)|bitter (adj)
narwa|fragrant (adj)
narwe|(sweet) lily (n)
nasa-|to mislike, taste nasty (impers.); to dislike (vb)
nasta|existence, being, creature (n)
naswa|nasty (adj)
nat; neta (natt-)|thing (n)
natto (nattu-)|thing, affair (n)
nauca|dwarf (n)
nauma|hint, clue (n)
naustavilte|free from suspicion, *innocent (vb)
nauta-|to guess (vb)
naute|skin (n)
navillo|whisper, hint, suspicion, rumour, malicious comment, innuendo (n)
naxa|sour (adj)
naya-|it grieves (impers.) (vb)
na|for (prep)
nea|it is, yes (adv)
necca; pelma; tenca|pen (n)
nectele|honeycomb (n)
nehta; tarasse|hawthorn (n)
neite|wax (n)
nel(de)cainen|thirty (cardinal)
nelcaiya; nelceanya; nelceatya|thirteenth (ordinal)
nelce(a)llume|*thirteen times (adv)
nelceast(y)a; nelceasto; nelceatto; nelcesto; nelcestya|one thirteenth (fraction)
nelcea|thirteen (cardinal)
nelde tuxe|three hundred (cardinal)
neldellume; nellume|*three times (adv)
neldenelqua|square, quadrilateral (n)
neldest(y)a|one third (adj)
neldesto|one third (fraction)
nelde|three; four (cardinal)
neldorin|beech-tree (n)
neldorion|beech wood (n)
neldor|beech (n)
neldóra|three million (cardinal)
neldóre|trillion (cardinal)
nele; nyat|tooth (n)
nelma|needle (n)
nelqua|cornered (adj)
nelt|corner (from outside) (n)
nelya|third (ordinal)
nel|thrice (adv)
nemba|thread (n)
neme-|to sew (vb)
nemya|*needle (n)
nen (nend-)|river, water (n)
nen; súma (neng-)|nostril (n)
nendo|water mead (n)
nenyuvar; nénuvar|pool of lilies (n)
nenyu|yellow water-lily (n)
nereaine|stoutness of heart (n)
nerea|manly, stout, brave (adj)
nerevoite|manly, male (adj)
nermi|field spirit, fay of the meads (n)
nertu|strength (n)
ner|man, husband; warrior (n)
neríte|*manly (adj)
nes (nest-)|food, feed, fodder (n)
nese-|to graze, pasture, give to feed, feed (vb)
nessele|pasture, mead; pasturage (n)
nesse|(green) fodder, herb, grass (n)
nesta-|to feed (vb)
nesta|(act of) feeding (n)
nes|mead, valley, land (n)
nete- [ñ-]|to get (vb)
ne|that (conj)
nicte-|to whiten, cleanse (vb)
nienaite|tearful (adj)
nieninquea|like a snowdrop (adj)
nieninque|snowdrop, (lit.) white tear (n)
nier (nies-)|(honey) bee (n)
nies (niess-)|honey bee (n)
nie|tear (n)
nin (nind-)|blue (colour), blueness, blue green (n)
ninda (n)|water, river (n)
ninda; ninwa; ninya (adj)|blue (adj)
nindon; ningon (nindond-)|lapis lazuli (n)
ninqua-|to shine white (vb)
ninqueru|male personified form of white (n)
ninya|*my; 1st sg. possessive emphatic (adj)
nion|bee (n)
niqu(il)issea|*snowy (adj)
niquetil; niquetilde (niqetild-)|snow cap (n)
niquileninque|snow-white (adj)
niquilis|fine snow (n)
niquissea|snowy (adj)
ni|I; 1st sg. pronoun (pron)
no (adv)|then, next (of time); upon (adv)
no; nu|under (prep)
nohto-|to stick out (vb)
noldare; nolpa|mole (n)
noldova|belonging to gnomes (adj)
noldovice|like a gnome, after the gnomes’ way (adj)
nolmenoite|audacious (adj)
nolme|audacity (n)
nolmo|pit (n)
nolo-|to dare (vb)
noloite|daring (adj)
nolwa|bold, brave (adj)
nond(in)a|tomorrow (adj)
nonnúora; nuanwa; nuononda|day after tomorrow (n)
nor; orome (norn-)|oak (n)
norca|slave, thrall, servant (n)
nornea|of oak (adj)
nornelassea|having oak-leaves (adj)
norne|oak (tree), oak in general (n)
nornoro-|to run on, run smoothly and hum (vb)
norolinde|tripping lightly (adj)
norolle|cart (n)
nosse|folk, kin, people (n)
nosta-|to give birth to; to cause (vb)
nostale|species, kind; nature (n)
nosta|birth, birthday (n)
noswa|damp (of weather) (adj)
noswe|a wet wind (SW) (n)
nos|wetness, damp (n)
note (notsi-)|drizzle (n)
notsiva|drizzling (adj)
notso|damp (n)
numenda-|to get low (of the Sun) (vb)
numenda|western (adj)
nungo|cold (in the nose or head) (n)
nungwe|cold in the nose (n)
nupte|a sniff (n)
nur (nurr-)|growl, complaint (n)
nurru|growl (n)
nus (nust-)|smell (n)
nuste|sense of smell (n)
nuvu-|to smell, sniff at (vb)
nya-|*my; 1st sg. possessive (pref)
nyan(do)|another, other (of many) (n)
nyanda|nursery story or rhyme (n)
nyanya|another, other (of many) (adj)
nyar (nyard-)|tale, saying (n)
nyara-|to relate, tell (vb)
nyara|tale (n)
nyarie|fable, story, legend (n)
nyas (nyast-)|scratch, score, line, mark (n)
nyasa-|to scratch (vb)
nyata-|to talk idly (vb)
nyatl|idle talk, gossip (n)
nyelecca|onyx (n)
nyelet (nyeleks-)|nail (of the finger) (n)
nyenya|querulous, tearful, plaintive (adj)
nyenyele; nyenyesse|lament, lamentation, weeping (n)
nyenye|weeping (n)
nyor-; nyoro-; pelte-; yuru-|to run (vb)
nyéna-|to lament (vb)
nyéni|she-goat (n)
nyére; piquis(se)|grief (n)
nyé|bleat, cry of goat or sheep (n)
ná-|to be, exist (vb)
násea|loathsome (adj)
náse|loathing (n)
náve|shrewdness, sagacity, perspicacity (n)
ná|so, yes (it is) (interj)
nénu|yellow water lily (n)
nérinwa|*mannish (adj)
nímo|I (emphatic); 1st sg. pronoun (pron)
nó-|to be born, become (vb)
nóla|summit, head, top (only used of mountains etc.); (round) hill; crown of head (n)
nóleme|deep lore, wisdom (n)
nóre (nóri-)|(native) land, nation, family, country (n)
nóte; rin|dew (n)
nóva|ahead, foremost, leading (adj)
nóvo|*before (adv)
nó|after (of place), behind; after (only of time); than (prep)
númea|in the west, western (adj)
númeta-|to get low (of the Sun), go down in the west (vb)
núme|west (n)
nún|beneath (adv)
núora|tomorrow’s, to be; future (adj)
núru-|to growl (of dogs), grumble, carp (vb)
núsima|*inclined (adj)
núta-|to stoop, sink (vb)
o-; u-|he; 3rd sg. masc. pronoun (pref)
oa; toa|wool (n)
oalle|blanket (n)
oalúme|shearing time (n)
oar (oarn-)|child of the sea, merchild (n)
oara|of wool (adj)
oaris; oarwen (oarits-)|mermaid, merchild (n)
occainen; otsocainen|seventy (cardinal)
occaiya|seventeenth (ordinal)
occa|knee (n)
occea|seventeen (cardinal)
ohta-; óta-|to shout (vb)
ohta·caro|warlike deed, hostile unfriendly act(ion) (n)
ohte (oksi-)|egg (n)
oica; oiswa|poor (adj)
oilimaite|final, ultimate, last (adj)
oilima|last (adj)
oilin|*last (adj)
oinalis (oinaliss-)|ointment (n)
oine|unguent (n)
oiqua; oiwa; silwa|glossy (adj)
oise; oite|poverty (n)
oista-|to bereave (vb)
oito-|to lack (vb)
oiwie|gloss, glossiness (n)
oi|bird, hen (n)
olda; olt; olwa|much (adj)
olde|very, much, intensive (adv)
oldo(s)|more (adv)
ole (adv)|much, intensive (adv)
ole (cardinal)|three (cardinal)
olet (olek-)|forearm (n)
olirdea; ulird(e)a|pitiless, cruel, (lit.) without bowels (adj)
ollo|cliff, seaward precipice (n)
olme (olmi-)|emanation; apparition, spirit (n)
olorda|dreamy, drowsy; in dreams (adj)
olorwa|in dreams (adj)
olpe|bottle (n)
olta-|to magnify, extol, praise (vb)
olto-|to increase, multiply (vb)
olwe(n)|branch, wand, stick (n)
olwea|stinking (adj)
olwen|thirty six (cardinal)
olwe|stink (n)
olya|much (adv)
olórea|dreamy, dreamlike (adj)
omanaste|omnipresence (n)
omarimbi; omarimni|everywhere about (adv)
oma|everywhere (n)
omba|hard (*as stone) (adj)
omo-|omni- (pref)
omohére|omnipotence; almighty (n adj)
omotengwe; omotunto|omniscience (n)
omotúre; ontúre|omnipotence; almighty (n)
ompanai; ompanu; ompinasta|everyone (n)
ompa|each; all, every (adj)
on(d)|(a) stone (n)
on(t) (om-)|everything (n)
ondole|stone monument; stone-cairn (n)
ongo-|it pains me (imp.) (vb)
onin|anvil (n)
onwa|stony (adj)
opole; opolinte|fawn, young deer (n)
orc|ogre, monster, demon, giant (n)
orda; orwa; tahóra|lofty (adj)
ordie|height, loftiness (n)
ore (ori-)|seed, grain (n)
oricon|heather (n)
orivaine|pod, seed pod, pea; peapod (a boat) (n)
orme (Physical World)|summit, crest, hilltop (n)
orme; orne|tree (n)
ormin|top (n)
oro-|to rise (vb)
oroman|wood-spirit (n)
oron (orond-)|bush (n)
oronta|steep (adj)
oronte|sun-rise (n)
oronto|East, rising (of the sun) (n)
orosta (Time)|impetus, speed, haste, rash courage (n)
orosta; rosta (Motion and Transportation)|ascension (n)
orot; rótele|cave (n)
orquin(di)|ogress (n)
orva|apple (n)
orya-|to sow (vb)
oryat (oryap-)|badger (n)
or|on; above, upon (prep)
os (ost-)|cottage, house (n)
ostar|township (n)
osta|homestead (n)
osto|gates of the Sun (n)
oswe (Body Parts and Functions)|hip (n)
oswe (Emotion)|terror, horror; (evil) phantom, ghost (n)
otoce; otocotta|wailing, beating of breasts (n)
otsan; otsola|week (n)
otsollume|*seven times (adv)
otsondóra|*seven million (cardinal)
otsondóre|*septillion (cardinal)
otsonto; otsontya; otsotto; otsottya|one seventh (fraction)
otso|seven (cardinal)
otto-|to knock (vb)
otwen|84 (cardinal)
otya|seventh (ordinal)
o|over, across, along (prep)
pa-; tua-|*their; 3rd pl. masc. possessive (pref)
pac-|to apply, attach (vb)
paimene|vindictiveness, vengefulness, cruelty (n)
paimenta-; paimeta-|to exact or inflict a penalty, punish (vb)
paimesta|chastisement (n)
paime|vengeance taken, punishment, penalty, infliction (n)
paitya-|to repay, requite (vb)
paiyan|oration (n)
pal-|to shake (vb)
palanca; palanta; paluva; palwa|even, flat, level (adj)
palante; palume|plain (n)
palapapte|*sycamore (n)
palasar (palasard-)|great table (n)
palassea|foaming (of the sea) (adj)
palasse|foam, splashing (n)
palastor|surf (n)
palaswin (palaswing-)|wave-crest (n)
palasya-|to splash, foam (vb)
palava-|to stray, wander (vb)
palis(te)|sward, green, lawn (n)
palla|paunch (n)
palme|a shaking (n)
palo (palu-)|plane surface, plain, the flat (n)
palta|shelf (n)
paltyalda|palm tree (n)
paltya|flat of hand, palm of hand (n)
palucta; sarno|table (n)
palwa-|to make wander (vb)
paláva|wandering (adj)
pampil(e)a|tremulous (adj)
pampile|trembling (n)
pampine|tremor, earthquake (n)
panin|definite, planned, concerted, deliberate, prepense, meant (adj)
panna|arrangement, grouping; book (n)
pano|series, course, plan, arrangement (n)
panta (adj)|open, wide, spreading (adj)
panta (n)|board (n)
panta- (Spatial Relations)|to open, unfold, spread (vb)
panta-; tanga- (Physical Acts and Materials)|to beat (vb)
pantie|unfolding, opening, revealing (n)
panya-|to plan, arrange, intend, mean (vb)
panyara|?setting (adj)
papa-|to tremble (vb)
paptaquelasta|fall, *leaf dying (n)
papta|*leaf (n)
par-|to peel (vb)
parma|skin, bark; parchment; book, writings (n)
pat (papt-)|small leaf (n)
pata-|to rap, tap (of feet) (vb)
patacanda|rattling, clattering (adj)
patacan|rattling, clatter (n)
patacatapaca; patactatapacta|rat-a-tat (n)
patace|clatter (n)
patacta-|to clatter (vb)
patinca|shoe, slipper (n)
patl|leaf (esp. of book) (n)
patsima|wide open (adj)
peanta-|to give into one’s hands, give instructions to, enjoin (vb)
pea|scorn (n)
pecte (peksi-)|plume, cox-comb (n)
pelco|leg (n)
pele-|to surround, fence in, pen in (vb)
pelecco (pelekku-)|axe (n)
pelecta-|to hew (vb)
peler|fence (n)
pelin|fenced in, pent (adj)
peltas (peltaks-)|pivot (n)
pelto|hedge, hedged field (n)
pen; ter|through (prep)
penanwa|present, standing by, supporting, backing (adj)
penasta|being near at hand, support, backing (n)
penda (adj)|*sloping (adj)
penda (n)|bridge (n)
penta|nose, beak (probably of such birds as woodpeckers) (n)
penwa|over, passed, past (adj)
peque-|to comb, card wool, tease (vb)
pequen; pequil|comb (n)
pere-|to go through, pass, pierce; to endure, undergo, experience; to penetrate, get to understand; to last (vb)
peren (perend-)|enduring, patient, lasting (adj)
perendie|patience; endurance; an agelong period (n)
perenwa|continual, enduring, unceasing (adj)
perequa|crooked (adj)
perma|passage; pass, aperture (n)
perpere-|to endure to end, suffer great anguish (vb)
perqua|wrong (adj)
pete-|to knock, strike (vb)
pi(o)pin|haws, fruit of hawthorns (n)
pi(pi)nectar|whitethorn, hawthorn (n)
pic-|to blink (vb)
piec; piet (piekk-)|pin (n)
piecta-; pietya-|to prick, pin-prick (vb)
piexin|brooch (n)
pie|berry (n)
pihye; vite|sap, juice (n)
pilin (pilind-)|feather; arrow (n)
pilinquasilla|nodding plume (n)
pilintele|plumage (n)
pilmo; pilu|thief, robber (n)
pilna|arrow (n)
pilt (pilty-)|blow, cuff, box on ear (n)
pilty-|to strike (esp. with flat hand) (vb)
pilucca|secret, stealthy (adj)
pilwe|robbery, theft (n)
pimpilin (pimpilind-)|hanging tail, tassel (n)
pimpina|trailing (adj)
pin; pinc|little thing, mite (n)
pingwa|fat, rich (of soil) (adj)
pinque (pinqi-)|slender, thin (adj)
pinquisil(da) (pinqisild-)|(slender and) tapering (adj)
pint (pimp-)|tail (n)
piosenna|holly (n)
pio|berry, plum, cherry (n)
pipiri-|to twirl, twizzle (vb)
pipte-|to fall (of folds or clusters), hang, trail (vb)
piquesta; píquele|bitterness (n)
piri-|to spin, turn (vb)
pirimbe|ring, circle (n)
pirin (pirind-)|thin rod, pin (n)
pirindea|cylindrical (adj)
pirinumbe|cylinder (hollow) (n)
piruce; pirute|swirl, twisting, pirouetting (n)
pirúc(end)ea|pirouetting, whirling lightly (adj)
pist-; retye-|to spit (vb)
piucca|blackberry (n)
piule|greasy, overfat; overfed, spoilt (adj)
piute-|to flourish, batten, grow fat (vb)
piu|calf of leg (n)
poar; póme|north (n)
poco|bag (n)
poica|clean, tidy (adj)
poime (poimi-)|soap (n)
poimine|lather, foam; mermaid (n)
poita-|to cleanse (vb)
poitya-|to make clean, tidy, straighten (vb)
polca|pig (n)
polda|mighty, powerful (adj)
poldor|physical strength; might (n)
poldórea|muscular, powerful (adj)
pole (poli-)|oats, grain (unground kernels of oats, wheat, etc.); flour (n)
polenta|oatmeal (n)
polesse|porridge (n)
polina; poliva|oaten (adj)
polisimpe|shepherd’s pipe, Pan-pipes (n)
polonde|alder (n)
polu; polúne|kernel (n)
pondo|gate (n)
ponte (ponti-)|back, rear (n)
porocelle|chicken (n)
poroce|barn fowl, hen (n)
pote (potsi-)|after, behind (of place) (adv)
potsinallume|a second time (adv)
potsina|rearward, back, rear, hinder; next, following; second (adj)
potsi|afterwards (adv)
pucta-|*to copulate (vb)
pucta; puhta|coitus, *sex (n)
puita-|to beget (vb)
pulca; púle|body, trunk (n)
pulco|body, trunk, bole of tree (n)
pulme; tupse|lump, knob (n)
pulpa; pulwa|fat, bulky (adj)
pulque; vasa|juice (n)
pulu-|to swell (intr.) (vb)
pumpole|bubble; merboy (n)
pumpo|bubble; bladder; blister (n)
puntl|mem. vir., *penis (n)
pur (purn-)|a fire, an artificial fire (n)
purma|blaze, flame (n)
puru-|to burn (vb)
purya-|to set fire to (vb)
pus (pust-)|boil (n)
pus-|to puff, snort (vb)
puse|puff (n)
pusilla|puff, whiff, breeze (n)
pusta-; sur-|to blow (vb)
pusulpe|gas-bag, balloon (n)
pusulta-|to puff out with one’s breath (vb)
putse (putsi-)|baby, child (n)
puyando|parent (n)
pyúva|fat (adj)
pé|the two lips, the (closed) mouth (n)
píwe|fatness, richness, goodness (n)
pí|speck, spot, dot, mote (n)
pómear|northern man, norseman (n)
pómea|northern (adj)
quaina|wailing (adj)
qual-|to die (vb)
qualin|dead, dying (adj)
qualma; qualúmea|deadly (adj)
qualmea|deathly (adj)
qualme|death, agony (n)
qualta|girdled, girt (adj)
qualume (adj)|heaving (adj)
qualume; urdu|death (n)
quama-|to be ill, vomit (vb)
quamba|unwell, sick (adj)
quampa-|to hawk goods (vb)
quampale|chaffering (n)
quampa|peddlar-goods (n)
quampo|pedlar, huckster (n)
quanda|whole, all (adj)
quanta-|to fill, complete (vb)
quanta|full, whole, all (adj)
quap-|to throb, flutter (vb)
quapa-|to chaffer, bargain, swap, barter (vb)
quapta- (Motion and Transportation)|to flap (vb)
quapta- (Possession and Trade)|to exchange (vb)
quaptale|exchange (n)
quapta|deal, bargain (n)
quaqua-|to quack, squawk, cackle (vb)
quarca|perverse, naughty (adj)
quasa-|to shake, flap, nod, rustle (intr.) (vb)
quasilla|tuft, nodding spray, tassel, plume (n)
quasil|arrow, arrow-feather (n)
quea-|*our; 1st pl. inclusive possessive (pref)
quele-|to perish; to fade (vb)
quelecte|carcase (n)
queletya-|to perish (vb)
quelexie|rot, corruption (n)
quelexima|corrupt, rotten (adj)
quelme|ruin, utter end, perdition, end, death (n)
quelmo|we (emphatic); 1st pl. inclusive pronoun (pron)
quelqua; querca|throat (n)
quelu-|to well up (vb)
quelume|source, origin (n)
queluva|original (adj)
quelu|well, spring, source (n)
quent; quetta|word (n)
quentea|verbal (adj)
quentele|sentence; wording, expression, phrase (n)
quentima|*tale (n)
quet-|to speak, talk (vb)
quetl|speech, talk (n)
quets(im)a|having speech, able to talk, good at expression, glib (adj)
que|any; we (inclusive) (pron)
quie|calm at sea (adj)
quildare|bat (n)
quilda|quiet, hushed, still (adj)
quilde; quille|quiet, rest, hush (n)
quildi-|to rest, stay quiet, be quiet (vb)
quilea|coloured, -hued (adj)
quile|hue, colour (n)
quilinoite|broidered (adj)
quilin|adorned, bright-coloured, embroidered (adj)
quille; quillinin (qilli-)|blue-bell (n)
quiltasse|(em)broidery (n)
quilta|belt, girdle (n)
quilti-|to gird, encircle (vb)
quilya-|to adorn, embellish, colour (vb)
quim(en)ea|womanly, feminine (adj)
quimelle|little woman (n)
quimenoite; quimíte (qimenoitsi-)|feminine, female (adj)
quin (qim-)|woman, female (n)
quinde; quinne|womanliness, femininity; (concr.) women as a whole (n)
quindelis; quindestin|nun (n)
quindesta|convent (n)
quindl|a spindle, top (n)
quinga|bow (n)
quingi-|to twang, thrum (of strings, harps, etc.) (vb)
quinqua|drooping, languid (adj)
quinquelea|languorous (adj)
quinquele|languor (n)
quinquenna|Solomon’s-seal (n)
quinque|this (n)
quint (qinty-)|loop, stitch in knitting (n)
quintl|lyre (n)
quinya|female (adj)
quiqui-|to hang, droop (vb)
quiquilla|Lily of the Valley (n)
quiri- (Spatial Relations)|to murmur (vb)
quiri-; quirna- (Clothing and Adornment)|to stir (make spin) (vb)
quirin|wheel (n)
quirme|cream (n)
quirquirinda|murmuring (adj)
quirquirinde|murmuring (n)
quirquisi-; quisquiri-|to rustle, murmur (vb)
quisi-|to whisper (vb)
quitima|for knitting (adj)
quitin|knitted, joined tight (adj)
quity-|to knit (vb)
quolda; quolina|ill (adj)
quolima|sickly, ailing (adj)
quolimo|invalid (n)
quolo-|to ail (vb)
quolu|disease (n)
quolúva|pestilent, pestilential (adj)
quolúvie|pestilence (n)
quonda|choking smog, smoke (n)
quorin|drowned, choked, speechless (adj)
quoro-|to choke, suffocate, (esp.) drown (vb)
quosta-|to choke, drown (trans.) (vb)
quoto-|to count up, reckon; to account, call up; to think, consider (vb)
quotta|sum, number, account, total (n)
quámea|sick (adj)
quáme|sickness, nausea (n)
quára|watch, ward (n)
quárele|watchfulness, anxiety (n)
quá|duck (n)
químar|phantom (n)
quínea|squeaking (adj)
quíne|squeaking (n)
quíni-|to speak high, squeak (vb)
quíva|awake (adj)
quívie|awakening (n)
racta- (Physical Acts and Materials)|to stretch out, reach (vb)
racta-; soracta- (Spatial Relations)|to pile, hoard, amass, collect (vb)
racta; ranco; rá|arm (n)
racte|pile, heap (n)
rama-|to shout, sound loud, bray, blare (vb)
ramba-|to walk (vb)
rambe; ranwe (Language and Music)|shout, blare (n)
rambe; rauna (Warfare and Hunting)|prey, booty (n)
ran (ram-)|noise (n)
ranca; rusta|broken (adj)
randa|bark; peel, rind, outer ring, circumference (n)
ranta (Motion and Transportation)|arch, bridge (n)
ranta (Spatial Relations)|part (n)
rara-|to scrape, peel, strip (vb)
rasta|file, scraper (n)
rato|soon (adv)
rau (ráv-)|lion (n)
rauca|swift (adj)
rauce|demon (n)
rauci|fiend (n)
rauco|ravening, rushing (adj)
raume|running, course (n)
rausima|*hunted (adj)
rausime|vermin (n)
raustea|of prey (adj)
rauste|hunting, preying, the hunt (n)
rauta-|to chase, hunt, pursue; to extirpate, exterminate; to steal (vb)
rava-|to run, chase (vb)
ravenne|she-lion (n)
ravin|fierce, savage (of beasts) (adj)
recca|spittle (n)
renda|related, of the same kin or clan (adj)
rendi|*kinship, kin, kindred, clan (n)
rendo; réro|kinsman, cousin (n)
rent (renty-)|spittle, saliva (n)
resse|kinswoman, cousin (n)
resta-|to aid, come to aid of, rescue, save (vb)
resta|support; kinship, kin, kindred, clan (n)
retima|despicable, contemptible (adj)
rim-|to border on, lie at edge, neighbour (vb)
rimbe|edge, lip, brim (n)
rimbi; rimni|around, all around (adv)
rimp(in)a|striped (adj)
rimpe (rimpi-)|stripe, strip (n)
rimu|outskirts (n)
rin (rind-)|year, circle (n)
rincalenda|anniversary (n)
rinci|orbed (adj)
rinco|disc, orb, circle (n)
rincu|orb of Moon (n)
ringa|cold, damp, chilly (adj)
ringwe|rime, frost; cold (n)
rinqua|round, circular; revolving returning, recurrent (adj)
ripta-|to cut in strips, tear up; to stripe, mark in parallel lines; to flay, flog (vb)
riqui-|to wrench, twist (vb)
rista-|to plant (vb)
ristale|sowing time (n)
ristar|sower (n)
rista|shoot (sowing), plant, seedling (n)
roa|wild beast (n)
ronda|cavern (n)
ronta; rotwa|hollow (adj)
rosta-|*to rise (vb)
rotl|cave, hollow, grot (n)
rotse|pipe, tube (n)
ro|*on (prep)
rua; rúva|steady, still, tranquil (adj)
ructa-|to belch smoke, spout smoke; to cause to smoke; to smoke at a pipe (vb)
rucu-|to steam, smoke, reek (vb)
rucu|smoke, reek (n)
rue|rest, stillness, remaining, steadfastness (n)
ruin|peace (n)
rungwa|stiff, solid (adj)
rámaite; vilda|winged (adj)
rámandea|long-wing(ed) (adj)
rámavoite|winged, having wings (adj)
ráma|wing; arm (n)
ráqua|rough (adj)
ríma|line of seeds planted, row, series, furrow (n)
rímenoite|neighboring, bordering (adj)
rímen|border, shore (n)
rína|scattered, sown (adj suf)
rípe|line, margin, bank of stream, edging of grass, border (n)
rísimande|passim (adv)
rísima|scattered, ubiquitous, universal (adj)
róma|upward path, mountain side, (mountain) slope, alp (n)
róna-|to arise, rise, ascend (vb)
róta|tube, hollow cylinder (n)
rú (Emotion)|steadfastness, faith, trustiness (n)
rú (Social Relations)|dwelling, village, hamlet (n)
rúse (rúsi-)|weary (adj)
rúvina|burst (adj)
rúya|unmoved, steadfast (adj)
sa; ta|that (there) (pron)
saca-|to pursue, look for, search (vb)
sahta- (Physical Acts and Materials)|to split (vb)
sahta- (Sense Perception)|it is hot (vb)
saice; saiste (saiki-)|hunger (n)
saicelea|famished (adj)
saicele|famine (n)
saicelta-; saitya-|to starve (vb)
saina|smooth (adj)
saipo|boot (n)
saiqua; saisa|hungry (adj)
sairina|magic (adj)
sairu|magical (adj)
saita-|to be hungry (impersonal) (vb)
saiwa-|?to be hot (vb)
saiwali|summer (n)
saiwa|hot (adj)
sal-|?to remain or remove (vb)
sala-; salta-|to sail (vb)
salamba|twanging, throbbing, resounding, echoing (adj)
salambe|twanging echo (n)
salaquintl; salaquíne|violin, (lit.) thrumsqueak-er (n)
salca|scythe (n)
salce; salci|grass (n)
salistina|blessed (adj)
salma|lyre, small harp (n)
salme|harp-playing, music of lyres (n)
salpa-|to take a sup of, sample, sip (vb)
salpa; tolpo|bowl (n)
salque|grass, long mowing grass (n)
salquin|viola (n)
salumbe|harping, music (n)
sambe (samb-)|room, chamber (n)
samin (samind-)|silk (n)
saminda; saminwa|silken (adj)
sampa|spade (n)
sampe; sampo|cave, hollow (n)
san (samb-)|hall, dwelling, house (n)
sana|day (24 hours) (n)
sanca (Emotion)|hate, fierce hatred (n)
sanca (Physical Acts and Materials)|rend, jab (n)
sance|hateful (adj)
sanda; tanya|that (adj)
sanga- (Physical Acts and Materials)|to pack tight, compress, press; to gather (vb)
sanga-; sangya- (Physical World)|to scorch (vb)
sanga|throng, tight mass, crowd (n)
sangwa|tight, thick, dense, tough, hard (adj)
santo|that (pron)
san|then, at that time (conj adv)
sapsa; sapta|pit, grave (n)
saquila|fire-red, scarlet (adj)
sar-; tecta-|to write (vb)
sara-|to saw (vb)
saramór|*writing-ink (n)
sarapenda|wood-bridge (n)
sarat (sarakt-)|plank (n)
saratwa|made of planks (adj)
sarco (sarku-)|flesh, living flesh, body (n)
sarco|elder [tree] (n)
sarcuva|corporeal, bodily (adj)
sarma|saw (n)
sarqua|fleshy (adj)
sar|earth, soil (n)
sastya|sore, galled (adj)
sat; tunda (sapt-)|hole (n)
satl|search, enquiry (n)
satta; uivi|both (adj)
satto|both; the two (adj)
satwa|hollow, dug-out, excavated (adj)
saule|litter (of pups, cubs, etc.) (n)
saune|bath, small pool (n)
sausa|bath water, hot water (n)
savarda; savarna|pack (of dogs, wolves) (n)
savar|wild dog, jackal (n)
saya-|to be hungry (vb)
se; sen|as, like, in manner of (prep)
sehta-; véla|to see (vb)
sehte (sehti-)|pupil; bead; †eye, eyeball (n)
selca|bright (adj)
senda|like, something like, similar (adj)
senge|keen of sight, observant, sagacious (adj)
senna|red, brown, red-brown (adj)
serin (serind-)|wreath, crown (n)
serindo|crown (n)
serma|string, cord (n)
serta-|to tie (vb)
sestaine|assimilation, imitation, etc. (n)
sestima|comparable (adj)
sie|sight, sense of sight, eyesight; pupil of eye (n)
sihta|moist, wet (adj)
silaina; silína|shimmering (adj)
silc(in)a|rich, fat, glossy (adj)
silcesse|harvest (n)
silci-|to mow, scythe, mow down (vb)
silcima|ready for cutting (adj)
sild(r)a|slender (adj)
sildapinque|tapering (adj)
silda|gleaming (adj)
silde; sui|daughter (n)
sile|glint (of white) (n)
sili-|to gleam, glint (vb)
silic (siliq-)|flint (n)
siliqu(in)a|flinty (adj)
silma|ray of moonlight (n)
silmea|*of the moon (adj)
silmerána|gleaming moon, silver moon (n)
silme|gleaming, silver (adj)
silquelossea|with hair like white flowers (adj)
silqueléna|having tresses (adj)
silqueléni|silver birch, (lit.) long tresses (n)
silque|tress of hair; (glossy) hair (n)
silt-|to sift, sort out, winnow (vb)
silta|sieve (n)
silte-|to filter (of light), flicker (vb)
siltina|winnowed (adj)
silwin (silwind-)|birch (n)
simp(in)a|pipe, flute, flageolet (n)
simpeta-|*to pipe (vb)
simpetar|piper (n)
simpise|piping, whistling (n)
sinc (sinq-)|mineral, gem, metal (n)
sindi|river (n)
sine|pale (bluish) green (n adj)
singe; singwe (singi-)|salt (n)
singwa|salt (adj)
sinque??|sparkle as with gems (adj)
sinquele|mine (n)
sinquevoite|gemmed (adj)
sinque|jewel, gem (n)
sinquina|metallic (adj)
sint (sinty-)|a gleam, spark, glister, drop of dew, etc. (n)
sinte (sinti-)|esteem; estimate, computation (n)
sintilis (sintiliss-)|sparkling as of crystal (n)
sintl|crystal (n)
sinty-|to sparkle (vb)
sipi-|to pipe (vb)
siqui-|to sigh (vb)
siquile|sighing, lament (n)
siquilisse|weeping willow; lamentation (n)
siri-|flow (vb)
siripta|slender stem (n)
sirpe|stem, stalk, slender tube, etc. (n)
sisi-|to scorch, singe, fry (vb)
sisin|parched, scorched (adj)
sist(e) (sisty-)|ulcer, sore, boil (n)
sistina|ulcerated, sore (adj)
sito (situ-)|custom, habit (n)
sitsina|habitual, customary, accustomed, usual, ordinary, common (adj)
sitta-|I am used to, I do habitually (vb)
situ-|to be accustomed [to] (vb)
si|they; 3rd pl. fem. pronoun (pron)
so-|grouped, together (pref)
soc-; soco-; soqu-|to drink (vb)
socto-|to give to drink, drench (vb)
soile|cleansing (n)
soleste|collection (n)
solme|wave (n)
solor (solos-)|surf, surge; wavebreak, coast (n)
solosse|surf, surge (n)
solto-|to wave, heave, surge (up and down) (vb)
sonda|seat, chair (n)
sor(ne); soron (Animals)|eagle (n)
soraxa|shingle (n)
soresta|family (n)
sorin (sorind-)|throne (n)
sornion|eyrie (n)
soro-|to sit (vb)
soron (Physical World)|pinnacle, high peak, crag (n)
sorta-|to sit down (vb)
sorto-|to set, settle (vb)
sovalle; sovasta|washing, bathing (n)
sovallu-; sovalna-|to cleanse, purify (vb)
sovalwa|cleansing (adj)
soveasse|resemblance; likelihood (n)
sovea|alike (adj)
sucte (suksi-)|resin, gum (n)
suiva|soughing, moaning (adj)
sulca|sticky, viscous (adj)
sulmin|base of a pillar, base of column (n)
sulp-|to lick, sup, lick up, sup up; to sip, taste; to drink (vb)
sulpa|soup (n)
sult (sulp-)|sip, taste (n)
sulta-|to support (vb)
suni|bitch, *female dog (n)
sunqua|going down, descending; abysmal, deep, profound (adj)
sunquelaina|falling, fading, setting (adj)
sunquelaine|sunset (n)
sunquelea|westering, setting (adj)
sunquele|sinking, falling, setting of heavenly bodies (n)
sunque|going-down, descent, down-fall; abyss, depth (n)
suqu-|to fall, fail, go down, die down (vb)
sura|a clan (n)
surus; súru|air-spirit; wind, gale (n)
susúlima|full of wind, windy, airy (adj)
sutl|sticky matter, slime, gum (n)
sutya-|to sweeten, soothe (vb)
suxina|resinous (adj)
sá; tan(y)a; uru|fire (n)
sár(e)a|fiery (adj)
sé|eye, eyeball, pupil (n)
síre|stream (n)
sírima|liquid, flowing (adj)
síse; síte|they (emphatic); 3rd sg. fem. pronoun (pron)
síva|*their; 3rd pl. fem. possessive emphatic (adj)
sóla|tide (n)
sóma|state, condition (n)
sóra (adj)|long, trailing (adj)
sóra (cardinal)|million; (vaguely) a very great number (cardinal)
sóra (n)|seat (n)
súce|resinous trees, pine or fir (n)
súle|column, pillar (n)
súlime; vanwe; vá|wind (n)
súne|(human) nose (n)
súye|air, breezes, winds (n)
súyon|nephew, daughter’s son (n)
sú|(noise of) wind (n)
ta (prep)|on, above; by, beside; than (prep)
ta (pron)|they; 3rd pl. neut. pronoun (pron)
ta-; tea-|*their; 3rd pl. neut. possessive (pref)
tac-; taca-|to fix, fasten (vb)
tahorme; taorme|mountain (n)
taila|(axe) blade (n)
taime; taimie; tea|sky (n)
taina; tea; tína|straight (adj)
taitelúme|firmament (n)
taiva; táva|*their; 3rd pl. neut. possessive emphatic (adj)
tal-|to end (n)
tala(no)ite|footed (adj)
tala-|to carry, bring; to weigh (intr.) (vb)
tala; tál (Body Parts and Functions)|foot; bottom, lowest part (n)
tala; velu; velunte (Motion and Transportation)|sail (n)
talacúme|huge burden, pile (n)
talan (taland-)|burden (n)
talanda; talanya|burdened, weighed down, sad (adj)
talante|scales (n)
talar (talard-)|beast of burden (n)
talas (talast-)|sole (n)
talat|dry land (n)
talca; tongar|smith (n)
talcu-|to glaze (vb)
talda|covered (adj)
talma|end; weight, measure (n)
talme|weight (abst.) (n)
talpa|support, prop, base, basis, pediment (column) (n)
talque (talqi-)|glass (n)
talquea|glassy (adj)
talquina|made of glass (adj)
talta-|to lade, burden, load charge; to enjoin; to oppress, weigh down (vb)
talta|shaky, wobbling, tottering; sloping, slanting (adj)
tamarin; tamuril|yew (n)
tambe (tambi-)|copper, bronze (n)
tambin (tambind-)|cauldron (n)
tambina|of copper (adj)
tamilla; tamin|forge (n)
tampo|well (n)
tanca (adj)|firm, fixed, fast; steady, (stead)fast (adj)
tanca (n)|fastening, rivet (n)
tanco|firmly (adv)
tanda (adj)|*that (adj)
tanda (n)|hedge, fence, enclosure; border, rim (n)
tande|thither (adv)
tange (tangi-)|close, near (adj)
tange|close to, by (adv)
tanta(ra)|bouncing, resilient (adj)
tanta-|to bounce, bound, rebound; to dance (tr.), dandle, wave (vb)
tanta|number (n)
tantl|shuttle (n)
tantya-|to set bouncing (vb)
tapa-|to taper, stretch out (intr.), extend thin (vb)
tapatenda mavoisi|Spanish [chestnut] (n)
tapatenda|taper fingered, light fingered, long fingered (adj)
taqua-|to build, fashion, construct, make (vb)
tar (tár-)|hedge, fence (n)
tara-|to cross, go athwart, cross rivers (vb)
tarambo; taran (taramb-)|bang, buffet (n)
tarcele|great system of roots (n)
tarna|passage, ford, crossing (n)
tarqu-|*to dry, preserve; to pickle (vb)
tarqua-|to dry, preserve; to pickle (vb)
tarquin(a)|salted, dried; salt meat (n adj)
tarucca|horned (adj)
tarucco|bull, ox (n)
tarucu; yac(c)o|ox (n)
tarunco|bull (n)
taru|horn (n)
tarva; tarwa (adj)|tired (adj)
tarva; tarwa (n)|garden, enclosure (n)
tarwesta-|to crucify (vb)
tarwe|cross, crucifix (n)
tas; taxe (taks-)|nail (n)
tasinwa|numbered (adj)
tasta-|to reckon (vb)
taste|fringe (n)
tatya-|to feel for (like tentacles etc.) (vb)
taule (Agriculture and Vegetation)|great tree (n)
taule (Physical Acts and Materials)|pillar (n)
tauma|basis, foundation, ground floor (n)
tauno|(great) forest (n)
tavar (tavarn-)|dale-sprite, fay of the woods; forest (n)
tavas; tavasta (tavast-)|woodland (n)
tayorme|mountain peak (n)
tayóra|*lofty (adj)
tecca; tecte|book (n)
tece-|to mark; to write on, write (vb)
tecet; tecetta (tekett-)|letter (n)
tectamaqua|having a good ‘hand’ (adj)
tectar|writer (n)
tectele|art of writing, script; writings, documents, papers, scriptures (n)
tel (teld-)|roof (n)
telar|brick, tile (n)
telco|stem (n)
telda|having a roof (adj)
telea|*roofed (adj)
telella; telerea|elfin (adj)
telempe; telque|silver (n)
telepta|*silver (adj)
teleste (telesti-)|(f.) little elf (n)
telesto (telestu-)|(m.) little elf (n)
telimbo|canopy; sky (n)
telin (telimb-)|roof, covering (n)
telintule (telintuli-)|bearing a roof, roofed (adj)
telpe (telpi-)|silver; money (n)
telpea; telpia|silvern (adj)
telpilin|silver piece (n)
telpina|of silver (adj)
telpingwe|silverfish (n)
teltasse|awning (n)
telu-|to finish, end, close, complete; to cover, roof (vb)
telumen|finish, conclusion (n)
telume|the heavens, (vault of) heaven, firmament (n)
telusta|outer, extreme, ultimate (adj)
teluste (telusti-)|extremity (n)
telu|end (fate), close (n)
telwa|last, late (adj)
telyanta-|to allure (vb)
telyantalya|alluring (adj)
telyantasse|allurement (n)
telya|attractive; importunate (adj)
telúmea|final, conclusive, end; last; extreme (adj)
telúme|finish, conclusion, (the great) end (n)
tempe|hate (n)
ten-; tunqu-; unqu-|to hear (vb)
tende (tendi-)|sense of touch, sense, sensation, feeling (n)
tendilea|feeling; sentimental (adj)
tendile|feeling, sentiment (n)
tendl|string (n)
teng-|to think (vb)
tenge-|to know, understand, grasp, think (vb)
tengenwa|wise, knowing, understanding; sensible (adj)
tengwe; tingwe|knowledge, understanding; idea, notion, thought (n)
tengwele|sense (n)
tengwet(ta)|idea, notion (n)
tentima|sensitive (adj)
tentl|a feeler (n)
tenya-|to feel, touch (vb)
ter-|*to pierce (vb)
terendl|lathe (n)
terenwa|shapely, well tuned (adj)
teren|lissom, lithe (adj)
teret (terekt-)|auger, borer, gimlet (n)
tereva|sharp, piercing, shrill; acute (pain) (adj)
tessara|maiden, maidenly (adj)
tessare (tessari-)|little maid (n)
tessa|maid, maiden (n)
teste|small worm (n)
tet (tekt-)|spot, mark (n)
teta-|to attract (physical and figurative) (vb)
tetl|small flower (n)
tetse|bud (n)
tetta|baby (n)
tettele|burgeoning, efflorescence (n)
teve-|to hate, dislike (vb)
tevin|hated (adj)
texe|attraction (n)
tie|line, direction, route, road, path (n)
til; tila (tiln-)|(single) hair (n)
tilde|point, tip, peak (n)
tildi-; tump-|to cover (vb)
tile|single hair (n)
tilinya|downy, hairy (adj)
tille|eyelash (n)
tilt-|to make slope, incline (tr.), decline, shake at foundations, make totter (vb)
tilta; tiltin|slanting (adj)
tilu-|to shine (blue) (vb)
tilwe|glimmer (n)
tilwindea; tilwínea|shining (adj)
tilwin|shining light, bright light (n)
timbare|forehead (n)
timpa|spray, nozzle of hose (n)
timpe|fine rain (n)
timpina|fine, powdered, sprayed (adj)
timpinen (timpinend-)|fluter (n)
timpine|spray (n)
timpínea|made of spray, full of fine showers, showery (of weather) (adj)
tinda|spike (n)
tinde (tindi-)|spiked, pointed, barbed (adj)
tini-|to gleam, shine as a star (vb)
tintele|sparkling, twinkling (as of frosty stars) (n)
tintya-|to sparkle, etc. (vb)
tint|(silver) spark (n)
tinwe; íle|star (n)
tiqu-|*to melt, thaw (vb)
tiqui-|to melt, thaw (vb)
tiquile|melting, thawing, thaw (n)
tiquilin (tiqilind-)|thaw, melting snow, slush (n)
tiquilindea|thawing, slushy (adj)
tiri-|to watch; to keep, guard, preserve; to look at, gaze at, observe (vb)
tirin (tirind-)|tall tower, turret, minaret (n)
tirinwa|vigilant (adj)
tirion (tiriond-)|(great or mighty) tower; city on a hill (n)
tirios (tiriost-)|town or city with walls and towers, burg (n)
tiriosta|city with walls and towers (n)
tiris; tirisse (tiriss-)|watch, vigil, ward (n)
tirne|steadfast regard, stare (n)
tirt (tirty-)|part, portion, share, section (n)
tirtina|divided, shared, distributed (adj)
tirty-|to partition, divide, part, distribute (vb)
titinwe|small star, a sparkle of dew (n)
titte|breast, teat (n)
tiuca|dense, solid (adj)
tiura|*compact (adj)
tiure (tiuri-)|compact (adj)
tiusima|comforting, consoling, easing (adj)
tiuta-|to strengthen; to corroborate, confirm; to comfort, console (vb)
tiutale; tíwele|strengthening, reinforcement; confirmation; comfort, consolation, easement (n)
toco-|to feel with the hand, handle; to appraise, tax, assess, assay; to try, test, essay, endeavour (vb)
tocot|cock (n)
tol (toll-)|island, isle (n)
tol(to)cainen|eighty (cardinal)
tolda|hill (with a flat top), hill top; town on a hill (n)
tolipin (tolipind-)|mannikin (n)
tolipince|little doll (n)
toli|doll, puppet (n)
tolla|hill top (n)
tolle; tolome|island (n)
tolma|helm (n)
tolmen|boss (of shield), isolated round hill (n)
toloime|sling (n)
toloise|rounded, cylindrical (adj)
tolos (toloss-)|knob, lump (n)
tolot (tolokt-)|pebble, cobble-stone (n)
tolto; umna|eight (cardinal)
toltost(y)a; toltosto|one eighth (fraction)
tolu-|to roll up, furl (vb)
tolupe (tolupi-)|roll, ball of wool (n)
tolya|eighth (ordinal)
tombo|gong (n)
tompa|small drum (n)
tompo-tompo|noise of drums (or guns) (n)
tompo-|to bang (vb)
tonga|great hammer (n)
tongwa; yeremba; yerenwa|like iron (adj)
tontilla|cymbal (n)
tontl|cymbal, tambourine (n)
toquo-|to yield, give, bear, bring forth (vb)
torina|baked, done (adj)
torma; urna|oven (n)
torme|mountain (peak) (n)
toro-|to bake (vb)
torqua|blazing hot (adj)
torquele|tropic heat (n)
torwa|baked, dark brown (adj)
tuacca|battle axe (n)
tub-; tum-|to dive (vb)
tuctalla|*search (n)
tucu-|to go in search of, look for, fetch (vb)
tuilenda|spring-like; fresh, sprouting, green (adj)
tuile|spring, (lit.) a budding; buds, new shoots, fresh green (n)
tuilindo|swallow, (lit.) spring-singer (n)
tuista|spray, twig, sprout, shoot (n)
tuita-|to bud, burst, burgeon, grow (vb)
tuiva; túva|*their; 3rd pl. masc. possessive emphatic (adj)
tul-|to bring, come (vb)
tulalca|able to bring (adj)
tulca-|to fix, stick in, set up, establish (vb)
tulca; turca|strong (adj)
tulinya|(bringable) worth bringing (adj)
tulma|bier, tray (n)
tulpie|supporting, toleration (n)
tulpo|buttress, prop (n)
tulpu-|to uphold, support; to aid; to endure, tolerate; to bear (with); to prop (vb)
tult (tulp-)|leg of chair, etc. (n)
tulu-|to bring, carry, fetch; to move (intr.), come; to produce, bear fruit (vb)
tulunca|steady, firm (adj)
tulwe|tall thin pillar, standard, pole; banner (n)
tulya-|to send, bring (vb)
tumbe|trumpet, (large) horn (n)
tumbo|dale, vale (n)
tumna|deep, profound, dark or hidden (adj)
tump-|to build; to beat (vb)
tumpo|shed, barn (n)
tunce (tunki-)|bright, witty, smart (adj)
tunda-; turu-|to kindle (vb)
tundo|firewood, fuel (n)
tunga|thick, dense (adj)
tunqua|able to hear (adj)
tunquele; unquie|hearing (n)
tunta-|to see, notice, perceive (vb)
tunto|notice, regard, perception; quickness of perception, wit (n)
tupin|roofed, having a lid, having hat on (adj)
tupu-|to roof, put lid on, put hat on, cover (vb)
tur; túranu; vardar (tûr-)|king (n)
turanion; turillo; túrion; vardo|prince (n)
turanwen; turille; turwen|princess (n)
turinda; turinoite|royal, of the ruling dynasty; in power (adj)
turindo; túrion (tūriond-)|palace (n)
turinqui; turquin; túrani; varni|queen (n)
turinquia|royal, Queenly (adj)
turinwa|kingly, royal (adj)
turinya-|to rule over, reign over (vb)
turquima|haughty (adj)
turu-|can, to be able (vb)
turuvoite|rich in timber (adj)
turuxa; turúva|wooden (adj)
turu|wood (as material), (orig.) firewood (n)
turwa; valma|powerful (adj)
turya-|to catch fire (vb)
tustima|inflammable (adj)
tusture|tinder, chips, firewood (n)
tusturin (tusturind-)|match (n)
tuvu-|to receive, accept, take, require, cost (vb)
tuxa lempea; tuxa pínea|hundred (n)
tuxallume|*hundred times (adv)
tuxanto; tuxantya; tuxatto; tuxatya|one hundredth (fraction)
tuxanya|hundredth (ordinal)
tuxa|gross, 144; hundred (cardinal)
tu|he; they; 3rd pl. masc. pronoun (pron)
tya-|*your; 2nd sg. possessive (pref)
tyac-|to stick (vb)
tyacta-|hew (vb)
tyalien (tyaliend-)|sport, play; jest, mockery (n)
tyalie|play, game (n)
tyalu-|to play (vb)
tyasa-|to test, try, pick, choose (vb)
tyasta-|to put to the test (vb)
tyastava-|to taste (at) (vb)
tyausta|savour, flavour (n)
tyav-|*to taste (vb)
tyava-|to taste; (impersonal) to taste of, reminds one of (vb)
tyavasta|sense of taste (n)
tyenda|that (of yours) (adj)
tyent(y)e|that (of yours) (n)
tyetl|babe, a tiny baby (n)
tyetse|teat (n)
tye|you (pron)
tyos (tyoss-)|cough (n)
tyosto-|to cough (vb)
tyucta-; tyucu-|to chew (vb)
tyulin|tall (adj)
tyulma; tyulme|mast (n)
tyulta-|to rear up, stick up (vb)
tyulusse|poplar (n)
tyur; tyurme (tyurd-)|cheese (n)
tyurda|curdled (adj)
tyuru-|to ‘turn’ milk, curdle (blood etc.) (vb)
tyus; tyúca (n)|cud (n)
tyustyucta-|to chew the cud; to reflect, reminisce (vb)
tyá|now (adv)
tyé|tea (n)
tyú(ta)|thigh (n)
tyúca (adj)|thick (adj)
tyúma|lump, mass (n)
tyúre (tyúri-)|stout, dense, compact (adj)
tyúte (tyúsi-)|thumb (n)
tá (adj adv)|high; high above, high up (adj adv)
tá (interj)|hush, be silent (interj)
tále|axe-blade (n)
táqua|form, shape (n)
tára|lofty, high, tall (adj)
tárie|height (n)
tári|queen, mistress, lady (n)
táta|hat (n)
tévie|hatred, dislike (n)
tócele|handling (n)
tóle; tólea|central, middle (adj)
túlima|(worth bringing) bringable, able to be brought (adj)
túma|moving (adj)
túpele|roofing, tiles, roof (n)
túpo|roof, cover, lid (n)
túrea|mighty (adj)
túre|might, strength, power (n)
túrin|king(dom) (n)
túto|they (emphatic); 3rd sg. masc. pronoun (pron)
túvima|acceptable (adj)
ua|the sea (n)
ue|fleece (n)
uindea; vindea|fishlike (adj)
ui|*two (adj)
ul-|negative prefix; mis- (pref)
ulban (ulband-)|monster, giant (n)
ulcarma|misdeed (n)
ulca|evil; bad, wicked, wrong (adj)
ulcu|wolf (n)
ulma|flagon (n)
ulme|a kind of wine (n)
ulmula|mumbling (adj)
ulqu-|*to rend (vb)
ulqua|evil (adj)
ulqui|she-wolf (n)
ulto-|to pour (tr.) (vb)
ulu-|to pour, gush (intr.) (vb)
ulumpingwe|caterpillar (n)
uluntilla|camel’s hair (n)
uluswe; ulwe|alder tree (n)
uluswea; ulwea|alder-grown (adj)
ulwe nornelassea|oakleaved alder (n)
ulwenoite|alderlike (adj)
ulwesse|alder-thicket (n)
um-|to be not, do not (vb)
unc(o) (unq-)|ear (of animals); corner, sticking out edge (n)
unqu-|to hook into, catch (fish), catch in, etc. (vb)
unquilla(r)|handle of jar; pothook (n)
uqu-|to rain (vb)
uquis; úquil|rain (n)
uruvoite|fiery, having fire (adj)
urwa|on fire, afire (adj)
urya-|to burn (intr.) (vb)
urúva|like fire (adj)
usque|fog (n)
usu-|to escape, get out (vb)
uswe|escape, issue, outlet (n)
va-|together (pref)
vacco|jacket, coat (n)
vactelear|merchant (n)
vactele|trade (n)
vaile|covering, *sheath (n)
vaimata-|to robe (vb)
vaima|wrap, robe (n)
vaina|clad (adj)
vaine (vaino-)|sheath, pod (n)
vainole|quiver (n)
vaita-|to wrap (vb)
vaite|skied (adj)
vaiwe; vaiya|seamew (n)
vaiya (Physical World)|sky, skies (n)
val (vald-)|good fortune, blessedness, happiness (n)
val(i)na|brown (adj)
valca (Emotion)|cruel, bitter (adj)
valcane|vague (adj)
valca|*vague (adj)
valce (valki-)|edge, sharp blade (n)
valcea|cutting, sharp (adj)
valda|worth; worthy, dear (n adj)
valdea|of moment, important (adj)
valiemba|tropical (adj)
valima; valin (valim-)|happy (adj)
valmandui|heaven and hell (n)
valto|the luck of the Valar (n)
van (vand-)|way, path (n)
vana-|to pass, depart, vanish, go away (vb)
vanco; vat|wares (n)
vande|away, hence, forth (adv)
vandl; vanga|staff (n)
vane (vani-)|fair, lovely (adj)
vanesse; vanéni|beauty (n)
vanest(e)a|beauteous (adj)
vanima|proper, right, as it should be, fair (adj)
vanta|?beautiful (adj)
vanwa (adj)|gone, on the road, past, over, lost (adj)
vanwa (n)|great gale (n)
vanwavoite|windy (adj)
vanya|good (not evil), holy (adj)
vaqua-|vanquish (vb)
vaquasta|a victory (n)
vaqui(e)|victory (n)
vara-|to rub (vb)
varca-|to bode (impersonal); to dread, fear (vb)
varca|fear, dread (n)
varcima|dreadful (adj)
vard-|to rule, govern (vb)
varimo; varyanu|foreigner (n)
varitsi; varyani|foreigner (fem.) (n)
varivoite|foreign (adj)
varne (adj)|?brown (adj)
varne (n)|strangeness, estrangement (n)
varqua|in fear, afraid (adj)
varta|change (n)
vartyane|service (n)
vartyo; virt (virty-)|servant, slave (n)
varya|different (adj)
var|or (conj)
varúse|*in other manner [than] (adv)
vasa-|to rush (of both noise and speed, tr.) (vb)
vasca|making a plash or rush (adj)
vassale|rustling (n)
vassivaswe|beating or rushing of wings (n)
vasta- (Dwelling and Furniture)|to dwell (vb)
vasta- (Time)|to rush (of both noise and speed, intr.) (vb)
vasta|road (n)
vaxe|sale (n)
va|from; with (prep)
vea (adj)|similar, like (adj)
vea (n)|sea (n)
veacirya|sea-ship (n)
vealta-|to resemble (vb)
veasta; vícele|resemblance, comparison (n)
velba|boiling, bubbling (adj)
velbe|bubble (n)
velca|flame (n)
vele-|to boil, bubble (vb)
velet (welekt-)|boil, tumor (n)
velice (veliki-)|great, large (adj)
velitya-|to magnify (vb)
velixe|greatly (adv)
velme; velwe|spring (n)
velu-|to unfurl (vb)
velupantie|revelation (n)
vembe; vembil|worm (n)
ven(di)|maid, girl, maiden (n)
vena; venin; venya|womanl[y] (adj)
venda|brook (n)
vendele|maidenhood (n)
vende|maiden (n)
vene|small boat, vessel, dish (n)
venga|*male (adj)
venie; venwe|shape, cut (n)
veniel|mariner (n)
venta-|to cut, shape (vb)
venta|chin (n)
vente|brook, small river (n)
verelin (werelind-)|whirligig (n)
verelinda|twirling, pirouetting (adj)
vereven(da) (werevend-)|winding rill (n)
verin (verind-)|married (adj)
veringwi|husband and wife, married pair (n)
veru; veruner|husband (n)
vesta-|to wed, marry, join others in marriage; (refl.) to get married (vb)
vestale|wedding (n)
vestaner|?(bride)groom (n)
vestani|*bride (n)
vestanoina|related by marriage (adj)
vestaquin|?bride (n)
vesta|state of marriage (n)
ve|as, like (prep)
via|male (adj)
vica|valiant (adj)
victe|gum (n)
vie (Body Parts and Functions)|teors, *penis (n)
vie (Mankind)|*man, male of the Elda (n)
vihta|*folk (n)
vil(de)|matter, business, affair, thing (n)
vil-; vili-|to sail, fly, float (vb)
vilcin|bitter, evil (adj)
vildi-|to matter; to be of significance, worth, moment (vb)
vildima|essential, imperative (adj)
vilina|airy, breezy, light (adj)
vilindea|as a bird (adj)
vilisse|spirit (n)
vilwarin (wilwarind-)|butterfly (n)
vilwarinda|butterflylike (adj)
vilya|(lower) air (n)
vimpele|a twinkling (n)
vinca|corner, nook (n)
vinda|woof (n)
vindele|loom (n)
vinge|(blowing) foam, spindrift, froth, scud, spray; wave (n)
vingil (wingild-)|(sea) nymph; (lit.) foam-maiden (n)
vintele|*twinkling (n)
vintil|a glint (n)
vinwe (winwi-)|a sparkling, flash (n)
vinwinoite|glittering (adj)
vinya-|to flash, glint (vb)
virti-|to serve (vb)
viste|weft (n)
vitevíse|*resin, gum, (lit.) sap-blood (n)
vixa|sticky (adj)
voine|desire, wish (n)
vor(o)|ever, always (adv)
vorima|everlasting (adj)
vorinquile|monotony (n)
vorne|an aeon (n)
vorocantele|harping, vain or monotonous repetition (n)
voronda|faithful (adj)
voruva|age long (adj)
vára|other (adj)
váro|*rather (adv)
vá|gone forth, away (adv adj)
vícana-|to compare (vb)
více|like (adj)
víle|gentle breeze (n)
vílyava|airy (adj)
vírin|glass substance [used to make the Moon] (n)
vóre (vóri-)|fur (n)
vóre (wóri-)|sweet (to taste only) (adj)
vórina|of fur (adj)
vóriva|like fur (adj)
ya(n)|and (conj)
yaim-; yaima-|to possess (vb)
yaima|implement (n)
yalle|a hollow ring (n)
yalta; yalte; yarta|yoke (n)
yama-|to shout, call (vb)
yambo|cheer, shout of triumph (n)
yanda|dark, gloomy (adj)
yando|also (adv)
yanta-|to add to, enlarge, increase, augment (vb)
yanta; úmea|large (adj)
yanta|joined (adj)
yantya-|to add to, augment (vb)
yanwa|goose (n)
yan|when (conj)
yara|a gloom, blight, lowering darkness (n)
yarendila|like a sailor (adj)
yarendilyon|sailor (n)
yaru|gloom, blight (n)
yat; yatta|neck; isthmus (n)
yausta|crop (n)
yava- (Agriculture and Vegetation)|to bear fruit (vb)
yava- (Possession and Trade)|to hold (vb)
yaxina|of steel (adj)
ya|relative pronoun (pron)
yel (yeld-)|cold, the cold (n)
yelma|(a bout of) frost; a cold; chill (n)
yelwa|cold (adj)
yenda; yendina|yesterday’s (adj)
yendo; yesta|glance, gaze (n)
yere(n)|pig iron (n)
yolme|stench, stink (n)
yolo-|to stink (vb)
yondo|son, male descendant, (great) grandson (n)
yucainellume|*twenty times (adv)
yucainen tuxa; yunquecainen|one hundred twenty (cardinal)
yucainento; yucainentya|one twentieth (fraction)
yucainenya|twentieth (ordinal)
yullume|twice, *two times (adv)
yulu-|to carry (vb)
yundóra|two million (cardinal)
yundóre|billion (cardinal)
yunga|twin (n)
yunquenya; yunquetya|twelfth (ordinal)
yunquetto|one twelfth (fraction)
yunque|twelve (cardinal)
yuro|a run, race (n)
yutuxa; yúyo tuxa|two hundred (cardinal)
yáma|shout; call; name (n)
yáme|yawning (adj)
yávan|harvest, autumn (n)
yáva|fruit, produce (n)
yéta-|to look at (vb)
yú-|ago (pref)
yúyo húmi|two thousand (cardinal)
yúyo yucainen|twenty two (cardinal)
yúyo|two (cardinal)
yú|twice (adv)
áma|mind, heart, thought (n)
ána|crown of head, top (n)
ára|dry sand, grit (n)
áye|hail (interj)
â|mind, inner thought (n)
íne|to-day (adv)
ó(vo)|mouth (n)
óleme|elbow (n)
óma|voice (n)
ómu|*although (adv)
órea|of the dawn, Eastern (adj)
óre|dawn, Sunrise, East (n)
ówen|merchild, mermaid (n)
ô|from (prep)
ú-; úv-|un- (pref)
úrin|(blazing) hot (adj)
úro|boar (n)
úsiéra|*escaped (adj)
úva|the under (adj)
úya-|is not (vb)
ú|beneath (prep)
