(be)bilfir|conscience (n)
(g)lairin|*poem (n)
(g)leg; aitheb; aithra; crisc|sharp (adj)
(g)leg; aitheb; aithra|piercing (adj)
(g)leg|keen (adj)
(m)ami|mummy (n)
(m)bara-; gwadh-; mara-; rûtha-|to dwell (vb)
(n)ada|daddy; father (n)
(n)adi; ada|daddy (n)
(n)adi; ador; bâb; nathon|father (n)
(n)gôl; macha; magru|slaughter (n)
-(a)vlid|less (suf)
-(i)ol; -(r)in; -r(i)ol; -ra; -thol; -wed|adjective suffix (suf)
-(i)on; -eg|adjectival suffix (suf)
-(n)ir|(feminine) agent (suf)
-(o)th; -eth; -ios; -ith; -os; -ri (Grammar)|abstract noun (suf)
-(r)il|feminine agent (suf)
-(r)on; -ir; -or|agental suffix (suf)
-(u)m|?indefinite suffix (suf)
-a; -n|genitive suffix (suf)
-bar|-ham; dweller; home (suf)
-chi|dim[inutive] suffix (suf)
-c|noun or adjective suffix (suf)
-drin; -glin; -grin|suffix in the name of languages (suf)
-gen|*earth (suf)
-i; -r|dative suffix (suf)
-iant(ha); -iont(ha)|*superlative (suf)
-iel|name suffix (suf)
-inci|diminutive superlative (suf)
-inthir|diminutive (suf)
-in|adjective ending; plural suffix (suf)
-iof|-bearing (suf)
-la|noun suffix; verbal suffix (suf)
-li; -od; -on; -st; -thi; -wen; -weth; -wi|noun suffix (suf)
-lim|many (suf)
-liont|*tendril (suf)
-loth|-grown (suf)
-odro(n); -oglo(n)|augmentative (suf)
-og|adjectival suffix; agental suffix (suf)
-onta|superlative (suf)
-os; -weg (Mankind)|masculine suffix (suf)
-ra; -sta|verb suffix (suf)
-rim|*many (suf)
-r|plural in verbs (suf)
-tha|noun or adjective suffix; verb suffix (suf)
-thi|*diminutive suffix (suf)
-thlib|-ly or -like (suf)
-thlim|folk; race (suf)
-thwi|fem. patronymic prefix (suf)
-th|plural suffix (suf)
-tt; -ui; -wi|dual (suf)
-uin|*noun suffix (suf)
-vran; -vron|dwelling (suf)
-wein; -wig; -win|*female suffix (suf)
-wen|*augmentative (suf)
Ban; ain (Religion and Beliefs)|god (n)
Ban|one of the Valar (n)
Cwedhrin; Cweneglin|*Elvish (Qenya) (n)
Cwenn|Elf (n)
Egla|(lit.) being from outside; fairy (n)
Gilim; Hess; folorin|winter (n)
Gold [ng-]; Goltha [ng-]; Gul [ng-]|Gnome (n)
Golda [ng-]|Gnome; wise one (n)
Goldogrin|Language of the Gnomes (n)
Goldrin|Gnome (adj)
Gwala|one of the gods (n)
Gwalion; Gwalon|male god (n)
Gwalir; Gwalthir|female god (n)
Rân|Moon (n)
Silma; Thilim|*Moon (n)
Sil|Moon; Rose of Silpion (n)
a(d); avin; bin; da|into (prep)
a(n); nan|of (prep)
a- (pref)|? (pref)
a- (pron)|3rd-person pronoun; it; they (pron)
a; mu; o; uf (Spatial Relations)|from (prep)
abair|victory (n)
abod|again; back; in exchange; in return (adv)
abont|back; backwards (adv)
acha; âch|waterfall (n)
ach|*excessively; too (adv)
adhin; dîn|formerly; long ago; once (up a time) (adv)
adhwen|approach; avenue (n)
adr(a)|lying athwart; situated on far side (adj)
adron|beyond; further; on other side; over (adv)
adros|crossing; ford (n)
adrum; odrum|hammer (n)
adr|across; athwart (prep adv)
agla; aglen; gwinc; tang|flash (n)
aglar(i)ol|glorious (adj)
aglar; aglath|glory (n)
agraith; agrech|contempt (n)
agra|excessive; extreme; vehement (adj)
agrectha-|to contemn; to despise (vb)
agrectharol|contemptible; despicable (adj)
agrecthion|despised (adj)
agros|excess; excessively; too (adv)
aibin; aibios|cherry (tree) (n)
aidha|nest (n)
aidlan; ain; aina; ainan; aindana; sinnai (Time)|today (n)
aidra-|to expiate (vb)
aidros|expiation (n)
aigli; bil|bird (n)
aigos; aiguis|pine-tree (n)
ail; ailion|lake; pool (n)
aina; ineg; inig (adj)|small (adj)
aindanathon|today (adj)
ainil|(female) god (n)
ainog|*(male) god (n)
ainos|(male) god (n)
ainuil|*(female) god (n)
air(in)|holy; sacred (adj)
aisc|bitter; sharp; sharp edge of a blade (adj n)
aista-|to revere (vb)
aistog; eirin; mani|holy (adj)
aistog|awful; revered (adj)
aist|awe; reverence (n)
ais|knowledge; wisdom (n)
aith(i)or; ecthor|swordsman; warrior (n)
aith; aithi; aithwen; ectha (Warfare and Hunting)|sword (n)
aith; aithr (Agriculture and Vegetation)|thorn (n)
aitha-|to prick; to sting (vb)
aithl; aithyl; tuil|spring (n)
aithla-|to bubble up; to issue forth; to spring (from) (vb)
aithog; aithra|thorny (adj)
aithos|thorn bush (n)
aithr; mort|†sword (n)
aithrog; aithron; aithweg; gothweg; mord; mort|warrior (n)
aithron|†swordsman (n)
aivin; aivor|colony of birds; rookery (n)
ai|oh! (interj)
alaf|broad of the back (n)
alan; rôma|shoulder (n)
alc(hor)|fane; shrine; temple (n)
alch(ar)|shrine; temple (n)
alcharn; durog; duruin; âlog|wooden (adj)
alcharn; âlog|of wood (adj)
alepthog; alewthion|having fingers (adj)
alepthog; lepthadrin; lepthindros|fingered (adj)
alf; alfa; alfuil(in); silwin|swan (n)
alm(oth); alos; drui; drû; gawlas; goloth [ng-]; tavros|forest (n)
alm|back (from shoulder to shoulder); shoulders (n)
altha-|to grow (high); to shoot up (vb)
altha|sapling; scion; shoot; sprig (n)
alw(eg)|lofty (of living things, trees, men) (adj)
alwen; galdon; orn|tree (n)
am (adv)|above; towards head of; up; upwards (adv)
am (n)|breast; front (chest) (n)
am(b)ros(t); amrost; aurost; glô; haurost|dawn (n)
amabwed; mabwed|having hands (adj)
amaith; amil; mab(a); mabir; mam; nanwin; nân|mother (n)
amlad; ladwen|surface (n)
ammogrint|red-breast[ed] (adj)
ammos|byrne; cuirass; hauberk (n)
amon (adv)|against stream; uphill (adv)
amon (n)|hill; mount; steep slope (n)
amosgarn; cilobinc; crinthammos; cílobi|robin (n)
amoth|breast (n)
amra-|to go up and down; to live in the mountains; to wander (vb)
amrad; amraith|nomand; wanderer (f.) (n)
amrint|lark (n)
amrod|living in wilds; wandering (adj)
amrog-dorn|brown wanderer; gipsy (n)
amrog|nomand; wanderer (n)
angrin|iron; of iron (adj)
ang|iron (n)
annai; eg; egros|far away (adv)
anna|door; opening (n)
annor(in); annuir; dara|lofty (adj)
ann|door (n)
anos|man (fullgrown); warrior (n)
anothrin|adult (of men); fullgrown; manly (adj)
anoth|man (fullgrown); warrior; †manhood (n)
antha-|to give (vb)
antha; ortha|upper (adj)
anthor(in)|lofty (of mountains) (adj)
anthos|above; up (adv)
anthum|cg. onto; upwards (prep)
ant|cheek; face (n)
an|-body; anyone; creature; one; person; someone; they (n)
ar (conj)|and; besides; too (conj)
ar (prep)|at; to; towards (prep)
ar-|along with; beside; compared with (pref)
arc; arch; gruim; grum; saichwed; sairin; torod; udrug|fierce (adj)
archod|difficulty (n)
archos|evil temper; savagery (n)
archuis|evil temper (n)
arch|awkward; difficult; harsh (adj)
arc|awkward; difficult; harsh; ill tempered (adj)
arf; arp; gwivrin; ilgiol; uivrin|barren (adj)
arf; arp|desert; dry (adj)
argulthion|equal; equivalent (adj)
arin(g)|kiln (n)
armin; ermin|desert; waste (n)
arn; bo(n)|son (n)
arog|rushing; swift; torrential (adj)
artha-; lentha-|to approach (vb)
arthaid-; gada-; ilt(h)a-; ilt-|to join (vb)
artha|alongside (of) (prep)
arthi; erthi|also; as well; besides; too (adv)
art|along side of; beside (adv)
arwad|apple tree (n)
asc; asg|bone; stone of fruit (n)
asc; nen(n) (Physical World)|water (n)
ath; atha (pron)|3rd pl. pronoun; they (pron)
atha (cardinal)|two (cardinal)
athla|twice (adv)
athron|other; second (adj)
athru|again; once more; secondly (adj)
athwi; uith|both (adj)
auba; gam; gôm|shout (n)
auglas; auglos|bright sunshine (n)
augla|ray of sunlight; sunbeam (n)
aulin; raig|wrong (adj)
aul|badly; ill (adv)
aur(a)|Sun (n)
aurin|fashioned; made (by craft of hand); wrought (adj)
aus(s)aith; avasaith|avarice (n)
ausin|fortune; rich (adj n)
ausirol; avos; gwalthi; gwalwen; gwalweth|fortune (n)
aust; ost; sachwen; safwen; saiwen|summer (n)
authmadri|midday meal (n)
authmeg; maidhon|midday (n)
authmeg|high noon (n)
auth|noontide; sunshine; warmth (n)
avasaith|greed of gold (n)
avas|luck; wealth (n)
avosaith|avarice; greed of gold; money-greed (n)
avos|luck; prosperity; wealth (n)
awl|*lofty (adj)
ba; bi; bir|in (prep)
bab-|to drink; to quaff (vb)
baba; babi|mamma; mummy (n)
bacha|coat; jacket (n)
bactha-; haitha-; padra-|to walk (vb)
bactha|leg (n)
bad (Dwelling and Furniture)|building; outhouse; shed (n)
bad-|to travel (vb)
bad; haid; haig; int; rada; tê|path (n)
bada-|to build (vb)
badweg|pedlar; traveller (n)
bag-|to sell; to trade (vb)
bageth|market (n)
bagri|wares (n)
bagron|trader (n)
baidha-|to clothe (vb)
bail|case; cover; pod; sheath (n)
bain; govaithum|clad (adj)
baith (Clothing and Adornment)|garment (n)
baithri|clothes; clothing (n)
baith|journey; road; way (n)
bal [mb-]|anguish; evilness; pain (n)
balc|cruel; evil (adj)
baldrin; beleg; bâl; malcrin; malcwed; odog; polodrin|mighty (adj)
bald|*worthy (adj)
balt|free; rid; soluit (adj)
banc|trade (n)
bandra|away; departed; gone; lost (adv)
band|hell (n)
bang|staff (n)
bant|wall (n)
baptha-|to feed; to take sup of (vb)
bar [mb-]|dwelling; home (n)
bar(n)a- [mb-]|to dwell in (a land); to till (land) (vb)
bara [mb-]|cottage; home (n)
barai [mb-]; barthi [mb-]|at home; home (adv)
barant [mb-]; barod [mb-]|home; homewards (adv)
baravlid [mb-]|homeless (adj)
barchol|awful; terrible (adj)
barc|dread; terror (n)
bardha-|to reign; to rule (vb)
bardha; hermin|realm (n)
barn [mb-]; baron [mb-]; ruin|inhabited; tilled (adj)
barog [mb-]; baron [mb-] (adv)|abroad; away; from home; out (adv)
baros [mb-]|hamlet (n)
bart; elt (Spatial Relations)|change (n)
bartha-|to alter; to change; to exchange (vb)
bart|*fate (n)
barwen [mb-]|homestead (n)
bas- [mb-]|to bake (vb)
basbos; gwass|splash (n)
basbotha-; fasca-; throsta-|to splash (vb)
basca-; basga-; cwas-|to flap (vb)
bascovas|flapping and beating (especially of wings) (n)
basgorn [mb-]|loaf (of bread) (n)
bass; ram|pinion; wing (n)
bast [mb-]|bread (n)
baul|body; trunk (n)
baur [mb-]; ind; indos; inn; innos; rû|house (n)
bectha|chin; tip (n)
bedhgad; bedhiod; besgad|wedlock (n)
bedhin|married; wedded (adj)
bedhren|brother in law; kinsman by marriage (n)
bedhres|*kinswoman by marriage; sister in law (n)
bedhri; gadweth; govedhri|wedding (n)
bedhril; bess|wife (n)
bedhron; benn (Mankind)|husband (n)
bedhwen; govedhwen; hauthwais|matrimony (n)
begl|beard (n)
beg|chin (n)
belectha-|to extol; to magnify (vb)
beleg; odog|great (adj)
beleth(os)|144; a great number; a gross (n)
belin|expanded; set (of sails); unfurled; unrolled (adj)
belon|sail (n)
beltha-|to expand; to open out (transitive); to set sail; to unroll (vb)
belu-; belwa-|to belly (of sails); to swell; to unfurl (intransitively); to unroll (vb)
benc; bent|small boat (n)
benin; benwed|pretty; shapely (adj)
benli|a pretty (n)
benn (Spatial Relations)|cut; fashion; shape; shapeliness (n)
benna-|to wed (vb)
bentha-|to cut; to fashion; to shape (vb)
benthi|pretty (adj)
bilin(c)|small bird; sparrow (n)
biltha-|to flit; to flutter (vb)
bir|inside; within (prep)
bith|juice; sap (n)
bladwen; eng(a); ladwen|plain (n)
blaith|spirit (n)
blantos; mabinos gwilbriniol; mavlantos|sycamore (n)
blant|blunt (of words); candid; expansive; flat; open (adj)
blath|floor (n)
blectha-; blencha-|to flash (vb)
blectha; bleg|a flame (n)
blenc; galwed; glathrin|brilliant (adj)
bless [mb-]|good feeling; grace; kindness (n)
blethrin [mb-]|gracious; kind (adj)
blid-|to free; to rid (vb)
blith|air; breeze; zephyr (n)
bloss [mb-]|wheat (n)
bo-; bon-; go-; gon-|son of (pref)
bod-|again; back; un- (= backwards) (pref)
bodra-|to delay; to hinder; to tarry (vb)
bodra|back(ward); hinder; rear (adj)
bodron|behind; further back (adv)
bodruith; hadruith; sagruith|revenge (n)
bodruithog|thirsting for vengeance (for a particular act) (adj)
bodruithol|vengeful (by nature) (adj)
bod|back; behind; of time ago; ‘a while back’ (adv)
bont|back(wards) (adv)
bordd; tangar; tangor|fireplace (n)
born|age; great period (n)
botheb-|to undo; to unloose; to untie (vb)
bothli [mb-]|oven (n)
brach|plaid; shawl; wrap (n)
bractha-|to arouse; to awaken; to refresh; to revive (vb)
brada; drogla|cart (n)
brada|waggon; wain (n)
brag; guin; laibrin|fresh (adj)
brageth; gwinwen|freshness (n)
braitha-|to swathe; to wrap (vb)
branc; brant; branta|bow (for shooting) (n)
brand; indos; innos; thambros|hall (n)
brann|dwelling; hall (n)
brant [mb-]|cooked; done; overdone (adj)
brantha-; ras-; tortha-|to scorch (vb)
brath-|to cook (vb)
bridh(n)ir|princess; queen (n)
bridhon|king; prince (n)
bridhweg|liege (m.) (n)
bridhwig|liege (f.) (n)
bridol|changing; variable; varying (adj)
brig-|to be afraid of; to fear (vb)
brigla-|to change; to vary (vb)
brigli|variation (n)
brigol|afraid; fearful; timid (adj)
brin(in)|glassy substance (n)
brinc|clear; transparent (adj)
brindi|(Queen) Princess (n)
bringlast|alabaster (n)
brith-; tug-|to chance (vb)
brithla|pearl (n)
broch; bros(s)|mare (n)
brod; bron(n)|firm; steadfast (adj)
brog; mair|horse (n)
bronniol|constant; faithful (adj)
brontha|continual; continuous; everlasting; unceasing (adj)
bront|perpetually (adv)
bronwedieth; bronweth|constancy (n)
brum; rum|noise (n)
brumla-; rumla-|to make a noise (vb)
buin|desire; wish (n)
bâl|great; important; worthy (adj)
bâ|away; off (adv)
bóra|always; continuously; ever (adv)
bôr|descendant (n)
cab-|to jump; to leap (vb)
cacha-; cancha-|to laugh (vb)
cactha-|to deride; to laugh at; to make fun of; to mock (vb)
caf-|to taste (used of the thing) (vb)
caf; cim|blade (n)
cafalon|*(lit.) head-naked; bald (adj)
cafol|bald (adj)
cafwen|judgement; sense of taste; taste (n)
cag; cagri; cagli|jest; joke (n)
cagrin|amusing; funny (adj)
cagriol|jocular (adj)
cailtha-; mictha-|to kiss (vb)
cailthi|kiss (n)
cail|lip (n)
caineglad|fortnight (n)
caitha-|to bring about; to cause; to compel; to induce; to make to do or be (vb)
caithl|fount; origin; source (n)
caithonwed|original (adj)
caithos|causation (n)
caith|cause; motive; reason (n)
calon|budd[ing]; grown (of plants); in blade (of corn) (adj)
calph|bucket (n)
caltha-|to flourish; to grow; to wax (vb)
caltha|herb; plant (n)
calwed; hilon; hilwed; hithadrin|adolescent (adj)
calwed|flourishing (adj)
calw|green shoot; sapling; sprout (n)
cam(m)a-; cav-; crictha-; loctha-|to bend (vb)
cam(m)a-|to bow; to cower; to stoop; to submit (vb)
camba-; cavra-|to cower; to stoop (vb)
camp|leap (n)
cam|bent; bowed; humble; submissive (adj)
canc; dairwen|mirth (n)
cancol|laughing (adj)
canc|laughter; merriment (n)
canga-; loctha-|to tangle (vb)
cangi-; cinga-|to get tangled; to go wrong (vb)
cang|awry; confused; confusion; mixed up; mêllay; tangle; tangled (adj n)
cantha; tang|flame (n)
cantharol|flaming; glaring (adj)
canthor|blaze; flare; glare (n)
cantrib|square (n)
cant|four (cardinal)
captha-|to startle (vb)
cara|act; deed (n)
carc|fang; jag; point (n)
cariod(wen)|activity (n)
carm|act; deed; exploit (n)
carn(in)|scarlet (adj)
carna|blood (especially fresh blood); gore (n)
carn|done; finished (adj)
carpa|bunched-up; in a bunch; together (adv)
carp|bunch; bundle (n)
cartha-|to finish; to make (vb)
carthion|complete; perfect (adj)
cas|head; skull (n)
cathor|(lit.) head-ward; helmet (n)
caug (adj)|bent; bulging; humped (adj)
caug (n)|humpback (n)
caum; nog|knob (n)
caura; cîr|sour (of milk) (adj)
cauri; cír; cûr|cheese (n)
cautha- (Sense Perception)|to get flavour of; to notice; to perceive; to taste (of the taster or person) (vb)
cautha-; thas-|to shave (vb)
cauthiol|circumspect; discreet; endowed with good taste; tasteful (adj)
cav-|to make stoop (vb)
cectha-|to spout out (vb)
celchin|of glass (adj)
celchwed; celegrin|glassy (adj)
celc|a glass; glass (n)
celebrin|of silver (adj)
celebriol|like silver (adj)
celeb|silver (n)
celeg; talp|glass (n)
celegrin|like glass (adj)
celeptha|silvern (adj)
celu-; gul-|to trickle (vb)
celu; celwin|rill; runlet; stream (n)
celwa-|to trickle (n)
ceral|jar (n)
cilm|brink; edge; rim (n)
ciloba-; ciloptha-|to chirp; to chirrup; to twitter (vb)
ciltha-|to jerk (out); to tug (vb)
cilt|jerk (n)
cing(win); ging; gung; ungwi|spider (n)
cingra-|to plait (vb)
cingrafindl|pigtail (n)
cingra|plaited (adj)
cint; sith|hither (adv)
cintha-|to light; to set alight (vb)
cith; nath|affair; matter; thing (n)
clam(p)|claw; grasp (n)
clamfa-|to claw at; to grab (vb)
clann; eilian; olf(in); olfin(g)|branch (n)
clast|bud; shoot; sprout (n)
clath|small branch; twig (n)
clib-|to lean; to support; to uphold (vb)
climli|heaven; sky (n)
cli|?attractive (adj)
clochiol|stone (adj)
clochrin; clogrin|stone-like; stony (adj)
clochwed; clogwed|stone-covered; stony (adj)
cloch|stone (small); stone of fruit (n)
clocthi|pebble (n)
clogod|shingle beach (n)
clog|stone (small) (n)
closs|shingle (n)
cluimri|cosiness; pleasant warmth (n)
cluim|cosy; warm (adj)
clum(mi)|mushroom (n)
codiavol; codiof; codwed|nutbearing (adj)
codomla|*chestnut (n)
codorn; codron|*nut tree (n)
codrin|nutty (adj)
codwalion|chestnut; walnut (n)
cod|nut (n)
cog|claw; fist (n)
colc|box; chest (n)
coluid|pestilent (adj)
colu|pestilence (n)
colw; morn|black (adj)
corin; corol|circular; rolling; round (adj)
corm|circle; disc; ring (n)
corn|loaf (n)
corob|skull (n)
cortheb|boundary; bounds (n)
coth|husk; nutshell (n)
craig; gwegla|crooked (adj)
craitho-; crectha-|to spit (vb)
craith|foam; froth; spume (n)
cranta-|to accomplish; to achieve; to complete; to finish (vb)
crantha-|to complete (vb)
crech|spittle (n)
crib-|to gather; to pluck (vb)
crig|elbow (n)
crinc|bent and thin; crescent (adj n)
crinthammos|(lit.) red-breast (n)
crintha|pink; rosy (adj)
criptha|bunched-up; in a bunch; together (adj adv)
cris(s)|cleft; gash; gully; ravine (n)
criscolas|(lit.) *sharp-leaf; holly (n)
crista-|to cut; to slash; to slice (vb)
crist|knife; slash; slice (n)
crithiol; crithog|circular (adj)
crithla-|to circle; to encircle; to go round (vb)
crithos; drinn; grail; lemfarilt|ring (n)
crithos; grail|circle (n)
croctha-|to catch; to snare; to trap (vb)
crogin|hooked (adj)
crog|hook (n)
cross; crost|ball (n)
crost|cake; lump (n)
crug|beak (espec. of a ship) (n)
crui; cruith|colour (n)
cruim|coloured (adj)
cruith|appearance; complexion (n)
crunc|crow (n)
crî|knife (n)
crôl|round (adj)
cub; dûl [nd-]; rothrin; rûdin; tumbol|hollow (adj)
cuctha|consideration (n)
cucthol; cunghol|painstaking (adj)
cug-|to consider; to ponder; to resolve; to think (vb)
cuib; cwim|alive (adj)
cuibri|vitality (n)
cuid|animal; living creature (n)
cuilborn|lifetime (n)
cuilin; culwin; glôrin; glôriol|golden (adj)
cuilogri; cuilogwi|liveliness (n)
cuilog|alive; lively (adj)
cuil|life; lifetime (n)
cuitha-|to be alive; to live (vb)
cuithos|life (period of life); livelihood; living (n)
cuith|life; living body; the vital principle (n)
culon|*gold (n)
culu; glôr|gold (n)
cum-|to lie (down) (vb)
cumli|couch (n)
cuno|care; thought; ‘pains’ (n)
cunwed; cûn; cuvon|bent; bowed; concave (adj)
cuptha-|to bend (tr). (vb)
cur-|to congeal; to curdle; to turn sour (vb)
curdhuig; curdhweg|sinner [m.] (n)
curdhuin; curdhwin|sinner [f.] (n)
curdhu|evil; sin; wickedness (n)
curin; thairiniol; thairinwed|magical (adj)
curtha-|to curdle; to make cheese (tr.) (vb)
curth|curd (n)
curug; thothweg|wizard (n)
curus|witch (n)
curusôn|witchcraft (n)
curuthli|enchantments; sorcery (n)
curu|magic (n)
cusc; susc|abashed; hushed; quiet (adj)
cwam|ill (adj)
cwancha-|to ail (vb)
cwanchri|ailment (n)
cwanc|poorly; seedy; sickly (adj)
cwant|all the (with article); full; the whole (adj)
cwarth (cwardh-)|bad; evil; wicked (adj)
cwas-; cwath-|to nod; to shake; to wag (vb)
cwast|shaking (adj)
cwathil; pectha; pecthon|plume (n)
cwathli|plume; spray; tassel (n)
cwathra-|to shake (intr.) (vb)
cwed-|to say; to tell (vb)
cwedri|telling (of tales) (n)
cwel-|to fade; to wither (vb)
cweleg|corpse; dead body (n)
cwelm; math|dusk (n)
cweloth|fading (n)
cwent|saying; tale (n)
cwerc|throat (n)
cwess|proverb; saying (n)
cweth|word (n)
cwibra-; cwiptha-|to arouse (tr.) (vb)
cwidhra-; cwira-; ruitha-|to rustle (vb)
cwildred|bat (animal) (n)
cwileg|alder (n)
cwiliog; cwilon|bright-hued (adj)
cwil|hue; tint (n)
cwim(ri)|body; flesh (n)
cwimp|alert; vigilant (adj)
cwim|alert; awake (adj)
cwing; quing|bow (n)
cwingfimli|skill at archery (n)
cwingfim|skilled at archery (adj)
cwinglios|archery (n)
cwingron|archer (n)
cwintha-|to fill (vb)
cwir-|to make spin; to stir; to stir round (vb)
cwiril|spindle (n)
cwiruin|spinning wheel (n)
cwist; rûm|secret (n)
cwitha-; cwithra-|to murmur; to whisper (vb)
cwithri; rui|whisper (n)
cwithwiros|poplar (n)
cwiv-|to be awake (vb)
cwivra-|to awaken (intr.) (vb)
cwivros|awakening (n)
cwîl|gentle; peaceful; quiet (adj)
cwîr; malthin|cream (n)
cî; sî|here (adv)
cîrin|modern; present (place or time) (adj)
côf|odour; savour; smack (n)
côl|edible plant; herb; vegetable; wort (n)
cômathol|diseased; ill (adj)
côma|disease; illness (n)
cûm|burial mound; mound (especially grave) (n)
cû|bow; crescent; the waxing or waning moon (n)
daf-|to flay; to peel skin; to strip (vb)
dafros|bark; peel; skin (n)
dai (adv)|exceedingly; very (adv)
dai; ilon; ilwi(n); ilwint; luithon; telm; telum (n)|sky (n)
daimoth; ilbar|heaven (n)
daira-; dairtha-; saltha-|to play (vb)
dairiol|funny; merry (of things) (adj)
dairion|merry (adj)
dairog|merry (of persons) (adj)
dairtha-|to amuse (vb)
dairwed|funny (common); merry (adj)
dair|merriment; play (n)
dala- [nd-]|to sing or ring (vb)
dalech; daleg|(upright) stone (n)
daltha-|to erect; to set up (vb)
dal|cairn (n)
dana|day (24 hours) (n)
danoriol|daily (adj)
dantha-|to illuminate; to illustrate; to light up (vb)
danthos|(artificial) light; illumination (n)
dant|lamp (n)
darath; daroth|peak; summit (n)
dauth(r)a-|to flay; to strip (vb)
dauth; dôf|hide; skin (n)
dautha|naked; stripped (adj)
da|?with (prep)
deg|what (n[euter]) (pron)
deil(i)an; delwen|beech tree (n)
deldrin grontholas [nd-]; deldron grondolas [nd-]; gronthos deldrinwed|oakleaved beech (n)
deldrinwed [nd-]|beechen (adj)
deldrogod [nd-]|beech nut (n)
deldron [nd-]|beech (tree) (n)
delmos|beech nuts; mast [= fruit of beech, oak, chestnut] (n)
difedhin|*outlaw (adj n)
dimborn|olden times; past days; the past (n)
dim|former; over; past (adj)
diradhim; diradhin|once upon a time (adv)
diriol|tedious (adj)
dir|who (f.) (pron)
dod-|to drop; to fall down (vb)
dod; piog|berry (n)
dodri|falling (n)
dodri·lassion|*(lit.) falling of leaves; autumn (n)
dol- [nd-]; elta-; saptha-|to dig (vb)
dolc [nd-]|deep (adj)
doldrin [nd-]; dolfa [nd-]; dolmeg [nd-]|mole (n)
dolm [nd-]|pit (n)
dont|bump; drop; fall (n)
don|who (pron)
dori; turwin|queen (n)
dorm|summit (n)
dorn(a) [nd-]|(holm) oak; ilex (n)
dorn|seat (n)
doros|throne (n)
dortha-; panta-; sam-; tulga-|to settle (vb)
dorven [nd-]|*(lit.) land-shape; landscape; scene (n)
dos|when (adv)
doth [nd-]|damp; drizzle; moisture (n)
dothli; tibli|drizzle (n)
drab-|to (impersonal) to irk; to annoy; to labour; to work (vb)
drabri|labouring (adj)
drab|irksome work; labour; toil (n)
drambor|thudder (n)
drautha-|to tire out; to weary (vb)
drauthiol|arduous; labourious (adj)
drauthos|toil; weariness from labour (n)
drauth|tired; toilworn; weary (adj)
drib- [nd-]|to decay; to rot; to wear out (vb)
dribin|worn out (adj)
drim|dew (n)
drinn|disc (n)
drintha-|to turn (tr.); to twist (vb)
drint|turn; twist; wrench (n)
drio [nd-]; driodweg [nd-]; driothweg [nd-]|hero; warrior (n)
driod [nd-]; driodwen [nd-]; driothwen [nd-]|heroism; valour (n)
driog [nd-]|valiant (adj)
drith [nd-]|flavour; inkling; savour; smell; suggestion (n)
drith-|to it smells; to savours of; to smacks of (vb)
drogod|bondage; slavery; thraldom (n)
drogol; drogwed|base; mean; servile; slavish (adj)
drogwin|slave woman (n)
drog|servant; slave; thrall (n)
dronn [nd-]|course; race; track (n)
drui; drû; duru|wood (n)
drum|firm; stout; strong (adj)
drô|rut; wheel track (n)
duif (duiv-)|stream (n)
duil (Motion and Transportation)|fledged; flight; having power of flight; power of flight (n)
duil; duilin(g); duilinc; glindwil; lindwil|swallow (n)
duila-; gwil-|to fly (vb)
duileg|fledged; having power of flight (adj)
duivrad|canal (n)
duivrant|aqueduct (n)
dui|where (adv)
dultha-|to dine (vb)
dultha|dinner; supper (n)
dulwen|feast (n)
dumgort; dungort|(evil) idol (n)
dum|not to be spoken; secret (adj)
duru|beam; log; pole (n)
dwindi|a swift (bird) (n)
dâ; ront|high (adj)
dâd; nâd|grandfather (n)
dâf; padhwen; pand|bark (n)
dân; glâ; gôl|day (n)
dîr|long (of time) (adj)
dólin; glingon; glîr|song (n)
dôr [nd-]|country (inhabited); land; people of the land (n)
ectha-|to jet; to spout (vb)
ecthadra-|to put to the sword; to slay (vb)
ecthel(uin)|fount; fountain (n)
ed; edhos|close by (prep)
edhos|just without (prep)
edh|beside; hard by; near; near borders of; outside (prep)
eg (adv)|far off; wide (adv)
eg; egros|distant (adv)
eg; nel; seg; teb; teg (n)|point (n)
egelmion|broadshouldered (adj)
egiont|farther; further (adj)
egli(n)|needle (n)
egra|distant; far away (adj)
egrin|broad; far; vast; wide (adj)
egriol; odog|excessive (adj)
egwed|distant; far (adj)
eiben|cherry (n)
eilin; lô; nîn|pool (n)
eithlos; gwanos; gwaren; gwarin(n); nothri; renni|family (n)
eithog; eithweg|ancestor; sire; †father (n)
el(u)m|think of that! (interj)
elc|else; something else (adv n)
elef|half; half a ... (n)
elegrin|different; strange (adj)
eleg|else; other (adj)
elf(in)|five (cardinal)
elf; honn; ilf; ôm|heart (n)
elfeg|half (adj)
elfel|different; like something else (adj)
elm(en)|marvelous or unique thing; singular; something strange; wonder (n)
elma-|to admire; to marvel at (vb)
elta-|to draw; to lug; to poke (inward); to thrust; to tug (vb)
eltha-|to alter; to change (vb)
eltha|or; otherwise (adv)
elt|dig; lug; poke (probe); tug (n)
el|or (conj)
embrin|by name; named (adj)
emfeg; enfeg|infamous; of evil name (adj)
em|called by name; named (adj)
end|birds nest (n)
eng(a); nal|vale (n)
engan|spear (n)
engri[n]|of iron (adj)
engriol|of the vale; vale like (adj)
engri|flat surface; level; plane (n)
eng|level; smooth (adj n)
enn; gôm|name (n)
enos; enuith|title (n)
entha-|to call; to indicate; to name; to point out (vb)
entha|there by you; thither (adv)
enu-; enwa-|to be called; to be named (vb)
enweg|name sake (n)
enwiol|nominal (adj)
en|that already mentioned (by you); that by you; that past (pron)
er(e)tha-|to deprive; to isolate; to rob (vb)
ereg|alone; only (adj)
erethog; erethrin|isolated; lonely; solitary (adj)
ereth|loneliness; oneness; solitude (n)
erth (erdh-); mavwin|wish (n)
ert|once; once only (adv)
erwed|unique (adj)
erw|only (adv)
er|one (adj)
esc|sharp edge; sharp point (n)
est(i)rin; estirion|pinnacle; tower (n)
ethl(in)|ivy (n)
fab-|to feel; to handle; to touch (vb)
fabli|sense of touch (n)
fabwed; lubi|corpulent (adj)
fadin|sated; saturated (adj)
fadra-|to sate; to weary; to ‘feed up’ (vb)
fadrin; fadriol|sufficient (adj)
fadro(n)|too much (adj)
fadrog|tiresome (adj)
fadros|satiety; weariness of anything (n)
fad|enough (adv)
faf-|to blow; to pant; to puff (vb)
fafli|bladder (n)
fag-|to cut (vb)
fagin|cut (adj)
faidwen|freedom (n)
faiglim; faiglion|having long hair (adj)
faigli|hair; long tresses (n)
faigri|cruelty (n)
faig|cruel (adj)
failtha-|to go pale (vb)
failthi|pallor (n)
fail|pale; pallid (adj)
faina-|to get free (vb)
fairtha-|to release; to set free (vb)
fairthos; faith|liberty (n)
fair|free; unconstrained (adj)
faithir|Saviour; liberator (n)
falas|beach (n)
falchon|great two-handed sword; twibill (n)
falchor; falchos|cliffs (n)
falc|cleft; cliffs; gash; ravine (n)
falin; falon; hulc|naked (adj)
falm|breaker; wave (n)
falos|beach; coast; edge; fringe; line; margin; sea-marge; surf (n)
falt; fôl|bare (adj)
faltha-|to despoil; to make bare; to rob; to strip (vb)
famfa-|to maul (vb)
famfolc|fat-bellied (adj)
famp|appraising; assay; caressing; feeling; fingering; handling; stroking; touching; ‘fuss’ (n)
fam|fat belly; paunch (n)
fanc; tôb(a)|cut (n)
fang|(long) beard (n)
fann; lath|year (n)
fant|bent; bowed; crooked (adj)
far(o)n|different; separate; strange (adj)
far-|to depart; to divide; to leave; to separate; to sever (vb)
farc|crack; division; quarrel; split (n)
farn|boundary; mark; shore (n)
faronwed|foreign (adj)
faronweg|foreigner (m.) (n)
faronwin|foreigner (f.) (n)
faroth|boundary (n)
fartha-|to divide (tr.) (vb)
far|however; yet (adv)
fas-; puibra-; puidra-|to wash (vb)
fasc; glan; puig; sôn|clean (adj)
fasca-|to sprinkle (vb)
fass; fath (Clothing and Adornment)|tassle (n)
fast (Physical Acts and Materials)|cleaning; wash (n)
fast (Spatial Relations)|holder; stand (n)
fathli|tasselled fringe (n)
fathrin; fathwed|tasselled (adj)
fath|legality; possession; property; rights (n)
fau-|to give off a smell; to smell (vb)
faug (n)|wood smoke (n)
faug; golog; golw|stinking (adj)
fauglas; fuglos|tobacco (n)
faust|odour (neither pleasant nor unpleasant); smell (n)
fautha-; fôtha-; nictha-|to snow (vb)
fech; olch; ulc; ulch|bad (adj)
fectha-|to destroy; to ruin; to spoil (vb)
fecthir|bane; destroyer; slayer (n)
fecthi|baddish; less bad; naughty (adj)
fedhin|ally; bound by agreement; friend (n adj)
fedhirweg|lawman; lawyer (n)
fedhir|agreement; convention; law; properly bond (n)
fedhra-; gofedhra-|to unite in a band (vb)
fedhril|one bound by oath [f.] (n)
fedhrog|one bound by oath (n)
fedhwed|lawful (adj)
fedhwen|treaty (n)
fegla; feigien|worse (adj)
fegrin|free (adj)
felcha-; felegra-|to equal (vb)
felectha-|to equalize; to make equal (vb)
felegrin|equable (adj)
feleg|equal (adj)
feltha-|to be probable; to resemble; to seem like; to seem likely (vb)
felthadrin|probable (adj)
feltha|like; similar (adj)
felu-; ol-|to seem (vb)
felweg; gofelweg|one’s fellow or equal; rival (n)
fel|(as av.) as; like (prep adv)
fem|poison in general; venom (of snakes) (n)
fengvain|quiver (n)
fengwathil|arrow feathering (n)
feng|arrow; war arrow (n)
fenlug; fent; lingos; lûg|snake (n)
fenog; fenwed|venomous (adj)
fesca-|to irritate; to itch (vb)
fesc|irritating; itching (adj)
fess|itch; itching (n)
festa-|to breath[e] (vb)
fest|breath; breathing (n)
feth|one breath (n)
fi-|2nd-person singular; you (pron)
fidhrad|hairy; hirsute (adj)
fidhra|collective hair (n)
fidhrin|haired (adj)
fien; fuin|worse (adv)
filc; fileg|fern (n)
fimli; finwi; sôn|skill (n)
fimlios|skilfulness (n)
fim|clever; right hand (adj)
finc; finig|trick (n)
findel; fingl; finnil|tress (n)
fingli|narrow place; pass in mountains; sound; straits (n)
fing|narrow (adj)
fini(o)s|larch (n)
finn|lock of hair (n)
fintha-|to cheat; to deceive; to take in; to twist (vb)
fintha|thine (pron)
finthi|idea; notion (n)
finweg|craftsman; man of skill (n)
fiont(ha)|later (adj)
fiont|least (adj)
fion|bowl; goblet (n)
fir|less (adj)
fith (fidh-)|single hair (n)
fladwen; fladweth|grassland; meadow (n)
flad|grass; sward (n)
flantha-|to scorn; to utterly despise (vb)
flanthog|scornful (adj)
flant|expression of scorn; leer; sneer (n)
flan|scorn (n)
flass|foam; fringe; margin; ragged margin; sea-marge; surf (n)
flathnir; flathwin|foam fay (n)
flathrin|foamy; tasseled (adj)
flathwi; flathwing|scud; spindrift; spray (n)
flidhra|graceful; ‘willowy’ (adj)
flig-; pelectha-|to hew (vb)
flinc|chip (n)
floss; thloss|breaker (n)
fluim|(black) smoke; reek (n)
fodra-|to bring to an end; to come to an end; to end; to finish (vb)
fodra|endmost; latest; the last (adj)
fod|bottom; butt; end (n)
fofri; fofru|folly (n)
fofrin|foolish (adj)
folc|evil-smelling (adj)
foltha-|to emit smoke; to reek; to smoulder (vb)
forog|enemy (n)
fost; narth; nûth|odour (n)
fostrin|odorous (adj)
fo|a clan (n)
fring|carcanet; necklace (n)
fripthon; thrimp|stalk (n)
fuctha-|to smoke (over a wood fire) (vb)
fufril|moth (n)
fufuin; fuis; fund; fô(tha); fûn|hoard (n)
fug-|to smoulder (vb)
fugla-|to smoke (a pipe) (vb)
fuglas|*(lit.) smoke leaf; tobacco (n)
fuglathrod; ross|pipe (n)
fugri|smother (of smoke) (n)
fuin; furion; furn; mugwen; ruim|secret (adj)
fuin; morn|dark (adj)
fuin|hoarded (adj)
fuior|deadly nightshade (n)
fuitha- (Spatial Relations)|to hide (tr.) (vb)
fuitha- (Time)|to fall (of night); to grow dark (vb)
fuithlog; fuithlug|dragon (who guards treasure) (n)
fui|night (n)
func|smoke (n)
fung|dark (esp. of colour) (adj)
funt|elephant (n)
fur-|to conceal; to lie (vb)
furion|concealed; hidden (adj)
furn|concealed (adj)
fwegli|brush (n)
fwegra-|to sweep (vb)
fweg|broom (n)
fwi-|fem. patronymic prefix (pref)
fwion|nephew (n)
fwîr|niece (n)
fâ-; gôtha-|to have; to hold; to possess (vb)
fêg|bad; poor; wretched (adj)
fîr|late (adj)
fô; glui|snow (n)
fôf|fool (n)
fôl; nil|empty (adj)
fôl|leafless (esp. of trees) (adj)
fôr|gap; gulf (n)
fôs; soth|bath (n)
fûr|lie (n)
ga-|more; very (pref)
gab-|to bark; to bay (of dogs) (vb)
gach|milch cow (n)
gad(a)|isthmus; joint; link; small lane; track (n)
gada-|to connect; to unite (vb)
gadorwen|society (n)
gados; gadros|association; fellowship; union (n)
gadr; gôd|joint; link of chain (n)
gadren|*brother in law; kinsman by marriage (n)
gadres|*sister in law; kinswoman by marriage (n)
gadron|associate; fellow (n)
gadu|connected; joined (adj)
gadweth|joining; union (n)
gadwi; hethgadwi; hethgedwi|twins (n)
gagron|bullock; yoke ox (n)
gag|jaw (n)
gaibra-|to impregnate (vb)
gaib|*pregnant (adj)
gaid; gantha|more (adv)
gaigin|arms (n)
gaig|tool; weapon (n)
gail|star (n)
gaisin|of steel (adj)
gaista- [ng-]|to cause great grief to; to oppress (vb)
gaist|oppression; torment (n)
gais|steel (n)
gaithrin|like steel (adj)
gaiw|pregnant (adj)
gal(a)|daylight; light (n)
gal-|to shine (golden, as the Sun) (vb)
galoth|*(lit.) light hole; window (n)
galtha-; tanga-; tantha-; tusta-|to kindle (vb)
galt|yoke (n)
galwed|shining (adj)
galwen|brilliance (n)
gam(m)a-|to be profitable; to bring in revenue; to gain; to increase; to profit (vb)
gama-|to call; to shout to (vb)
gandos|morose temper (n)
gand|dark and gloomy; gloomy of temper; harsh; ill tempered; morose; sour (adj)
ganos; gwinwen; gwioth|youth (n)
ganothrin; laibrin|youthful (adj)
ganthan|[originally?] large; adult; grown big; grown up; waxen (adj)
gant|(lit.) increased; greater; larger; more (adj)
gar(th) (gardh-)|district; place (n)
garob|cloak; outer garment (n)
garth; melon; meltha|beloved (adj)
gartha-|to admire; to have affection or respect for (vb)
garw|sown-field; tilled (n adj)
gath (gadh-)|blight; gloom (n)
gath|neck (n)
gaudhwen|fever (n)
gaul; gûm (Sense Perception)|burden (n)
gaul|light (n)
gaust|corn; crop (espec. of cereal) (n)
gauth|heat (esp. of body) (n)
gav-|to bear fruit; to produce; to yield (vb)
gavon|harvest (time) (n)
gavos|crop; produce; yield (n)
gedfel|affable; amiable; friendly (adj)
gedren|second cousin (m.) (n)
gedres|second cousin (f.) (n)
gedrin|akin; sib (adj)
gedweth|friendship; kinship† (n)
ged|chum; friend; kinsman† (n)
gentha-|to grip; to lay hold of; to seize (vb)
gen|closed hand; grip (n)
gerd(h)olm; gersauth; gersoth|mine (n)
gerin|metallic (adj)
ger|metal; ore (n)
geth (Social Relations)|clan; folk; kindred (n)
gethlir|friend; †kinswoman (n)
gethli|friendship (n)
geth|ore of metals (esp. raw iron) (n)
gil-|to gleam; to shine pale and silver (as of the moon) (vb)
gilm|moonlight; silver light (n)
gilt; tinc|a gleam (n)
giltha|white metal (n)
gima-|to hear (vb)
gimli|(sense of) hearing (n)
gimra-|to hearken to; to listen to (vb)
gimriol|audible; noticeable (adj)
gimri|attention; hearkening (n)
gintha-; intha- (Quantity and Number)|to add; to add to; to increase; to join to (intr.) (vb)
giol; giwl; giwol|conceiving; fecund; having conceived; just pregnant (adj)
gioth; giwth|embryon; foetus; germ (n)
giothra-|to be conceived; to germinate (vb)
giothrin|embryonic (adj)
glaib|dripping wet (adj)
glaimri|fair weather; serenity (n)
glaim|clear; fair (espec. of weather); serene (adj)
glair|meadow (n)
glais|sweetness (n)
glamog; thancol|loathsome (adj)
glamra-|to abominate; to detest; to loath (vb)
glamri|bitter feud (n)
glant(hi)|cleanness (n)
glantha-|to cleanse; to purge; to purify (vb)
glanthin; glanwethrin|cleanly; pure (adj)
glanweth|cleanliness; purity (n)
glan|(originally) bright; pure (adj)
glar(os)|blaze; glare; splendour (n)
glarossiol|dazzling (adj)
glarosta-; glartha-|to dazzle (vb)
glarw(ed); glaur|bright; light (adj)
glass; glâs|brilliance; clarity (n)
glastrin|marble (adj)
glast|marble (n)
glathrin|lucent (adj)
gledhrin; glen(d)rin; glen(n); thlind|slender (adj)
gledhrinios; glen(d)rinios|slenderness (n)
glen(n)|fine; thin (adj)
glent; glenweth|thinness (n)
glest [ng-]; lest|assembly; concourse; gathering; moot (n)
glesta-; hosta-; lesta-|to gather (vb)
glib (n)|drop of water (n)
glib; siriol (adj)|liquid (adj)
glimri|sheen (n)
glim|shimmering (adj)
glingon|chant; chanting (n)
glingrin|musical (adj)
gling|music (n)
glint; sincli|crystal (n)
glin|sound; utterance; voice (n)
glis; gur; gûri|sweet (adj)
glisca-|to have a sweet tooth; to like sweet things (vb)
glisc|flattering; fond of saying sweet or flattering things; fond of sweets; suave (adj)
glissith; glist|sugar (n)
glith|dale; hillslope (n)
glo(r)nethlin|buttercup; meadowgold (n)
glod|gullet; throat (n)
glonta-|to devour; to gulp; to swallow (vb)
glonthen|(lit.) eye of the day; dandelion (n)
gloss; glothrin|clear white; white (adj)
glost|whiteness (n)
glum (adj)|(over) burdened; dull; heavy; sad (adj)
glum; lum|cloud (n)
glumri|moroseness; sadness (n)
glâm|fierce hate; hatred; loathing (n)
glâ|daytime (n)
glîr|poem (n)
glóna-|to dawn (vb)
glô; orosaura; orost|sunrise (n)
glôrin|of gold (adj)
glôriol|like gold (adj)
glôs|acme; best of anything; blooming time; floruit; flower (n)
glô|daybreak (n)
go-; gwa- (Spatial Relations)|in one; together; with (pref)
gobli|dell (n)
gobos|haven (n)
gob|hollow of hand (n)
gochest; gwachest|brother and brother; brother and sister; etc. (n)
gochestri; gochethri; hestri; hethri|consanguinity (n)
godaithion; godaithri(o)n; taithion|educated (adj)
godaithri(o)n|learned (adj)
godaithrinwed|grammatical (adj)
godaithri|education; erudition; grammar (n)
godra|joined; joint; united (adj)
gofedhin|allied; united; ‘friends’ (adj)
gofedhrog|ally (n)
gofel; gofil; gwafel|exactly alike (adj adv)
gofeltha|*similar; like (adj)
gofelthi|exact similarity (n)
gogail; gogel; gogìl; mem|mouth (n)
gol-|to stink (vb)
golairin|rhyme; rime; riming poem (n)
golaudri|deluge; flood (n)
golc; golod|stench; stink (n)
golesta-|to gather (intr.) (vb)
golma|ancient lore; lore; wisdom (n)
golweg; gulweg|*Gnomish man (n)
golwin; gulwin|*Gnomish woman (n)
gomaithri|government (n)
gomintha|together (adv)
gomod; gwamod|community; companionship; fellowship; living together (n)
gomodril|associate; companion; fellow (f.); nun (n)
gomodron|associate; companion; fellow; monk (n)
gomol|the teeth; two rows of teeth (n)
gond|stone (n)
gonn|(great) stone; rock (n)
gonothri(n)|of same kindred (adj)
gontha (Physical Acts and Materials)|memorial; pillar; stele (n)
gontha; nogin|boy (n)
gonthos|great rock (n)
gonwed|rocky (adj)
gor- [ng-]|all; altogether; quite (pref)
gor-; lith-|to die (vb)
goredhin [ng-]|akin; related; sib (adj)
goredhnir; goredhwin|cousin (f.) (n)
goredhweg|cousin (m.) (n)
goredin|*related (adj)
gorin; gwarin|circle of trees (n)
gorn|dung (n)
gorthin|fane; temple (n)
gort|idol (n)
gothfeng|(war-)arrow; a great arrow; an arrow sent as a summons to war (n)
gothnir; gothwin|amazon (n)
gothriol|warlike (adj)
gothri|warfare (n)
gothwen; macha; magru|battle (n)
gothwilm|armistice (n)
goth|strife; war (n)
goveg|just like (adj)
govin(d)riol; govinra; nochinra|long-acorned (adj)
govron; gronoch; nocha|acorn (n)
grail|circlet (n)
grand; ost|town (n)
grann|city; fort; strong place; walled town (n)
gratha-|to fray; to rub; to scratch (vb)
graug; grôg|demon (n)
graus|*female pig; sow (n)
grendi|cousinship; family (in a wide sense) (n)
gresta-|to aid; to help; to succour; to support (vb)
grest|salvation; succour (n)
gretha-; reth-|to preserve; to rescue; to save (vb)
grethron|saviour (n)
grileg|hooped shape; ringed (adj)
grilthi|finger-ring (n)
grim|folk; host (n)
grind; grinn|ankle; wrist (n)
grintha|*red (adj)
grith (grith-)|affection; attention; care (n)
grith-|to attend to; to care; to care for; to mind; to tend (vb)
grithonwed|careful; thoughtful; unselfish (adj)
grondolas; grontholas|oakleaved (adj)
grondos; gronthorn; gronthos|oaktree (n)
grondrui|oakwood (n)
gronduru|oakwood (mat) (n)
grosgen; groth|soil (n)
grothorf; podod|potato (n)
groth|earth (n)
gruigarm|*deed of horror; angry or violent act; vengeance (n)
gruithodwen|barbarity; ferocity (n)
gruithod|ferocious wrath (n)
gruithog|ferocious; mad with wrath (adj)
gruith|angry or violent act; deed of horror; vengeance (n)
grui|ferocity; horror (adj)
grôn|oak; oaktree (adj)
grûd; rodos|cavern (n)
grûda|cave (n)
gudh-|to be hot (intr.) (vb)
gudhrin|burning hot; inflamed (adj)
gudhriol|inflamed; inflammatory (adj)
gudhri|conflagration; inflammation (n)
guig|piece of property (n)
guin (adj, Possession and Trade)|held; own; possessed (adj)
guin (adj, Time)|ready (adj)
guin; gwein (n)|*woman (n)
guinir|slave (n)
guinog|chattel (n)
guinoth|property (n)
guira-|to possess (vb)
gui|already; just; just now; only just (adv)
gul-; ulna-|to ooze (vb)
gulin|(lit.) burdened; enduring; long suffering; patient (adj)
gulta-; ultha-|to pour out (tr.) (vb)
gultha-|to balance it on scales; to be worth; to bear up; to endure; to value or be equivalent to; to weigh (vb)
gum-|to lade (vb)
gumlaith|depression; grief; weariness of spirit (n)
gumriol|burdensome (adj)
gumri|burden (metaphoric); trouble; worry (n)
gund; gwelaith; gweleth; hunn|boil (n)
gund; hunn|pus (n)
gunn|?dragon (n)
gurmir|*(lit.) sweet wine; drink of the Valar (n)
gurth(u)|death (n)
gusta-; husta-|to burn (tr.); to destroy (vb)
gw-; u-|negative prefix (pref)
gwada-|to roam; to travel (far); to wander (vb)
gwadath(wen)|journey; wandering (n)
gwadhra|habitable (adj)
gwadhril|inhabitant (f.) (n)
gwadhron|inhabitant (m.) (n)
gwaidhin|web (n)
gwaidhi|a rime (i.e. the 2 actual rhyming words) (n)
gwaid|companion; kinsmen; relations (n)
gwailtha-|to air; to expose to air (vb)
gwail|air (n)
gwais|kinship; relation (n)
gwaith (gwaith-)|semen (n)
gwaith; gweith; gwiaith; hoth; nos|people (n)
gwalest|concourse; folkmote; moot (n)
gwalir|rime (n)
gwaltha-|to bless; to send good luck to (vb)
gwaltha; gwalwed|fortunate; happy (n)
gwalthi; gwalwen; gwalweth|happiness (n)
gwalt|any providential occurrence or thought; good luck (n)
gwam|gust of wind (n)
gwandra; gwanin|beautiful (adj)
gwandreth; gwanthi; gwanwen; gwanweth|beauty (n)
gwanos|birth; heredity (n)
gwanthi|a fair face; fairness; pretty (n)
gwant|beautiful; fair; loveliness (adj n)
gwar(e)dhir|comrade; f. companion (n)
gwar(e)dhon; gwardhos|comrade; m. companion (n)
gwar- (Sense Perception)|to guard; to watch (all senses) (vb)
gwar-|*to dwell (vb)
gwarestrin; tirin; tirion|watch-tower (n)
gwarest|-ship; cousinhood (n)
gwareth|guard; vigilance; ward; watch (n)
gwarieg|warden; watchman (n)
gwarth|dead (only of persons) (adj)
gwassiol|loud; noisy; rushing; rustling or splashing (adj)
gwass|noise of rushing; rush; rushing (n)
gwast; rû|dwelling (n)
gwavwed|windy (adj)
gwe-|2nd-plural pronoun; you (plural) (pron)
gwectha-|to generate; to impregnate (vb)
gwed-|to bend (intr.); to turn; to wind (vb)
gwedhweg|intricate; meandering; twisting; winding (adj)
gwedhwin|bend; loop (n)
gwedhwion|bending; looping (adj)
gwed|*brook; small river (n)
gwef|louse (n)
gwegrin|masculine (adj)
gwegri|manhood (time or state) (n)
gwegwed|male (adj)
gwegweth|male sex; manhood (state) (n)
gwegwin|hermaphrodite (n)
gweg|male of the Elda; man (n)
gweithiad|folk; nation (n)
gwel-|to boil; to bubble (intr.) (vb)
gwelaith; gwelc; gweleth|bubble (n)
gweleb|cool; fresh (esp. of water) (adj)
gweltha-|to press; to squeeze (vb)
gwelwi|spring of water (n)
gwem; terch; tereg|worm (n)
gwembel; gweml(i)|weevil (n)
gwen(n); gwent|big; fine; large (adj)
gwenedh|womanly? (adj)
gwenithli|maidenhood (n)
gwenniniol|girlish; maiden(ly) (adj)
gwennin|girl (n)
gwent (n)|brook; small river (n)
gwer-|to bend (tr.); to turn; to weave; to wind (vb)
gwerb(e)lin|*(lit.) wind-unwind; top; whirligig (n)
gweron|cylindrical; rounded; spun (adj)
gwert; lûgi|a twist (n)
gwes-|to greet; to welcome (vb)
gwesol|affable (adj)
gwest (Social Relations)|greeting; salute; welcome (n)
gwest; gwîs|entertainment (n)
gwesta-|to entertain (vb)
gwethlir|song of welcome (n)
gwethli|little girl; maiden (n)
gwethra-|to bloom; to flourish (vb)
gwethrin; gwethriol; maiwethrin|welcome (adj)
gwethrin; gwethriol; tuvrin; tuvriol|acceptable (adj)
gwi-|bi-; di-; twi- (pref)
gwiaith|men (n)
gwidh-a-ging|cobweb (n)
gwidh-|to weave (tr.) (vb)
gwidhin|woof (n)
gwidhon|woven (adj)
gwil-|to float; to sail (vb)
gwilbrin; gwilvrin|butterfly (n)
gwilbriniol|like a butterfly (adj)
gwilb|full of peace; peaceful; quiet (adj)
gwilith|breeze (n)
gwilm|cessation; peace; quiet; rest (n)
gwiltha-|to cease; to leave off (vb)
gwilthi; gwîl|peace (n)
gwilw|peaceful; quiet (adj)
gwimla-|to twinkle; to wink (vb)
gwimpel|scintillation; sparkling (n.) (n)
gwim|spark; wink (n)
gwin; nîr (Mankind)|woman (n)
gwinc; sint; tim|spark (n)
gwindod|elder tree; elderberry (n)
gwineth; gwinwed|female (adj)
gwingil|foam maiden; mermaid (n)
gwingli|loom (n)
gwing|crest; foam; wave-crest (n)
gwiniel|lady (n)
gwiniol|feminine (adj)
gwinios|womanhood (time or state) (n)
gwinlaith|womanhood (time) (n)
gwinn; gwith|net (n)
gwinta-; thê-|to see (vb)
gwintha-|to face (vb)
gwint|face (n)
gwinweth|female sex; womanhood (state) (n)
gwin|female (n)
gwiog; gwion; gwiw; gân|young (adj)
gwionert|deed of valour (n)
gwir-|to look (at) (vb)
gwiril|*spindle (n)
gwirith|countenance; expression; fixed look; look; look (on face); regard (n)
gwirn|unwelcome; unwished for (adj)
gwirtha-|*to not to wish; to mean not to; to not mean to (vb)
gwirthol; uirol; uthairiol|reluctant (adj)
gwirth|reluctance; unwillingness (n)
gwir|lord; master; possessor (n)
gwista-|to be ignorant of; to not to know (vb)
gwist|weft (n)
gwithadr; gwithant|shuttle (n)
gwâd|foreigner; stranger; traveller (n)
gwâs|juice (n)
gwâ|wind (n)
gwîl|cessation; leaving off; quiescence (n)
gî(laith)|in past; once (adv)
gîrin|ancient; belonging to former days; bygone; former; old; olden (adj)
gîr|yesterday (n)
gôbi|large hound (n)
gôf|fruit (esp. of tree) (n)
gôf·clochiol|stone-fruit (n)
gôg|clumsy; left (hand) (adj)
gôl|daylight (n)
gôma-|to nickname (vb)
gôma|by name; nicknamed (adv)
gôm|call; nickname (n)
gôr|all; each (adj)
habach|big shoe; clog; sabot (n)
habin|shoe (n)
hacha|buttocks; the hams (n)
had-|back; for-; in return for; instead of (pref)
hada-|to aim at; to throw at (vb)
hadang; hadung|(lit.) hurling iron; javelin (n)
hadha-|to abide with patience; to cleave to; to cling; to wait for; to wait on (vb)
hadhol|abiding; constant; enduring; faithful (adj)
hadra-|to face; to oppose; to resist; to stand in way; to thwart (vb)
hadra|equivalent; facing; opposing; opposite (adj)
hadron|opposite (prep adv)
hadruithog|thirsting for vengeance (adj)
hadruithol|vengeful (adj)
had|(c. allative) against; as; facing; for; in return for; instead of; opposite; over against (prep)
hag-|to sit; to sit down (vb)
hagra|seated (adj)
hai (adv, Spatial Relations)|there (by him) (adv)
hai (adv, Time)|early; in good time; punctually (adv)
hai (interj)|away; begone; go!; hence (interj)
haid; haig|road; way (n)
haidra|in good time; punctual; timely (adv)
haidri|after breakfast; forenoon (n)
haim; haithin|departed; gone; lost (adj)
haimadri|elevens; food in morning; lunch (adj)
hair|in good time; punctual; timely (adj)
haitha-|to fare; to go; to hie (vb)
haiva|(as av.) away; be off; begone; hence; hence!; off (interj)
hal(a)-|to drag; to draw; to pull (vb)
halcha-|to drag on ground (roughly) (vb)
halm|draft; draught; drawing (of fishes etc.) (n)
halthi|sheath (n)
hamra-|to abase; to abash; to humble oneself (vb)
hamra|base; lowly; lowlying (adj)
ham|ground; level of Earth’s service [surface] (n)
hanna-|to cleave; to mow (vb)
hant (adv)|thither (adv)
hant (n)|cast; throw; turn or move in games (n)
hantha-|to aim at; to direct; to fling; to hurl (vb)
harach|she-wolf (n)
hara|flesh meat; meat (n)
harc|flesh (on a living body) (n)
harog; harw; ulug; urc|wolf (n)
has-; hath-|beside; by; close to; touching (pref)
hasta-|to pause; to stay; to stop; to tarry; to wait (vb)
hast|pause; rest; stop; wait; waiting (n)
hau-|to lie (vb)
haugrin|humble; lowly; mean (adj)
haug|low (adj)
haus|bed (n)
hautha-|to lay; to lay flat on ground; to stretch out (vb)
hauthwaid|consort; wife or husband (n)
hauthwais|conjugal rights (n)
heb-|to bind; to bind round (vb)
hebon|(also) bounded; bound; surrounded (adj)
hebrim|bound(ary) (n)
hebwirol|circumspect (adj)
heb|around; round about (prep)
hel-; heltha-|to freeze (vb)
helc; heleg|ice (n)
helc; helw (adj)|cold; ice-cold; icy (adj)
helfileg|etc.; frost on panes (n)
helfin(n); helfingl|icicle (n)
helon|frozen (adj)
heloth; hîl|frost (n)
heltha-|to congeal (tr.) (vb)
hemp|a band; bond; cord (n)
hen; thed|eye (n)
hent|eyesight (n)
herma|lordship; protection; sway (n)
hermin|tutelage (n)
hermon; hiron; hiros; indor; innor; malc|lord (n)
hesc|chill; chilled; dead; withered (adj)
hest|*sibling; brother or sister; †consanguinity (n)
heth (adj)|pallid; wan; white (adj)
heth (n)|brother or sister (n)
hetheglon|daisy (n)
hethir|sister (n)
hethos|brother (n)
hethren|first cousin (m.) (n)
hethres|first cousin (f.) (n)
hethrin|consanguine; of the same family (in a close sense) (adj)
hilming|heritage; inheritance (n)
hilmir|heir (m. or f.) (n)
hilm|offspring; one’s descendants; posterity; progeny (n)
hiltha|youth (more often masculine) (n)
hirilwen|anxiety (n)
hiril|princess; †queen (n)
hiriol|anxious (adj)
hiron; hiros|guardian; master; overseer (n)
hirtha-|to care; to care for; to mind; to reck; to tend (vb)
hirthol|attentive; careful (adj)
hista-; hitha-|to hearken; to listen; to listen to (vb)
hist|attention; listening (n)
hith|listen! hark! (interj)
ho(n)-|grandson of (pref)
hodhir; ûna|hope (n)
horoth|age; eld; oldness (adj)
hortha-|to grow old (vb)
horweg|an ancient; old man (n)
hosta-; lactha-|to collect (vb)
hothri; hothrim|army (n)
hothron|captain (n)
hoth|folk; †army (n)
hugin|young pig (n)
huil|*female dog; bitch (n)
huir|foggy (adj)
huith; usb; usc; usg|fog (n)
huitha-|to it is misty (vb)
hum(i)los; humethla; humloth|(red) poppy (n)
hum-|to drowze; to sleep (vb)
humiol|drowzy; sleepy (adj)
hum|(lit.) to bottom; (right) down (adv)
hunc|pig (n)
huniol|bony; rawboned (adj)
hunt|nose; nostrils; snout (n)
hyrost|*dawn (n)
hîr|anxiety; care; heed (n)
hôm|base; bottom; ground; seabed (n)
hôr|aged; ancient; old (adj)
hôth (hôdh-)|expectation; hope (n)
hûbi; saur|hound (n)
hûm; lorwen|sleep; slumber (n)
hûn|bone (n)
hûs|crowd; heap; pile; very great number (n)
hû|dog (n)
hŷr|sun (n)
ictha-|to agitate; to arouse; to egg on; to excite (vb)
idhr(a); ind(r)|a long time; long (adv)
idhraluin; in(d)raluin|long ago (adv)
idhril; idhwin|*Man (f.) (n)
idhrog; idhweg|*Man (m.) (n)
idhruglin|the language of Men (n)
idra-|to prize; to value (vb)
idra|dear; precious; valued (adj)
idreth|dearness; value (n)
idri; îd|jewel; thing of great worth; treasure (n)
idril; melethli|sweetheart (n)
idrisaith|excessive love of gold and gems and beautiful and costly things (n)
igin|agitated; excited (adj)
igli|small fry; young of fish (n)
igol|excitable; exciting (adj)
ig|ado; excitement; fuss (n)
il(d)rim|disease; disturbance; unquiet (n)
il-|the opposite; the reversal (pref)
ilbar|the uttermost region beyond the world (n)
ilbrant; ilvrant|rainbow (n)
ilbrin|fat; greasy; oily (adj)
ilgioth|sterility (n)
ilm|fat; grease; oil (n)
ilrimog|uneasy (adj)
ilt(h)a-; ilt-|to yoke (vb)
ilta-|to prick; to prod; to stick in (vb)
iltanc|unsteady (adj)
ilwi(n)|heavens (n)
ilwint|(lit.) face of god; heavens (n)
im|fairy (n)
in(d)ra|long (also used of time) (adj)
in(d)wed|at home; domestic(ated); homely; indoors (adj)
in-|house of (pref)
inc; migin; pinig|little (adj)
inco|the identical; the same (pron)
ind; inn|abode (n)
indor; innor|master (of house) (n)
ing|fish (n)
inna; int|in home; to its house/its right place (adv)
inni|at home; home; in right place (adv)
int; rada (n)|track; way (n)
intha- (Motion and Transportation)|to fare; to go (indefinite); to proceed (vb)
inthi|less (adv)
inthorn|eagle’s nest; eyrie (n)
inweg|*fairy (male) (n)
inwin|*fairy (female) (n)
in|go; move; occasion; turn (n)
iolinc|lambkin; little lamb (n)
iol|lamb (n)
ior; ioroth; thorn|eagle (n)
irm|a wish; intention; resolve (n)
irn|desired; wished for (adj)
irtha-|to peck (vb)
irtha|her (pron)
irthod|intent; intention; will (n)
irthol|intentional (adj)
irt|beak (of small birds) (n)
ir|dative and allative (prep)
ista-|to be aware; to feel; to know; to perceive (vb)
ist|feeling; notion; sensation (n)
ith (Physical World)|fine snow (n)
ith; itheg (Grammar)|anything (n)
ithog|any (adj)
ithrin; ithriol|of any kind (adj)
ithweg; ithwin|anyone (n)
ivangod; ivongod|walnut (n)
ivogodron|walnut tree (n)
ivrin|fertile (adj)
i|the (article)
laboth|a hare (n)
labra|flapping; lax; loose; weak (adj)
lactha-|to (tr.) gather together; to amass (vb)
lada-; lôda-|to beguile; to caress; to smooth out; to soothe; to stroke (vb)
ladinios|equity (n)
ladin|equitable; fair; level; smooth (adj)
ladog|tin (n)
ladwen|flatness; heath; levelness; plane (n)
lad|a flat; a level; fair dealing (n)
laf|end of rope; hem of robe; loose-end (n)
lag-|to gather up; to get; to pick up (vb)
laib; laibrin; laug|green (adj)
laigos|greenness; verdure (n)
laim|rope; thong (n)
lais|glade; green sward (n)
laith (adj)|*lost (adj)
laith (n)|(properly) lapse; the course of time; time (n)
laith(r)a-|to (intr.) to be lost; to forget; to let slip; to lose; to mislay (vb)
laithra|dead and gone; forgotten; former; of yore; over (adj)
lalm; larm|elm; elm-wood (n)
lalmir|elm tree (n)
laltha-; tinta-|to dance (vb)
lalt|dance (n)
lam|speech; tongue (n)
lanc|chance; choice; pick; selection (n)
land; lann|broad (adj)
lang-|to blare; to clang; to ring (vb)
langon|great bell (n)
lantha-|to alight; to fall onto; to settle on (vb)
lant|(high) road; level way; street (n)
laptha-|to loosen; to relax (vb)
las-|to glance at; to look at (vb)
lasgweloth|autumn; leaf-fading (n)
lass|leaf; petal (n)
lasta-|to blink; to wink (vb)
last|flash of the eye; glance; look (n)
laub|shirt (n)
laud|flood; high tide; motion of the sea; tide (n)
laug|(of plants) alive; having sap; vigorous (adj)
laur|darkling; foreboding; threatening (adj)
laus|(aj.) fresh; energy; juice; sap; vitality (n adj)
lauthra-|to refresh; to revive (intr.) (vb)
lauth|a plant; herb (n)
lav-|to lick (vb)
lavra-|to lap (of animals); to suck up (vb)
leb-|to cull; to pick; to pluck; to take or feel or touch with fingers (vb)
lech (adj)|slippery; smooth (adj)
lech (n)|slide; smooth place (n)
lectha-|to sharpen (vb)
lemfadrin|of the finger; ring (adj n)
lemfin|halved; in half (adj)
lemp (Body Parts and Functions)|crooked finger; little finger (n)
lemp (Quantity and Number)|half (n)
lempa-|to beckon; to crook the finger (vb)
lempachùn|wishbone (n)
len (adj)|arrived; come (adj)
len (adv)|away; far; long; wherewith (adv)
lenchos|distance (n)
lenc|distant; far (adj adv)
lendri; lenthos|arrival; coming (n)
lendriol; lenthol|approaching; coming (adj)
lentha-|to come towards speaker; to draw near (vb)
lent|(c. dat.) at; along side of; close to; near; therewith; towards; up by; up to side of; with it; withal (adv)
lenu-|to extend in length; to stretch; to trail (vb)
lenweg|a stranger; ‘arrival’ (n)
lenwin|a stranger (fem.); ‘arrival’ (n)
lenwi|distance; length (n)
lepthadrin; lepthindros|of fingers (adj)
leptha|finger (n)
lesta-|to assemble; to meet (intr.) (vb)
lethrin|peril(o)us; slippery (adj)
leth|therewith; with it; withal (adv)
le|and (prep)
lib-|to drip (vb)
libli|small drop; small glass (n)
lib|drop; gout (n)
lieglest|a folk moot (n)
lieg|the citizens; the folk (n)
ligindon|blare of trumps (n)
ligin|curved horn; trump (n)
lillir|a song; lullaby (n)
lim (adj)|many (adj)
lim (n)|bundle; sheaf (n)
limfa; limfelis; limp(elis)|drink of the fairies (n)
lin-|to sound (intr.) (vb)
lind|twine (n)
lingwir; ulug|dragon (n)
ling|small snake (n)
lintha-|to play an instrument; to sound (tr.); to strike or ring bell (vb)
linthanin|playing or music of instruments (n)
lint|agile; light; nimble; quick (adj)
lin|sound (n)
lir-; lul-; rala-|to sing (vb)
lisc; lisg|reed; sedge (n)
liscaloth|reed grown; reedy (adj)
lista-|to bless (vb)
list|favour; grace; kindness (n)
lith-|to be over; to depart; to end; to finish; to go (vb)
lithin|bygone; ended (adj)
lithra-|to become silent; to cease speaking (vb)
li|and; with (prep)
lob-|to gallop (of animals); to run (vb)
lobrob|gallop; sound of horse’s feet (n)
lobros|horse; steed (n)
loctha-|to curl (tr.); to tie knot; to twine; to wind (vb)
loctha|coil; spiral; tendril; twist (n)
loda-|to gulp down; to swallow (vb)
log-|to bend (intr.); to curl (intr.); to twine; to wind (twine round anything) (vb)
logrifidhrin; logrifindel|curly haired (adj)
logrin|curled; curly (adj)
lomiol|dismal (adj)
lonc|curl (n)
lor-|to dream (tr.); to sleep deep (vb)
lorc|dreamy; drowsy; lazy (adj)
lortha-|to put to sleep; to send to sleep (vb)
losbas|ryebread (n)
losc; losg|rye (n)
loss; lost|bloom; blossom (n)
lothli|floret (n)
lub|fat; fat flesh (n)
lud-|to float; to flow; to stream (vb)
luibri; luist|thirst (n)
luib|thirsty (adj)
luim; luin|blue (adj)
luin|ago; gone; past (adj adv)
luista-|to be thirsty; to dry up; to parch (vb)
luis|blooming; florescence (n)
luitha-|to bloom; to blossom (vb)
lui|blueness; livid mark; livor (n)
lul-|to hum a lullaby (vb)
lulwi|a lullaby (n)
lumba; lumbrin|overcast (adj)
lumbri|foul weather (n)
lungra-|to bear on; to hang heavy; to weigh (vb)
lung|grave; heavy; serious (n)
lunta|ship (n)
luntha-|to balance; to weigh (vb)
lunthang|balance; scales (n)
lur-|to frown; to scowl (vb)
lurc|a frown; scowl (n)
lust; lûm|time (n)
lust|tide; weather (n)
luv-|to hang; to lower (of clouds) (vb)
lu|occasion; time (n)
lâ|place; room; space (n)
lî|a crowd of folk; folk; many people; ‘they’ (n)
lómin|gloom(iness); gloomy; shadowy; shady (adj n)
lôg|firewood; fuel (n)
lôm|gloom; shade (n)
lôs|flower (n)
lô|lake (n)
lûda-|to bloom; to grow (vb)
lûgi|a wind; deceit; guile (n)
lûr|slumber (n)
lûtha-|to come to pass; to occur; to pass (of time) (vb)
mabinos|plane tree (n)
mablad; mablod|palm of the hand (n)
mablios|cunning (adj)
mabol|skilful (adj)
mabrin(d)|wrist (n)
mabwedri|dexterity (n)
mabwed|dextrous; handed (adj)
mab|hand(s) (n)
mactha-|to kill; to slay (vb)
mad-|to eat (vb)
madheg|something (n)
madhin|some (adj)
madhir|someone (f.) (n)
madhon|someone (m.) (n)
madrin; madriol|edible; fit for food; wholesome (adj)
madri|a meal; edibles; food (n)
magli|great sword (n)
magruluib; magrusaig|bloodthirsty (adj)
magruluist; magrusaith|bloodthirstiness (n)
maien; mairien|better (adj)
maig; maiglos|thirst (adj)
mail|flour (n)
maimelion|dearly beloved (adj)
main|better (adv)
mairos|long hair; mane (n)
mais; mechor|gore (n)
maitha-|to govern; to hold; to rule; to wield control (vb)
maithog|having control (adj)
maithri|control (n)
maith|permission; power; rule (n)
maivenin|shapely (adj)
maiwest|welcome (n)
mai|well (adv)
mal (adj)|anguish; evilness; pain (adj)
mal (n)|paved way; road (n)
mal-; nag-|to chew (vb)
malcos|a province or principality; lordship; power (n)
malcrin; malcwed|lordly; noble (adj)
malc|powerful; rich (adj)
maloglin; maroglin|daffodil; yellow song (n)
malogrintha|orange; tawny (adj)
malon|yellow (adj)
maltha|golden yellow; mellow; rich (adj)
malthos|butter cup (n)
mam|grandmother (n)
manca-|to grab; to seize (vb)
manc|grasp; grip; hold (n)
mandra|noble (adj)
mang|butter (n)
mani|good (of men and character only) (adj)
manos|spirit that has gone to the Valar (n)
mar(o)n|ripe (adj)
mara; marol|sand (n)
maragwast|earth quake (n)
maros|ripe fruit (n)
mart(os)|fate; lot; portion (n)
martion|doomed; fated; fey (adj)
mar|Earth; ground; soil (n)
masgar|pasture (n)
masta-|to feed; to graze (vb)
mastir|*shepherdess (n)
mast|feed; fodder; food; nourishment (n)
mathrin|dusk; dusky (adj)
mathron|herd; herdsman; shepherd (n)
mathusgi|twilight (n)
mathwen|evening (n)
maudra-|to be early; to be preferred; to come first; to prefer (vb)
maudrimad|breakfast (n)
maudrin; maurin|betimes; early; premature; up early (adj)
maudri|early morn before dawn; time before first meal (n)
maudro|earlier; rather; sooner (adv)
maugli|hidden; secret (adj)
maug|silent (adj)
maul|bellowing; the lowing of cattle (n)
maur|dream; vision (n)
maus|pleasant; pleasant taste; pleasure (n adj)
mau|early; soon (adv)
mav-|to like (vb)
mavlant|*palm (of hand) (n)
mavra|eager after (adj)
mavrin; mavrothwed|delectable; delightful; desireable (adj)
mavri|appetite (n)
mavrog|eager (adj)
mavros|desire; eager longing (n)
mavuin; mavwin; mavwen|ancestress; †mother (n)
mawr; mora|good (adj)
ma|with instrument or by agent (prep)
me-|1st-plural pronoun; we (pron)
mectha-|to aim at; to intend; to mean (vb)
mectha|goal; intention (n)
mecthos|meaning (n)
meg|(esp.) mole; any small animal (n)
mel-|to love (vb)
melethli|darling (n)
melethril; melethron|lover (n)
meleth|love (n)
melon; meltha|dear (adj)
miaug|tomcat (n)
miaulin|she-cat (n)
mib; mibli|little kiss; peck (n)
mictha-|to bill (vb)
miginthi|littleness (n)
mim|gum (n)
mindon; minthon; tirin; tirion|tower (n)
mineth|island (n)
mintha|in one place; together; ūna (adj)
min|one; single (cardinal)
miog; mui|cat (n)
mirobin|grape (n)
mirofor|drink of the Gods (n)
miros; mîr|wine (n)
mirwelthin|vintage (n)
mod; tant|a number (n)
modog|*a large number (adj)
modra-|to count; to measure (vb)
modri|measurement (n)
modrog; modron|rich man (adj)
modwen|a large number (adj)
mod|figure (n)
mog-|to detest; to hate (vb)
mogrin|hateful (adj)
mogri|detestation (n)
molnaith|molar (n)
morc|black mark; dirty; smut; stain (n adj)
mord|man; †shepherd (n)
morth; mûri|darkness (n)
mortha|dim (adj)
mort|champion; hero; man; †shepherd (n)
moth(in); mothwen|1000; †flock (n)
mothweg|shepherd (n)
moth|sheep (n)
mu; mutha|am about to; am going to; will (prep)
mug-|to keep silent; to say nothing (about) (vb)
mugli|calf (n)
mugol|taciturn (adj)
muig|gentle; soft (adj)
muil|tarn (n)
muin (adj)|safe; secure (adj)
muin (n)|cattle; kine (n)
muinos; uchir|security (n)
muir; muthli|heifer (n)
muis|gentleness; softness; tenderness (n)
mul-; mum-|to bellow; to low (vb)
mumla-|to gibber; to stammer (vb)
mumloth|stuttering (n)
mumol|gibbering; inarticulate; stammering (adj)
munc|(aj.) mum; secretiveness; shut mouth; silence (n)
mur-|*to slumber; to sleep (vb)
murc|a nightmare; vision of the night (n)
murtha-; olma-; oltha-|to dream (vb)
musc|grey (adj)
muthra-|to veil (vb)
mâd|meal (n)
môl|the (inside of the) mouth (n)
môna; môni|spirits of the air (n)
môn|bare hill; knoll (n)
môs|food (of men) (n)
mô|hand (n)
mútha-|to (c. gen.) leave the place of/time of/speaker; to depart; to go; to go forward; to leave (vb)
mû; tarog|ox (n)
mûm|lowing (n)
mûri|†night (n)
mûst|byre; cowhouse (n)
mûs|cow (n)
na-|to be (vb)
nab-|to lay hold of; to take (vb)
nabos; naboth|seizure (n)
nactha-|to bite (vb)
nacthanaith|incisor (tooth) (n)
nad; nân|*thing (n)
naf-|to have inkling of; to suspect (vb)
nafa; nôf|inkling; suspicion (n)
nafol|suspicious (subjective) (adj)
nafra-|to nose about in others’ business (vb)
nag-|to gnaw (vb)
naith; sanc|tooth (n)
naitha-|to lament; to make moan for; to wail for; to weep (vb)
naithol|miserable (adj)
naithonwi|misery (n)
nal (adv)|down; downwards (adv)
nal; tumli (n)|dale (n)
nalairin|iris (n)
naldron|lower down (adj)
nalos|a slope; descent; setting; sinking (n)
naltha|(av.) below; beneath; downward; lower; lower-down (adj)
nam-|to (intr.) withdraw; to draw back; to draw out; to retire; to take back; to withdraw (vb)
nanc|bite (n)
nand; nann|field acre (n)
nandor|farmer (n)
nandriol|rural; rustic (adj)
nandri|the country (as opposed to town) (n)
nanweg|*farmer (n)
naptha-|to seize (vb)
narcolas|Autumn; the fall of the leaf (n)
narcos|decay; rot (n)
narp|corrupt; decayed; overripe; rotten (adj)
narthiel|fragrance (n)
narthol|fragrant; odorous (adj)
nast|being (abstract); being (creature) (n)
nathanwi|fatherhood (n)
nathrin|possible (in sense possible to exist or think of); real (adj)
naudra-|to abash; to make ashamed (vb)
naud|abashed; ashamed; bashful; bent; bowed (adj)
naug; naugli|dwarf (n)
nauglafel|(lit.) dwarf-natured; avaricious; mean (adj)
naugla|of or belonging to the dwarves (adj)
nauin|dwarf (adj)
naur (adj)|grumbling; ill-tempered; sour (adj)
naur (n)|a snarl; ugly grin (n)
naus|keen-witted; notice; observant (adj n)
nautha-|to give a hint to; to hint at (vb)
na|of (the) (prep)
necha|woe (n)
nectha|honey comb (n)
neglis|honey (n)
nelu-|to ring (tr. and intr.) (vb)
nel|end; jutting end; tip (n)
nen(n); sîr|river (n)
nendil; nennil|waterfay (n)
nermil|a fay that haunts the meadows and riverbanks (n)
nern|brook (n)
nerthi|manhood; manliness; virtue (n)
nerthog|doughty; stout; vigorous (adj)
nert|a feat; prowess; strength (n)
ness|long grass; water meadow (n)
nesta-|to feed; to graze; to pasture; to put to grass (vb)
nethli|little meadow; long lush grass (n)
nethron; thang|herd (n)
ni-|1st-singular pronoun; I (pron)
nib|snowflake (n)
nictha-|to hail; to rain (vb)
niel; siel|granddaughter (n)
nien(n); nîn|tear (n)
nifedhin|outcast; outlaw (adj n)
nig(la)|mouse (n)
nig-|to creep; to do or go by stealth; to steal (vb)
nigla-|to pilfer; to thieve (vb)
nigor|rain; rainy weather (n)
nigrim|to swarm (n)
nigrin|stealthy (adj)
nigweth|(snow) storm (n)
nigwin|rainy (adj)
nilta-; niltha-|to empty (tr.) (vb)
nimp|pallid (adj)
nim|blue green; pale blue (adj)
ninconin|snowdrop (n)
nind; ninn|blue stone; turquoise (n)
ninghonin|*snowdrop (n)
ninion|water lily (n)
ninios|dropping of tears; lamentation (n)
ninna-; nintha-; sibra-|to weep (vb)
nio(s)|bee (n)
niogrim|swarm (n)
nion|bee; grandson (n)
niosturwin|queen bee (n)
niost|hive (n)
nirnaithos|great lament (n)
nir|grandchild of (pref)
nitha|a candle (n)
nithla|candlestick (n)
nith|wax (n)
niwin|female bee (n)
ni|without (both senses) (prep)
no-|again; back; re- (pref)
nobra-|to follow; to go after (vb)
nobromath; nuimath; nuimoth|first signs of dawn; ‘second twilight’ (n)
nobron|next following; the second (n)
nodro|again; farther on; further forward; later (adv)
nod|forward; in advance; on (adv)
nogin|lad; urchin (n)
nogra-|to exceed; to excell (vb)
nogrin; nogriol|conspicuous; excellent (adj)
nog|hill; prominence (n)
nontha|the next; the succeeding (time only) (adj)
nor-|to roll; to run (vb)
norn|wheel (n)
northa-|to send rolling; to speed (vb)
nosc; noth|damp; wet (adj)
nosied|kinsman (n)
noss; noth; ubri; uch (Physical World)|rain (n)
noss|birthday (n)
nosta-|to be born (vb)
nosteg|birth (adj)
nost|birth; birthday; blood; high birth (n)
nos|kin (n)
nothri; rest|kinship (n)
nothrin|highborn noble (adj)
no|after(wards); again; next; then (adv)
nud-|to bend face down; to incline head (vb)
nudin; nûda|prone (adj)
nuf-|to get smell of; to perceive scent of; to smell (tr.) (vb)
nufleg; nuthleg|keen-nosed (adj)
nufli; nufri|sense of smell (n)
nuidro|still later (adv)
nuin|born (adj)
nuiri; obauthri|afternoon (n)
nui|afterwards; again; later (adv)
num-|to decline; to descend; to sink; to slope down (vb)
numbros|incline; slope (n)
nunta-|to assent (vb)
nunthi|downward (adv)
nur-|to growl; to grumble (vb)
nurna-|to bewail; to complain of; to lament (vb)
nurn|a complaint; lament; plaint (n)
nus-|to perceive; to take notice (vb)
nusimos; nusiothli|sagacity (n)
nusiol|sagacious (adj)
nybol|?snowy (adj)
nâla|yellow-lily (n)
nîr (Emotion)|grief; sorrow (n)
nîriol|sad; sorrowing (adj)
nôl|head (n)
nôn|the morrow; the next day on from one mentioned or in thought; tomorrow (n)
nôs|birthday; nature (n)
nûda|face down (adj)
nûmin|sinking; the west (adj)
nûn|a nose (of men only) (n)
nûr|easy; easy going; rolling free; smooth (adj)
nûth|scent; ‘wind’ (n)
o-|he (conj)
obaidra-|to avenge; to expiate (crime) (vb)
obin|next; second (adj)
obra-|to follow; to succeed (vb)
obra|close behind (of place); following; next behind or after (time or place); succeeding (adj)
obromath|just before dawn; the twilight that follows the night; ‘second twilight’ (n)
obron|*next (adv)
obruith|(evil) consequences (n)
ob|after; close behind (time and place) (prep)
ocha|fleece (n)
ochlad; oglad|week (n)
och|egg (n)
octha|knee (n)
od (prep)|against; at; up to (prep)
od; og|sharp corner (n)
odinthos|seventeen (cardinal)
odin|seven (orig[inally] many) (cardinal)
odog|exceeding; very; violent (adj)
odra-|to am able; to can (vb)
odra|very (adv)
odrim|(very) many (adj)
odrog; odron|a brave man; brave; dour; mighty; stout (adj n)
og-; ogra-|to be able; to can (vb)
ogor|ability; might; power (n)
ogra|able to (prep)
ogriol|possible (adj)
ol-|to appear (vb)
ol; ôla|cliff; seaward precipice (n)
oland|motion of sea; tide (n)
olaud; olod|motion of the sea; tide (n)
olf(in); olfin(g)|stick; wand (n)
olm; olor; oloth|dream (n)
olor; oloth|apparition; vision (n)
oltha-|to appear as an apparition (vb)
omla|a horse chestnut (n)
omlos|(horse) chestnut tree (n)
ongos|anguish (n)
ong|great pain (n)
ontha|his (pron)
on|he (pron)
or-|in addition to; on; onto; up (pref)
orc|goblin (n)
orcômin|fierce and bloody minded (adj)
orfing|pear (n)
orf|apple (n)
ormagodron|a (Spanish) chestnut tree (n)
ormagod|a (Spanish) chestnut (n)
orm|hill top; summit (n)
orod; ort|mountain (n)
oros; orost; rosta|rising (n)
orthi|up (adv)
or|(av.) on; (prep.) on; on top; onto (adv prep)
osp(a)|foam (n)
ospa-|to foam; to seethe; to spout (vb)
ospathol|ebullient (adj)
ospoth|froth (n)
oss|moat; outer wall (with moat); town wall (n)
ost (n)|enclosure; yard (n)
ost (pron)|yourselves (pron)
osta-|to build up; to fortify; to protect; to surround; to surround with walls (vb)
ostor|circuit of walls; enclosure (n)
oth|ye (pron)
pactha-|to speak; to talk; to utter (vb)
padhra-; pasta-|to flay; to peel; to skin (vb)
paga|court; paved floor (n)
paglant|a pavement (n)
paglos|parchment (n)
pagra-|to pave (vb)
pagri; pagros|pavement (n)
paib|sour (adj)
paithri|a speech; speech; talk (n)
paithron|orator (n)
paithwen|oratory (n)
palta-; throsta-|to beat (vb)
paltha|blade (of swords, knives, oars, etc.); page of book; wide flat leaf (n)
pand|book (n)
panta-|to arrange; to order; to place; to put; to set; to write a book (vb)
pant|arrangement; book; grouping (n)
pan|arrangement; place; settlement; spot (n)
paptha-|to quiver; to tremble (vb)
past|skin (n)
path|fine bark (paper); peel; skin of fruit (n)
pau|a beard (n)
pecthon|feather (n)
peleg|axe (n)
pelu-|to enclose; to fence (vb)
pel|-ham; hamlet; village (suf)
pibinaith(ros); pinaithros; tadhos|hawthorn (n)
pibin|haw; small berry (n)
pictha-; pigla-|to make urine (vb)
piectha-|to pin; to prick (vb)
pieg|pin (n)
piglin|urine (n)
pigwa; pigwed|bitter (adj)
piligwathil; pilingwathil|feathering of an arrow (n)
pilon|arrow; dart (n)
pim|any small round thing; bead; seed (n)
pinig|tiny (adj)
plador; plados|oar (n)
pleg|hedge-stake; stake (n)
pless; tath|fence; hedge (n)
podra-; ponta-|to retrace; to turn back; to turn round (vb)
polc|fat; thick (adj)
polm; polwin|strength (physical) (n)
polmog; polwed|strong (physically) (adj)
polod|authority; might; power (n)
pont|reverse or far side; the back (n)
porogog|the clucking and noise of fowls (n)
porogwil; uil|hen (n)
porog|fowl (domestic) (n)
pridu-|to decide (vb)
pridwen|judgment (n)
pridwir|judge (n)
prind|distinction (n)
pruin|charcoal (n)
puibra-; puidra-|to cleanse; to soap (vb)
puictha-|to clean; to condone; to do away with; to forgive; to pardon; to wipe out (vb)
puig|neat; tidy (adj)
puim|soap (n)
pui|child (n)
puthli|baby (n)
pâ-|to put (vb)
pî|a bit; anything very small; mote (n)
ractha-|to shatter (vb)
ractha; ranc|breach (n)
rag-|to break asunder; to burst (vb)
raibrog; ribrog|zebra (n)
raibros|(female) zebra (n)
raib|scored; striped (adj)
raig|awry; distorted; leering (of face); perverse; twisted (adj)
raim|border-line; edge (n)
raina-; rin-|to return (vb)
rain|anniversary; year complete (n)
raitha-|to extend (intr.); to reach; to reach at; to reach for (vb)
raith|district; extent; reach; region; scope; sphere (n)
rala-|to carol; to trill (vb)
ranc|burst (n)
ranoth|month (n)
rantha|arch; bridge (n)
ras-|to toast (vb)
rasc|toast(ed bread) (n)
rath|a measure = 2 feet; one’s reach; the extent of one’s arm; the full arm (n)
raug|rushing; swift (adj)
rausta-|to chase; to hunt; to pursue (only in actual sense of following game) (vb)
raust|chase; hunt (n)
rautha-|to chase; to hunt; to pursue (vb)
rau|lion (n)
redhin|related (adj)
redhos|land (n)
redhweg|cousin [m.] (n)
redhwin|cousin [f.] (n)
ren(d)|cousin (m.); relative (n)
ress|cousin (f.); relative (n)
resta-|to aid; to support (vb)
restu|abroad; away from home; out of land (adj)
rest|aid; help; support (n)
ribin|edged; striped (adj)
rib|border; fringe; line; shore; stripe (n)
rictha-|to confuse; to contort; to disarrange; to twist; to upset (vb)
rig-|to contort; to twist (vb)
rig|a snarl; a sneer (n)
rim (n adj)|calm; peace; peaceful; quiet; quietness (n adj)
rim (n)|border; fringe; line; stripe (n)
rimin|calm; edged; peaceful; quiet; striped (adj)
rimp|shred; slice; sliver (n)
rin-|to come back; to do again; to revolve (vb)
rinc|circular; disc; rondure (adj n)
ring|cold; cool (adj)
rinta-|*to return (vb)
rodrin|cylindrical (adj)
rod|stem; tube (n)
rogli|little pipe (especially musical) (n)
ront|steep (adj)
rosta|ascent; uprising (n)
rost|ascent; hill side; slope (n)
roth|cave; grot (n)
ruf-|to tear (vb)
ruim|mysterious (adj)
ruitha-|to whisper (vb)
rusg|oatcake (n)
rust|cultivation; inhabitation; tillage (n)
ruthla|oaten (adj)
ruthli|oats (n)
râ|arm; strength (n)
rî|a sudden breeze or cold breath; cool; coolness (n)
rô-|to endure; to remain; to stand; to stay (vb)
rôg|doughty; strong (adj)
rôl|a song (n)
rôn (Body Parts and Functions)|liver (n)
rôn (Possession and Trade)|clasp; embrace (n)
rôs (Time)|endurance; gentleness; meekness (n)
rôs; rôtha-|embrace (n)
rôs; rûs; ômgulwen|patience (n)
rô|docile; enduring; gentle; long suffering; quiet (adj)
rû; rûm|mystery (n)
rûdin|cavernous (adj)
rûs|endurance; long suffering (n)
rûtha-|to remain (vb)
sabli|shovel; spade (n)
sachwen; saiwen|midsummer (n)
sactha-|to fight (vb)
sad-|to care; to consider; to esteem; to reck; to show respect for; to value (vb)
sagruin|ferocious; full of hate towards (adj)
sagruith; thanc|hatred (n)
saib|boot (n)
saichwed; sairin|fiery (adj)
saictha-; saitha-|to have hunger (vb)
saidhon|noon (n)
saigri|famine; hunger (great) (n)
saig|hungry (adj)
sair; urin|hot (adj)
saith|hunger (n)
salca-|to scythe or mow (vb)
salc|ensilage; green cut grass (n)
salfinc|spoon (n)
salf|basin; bowl (n)
salta|a game (n)
salum|*harp (n)
sam-|to adjust; to arrange; to put together; to reconcile (vb)
sam; samin|arranged; done; settled (adj)
samri|arrangement (n)
samtha-|to settle a matter legally (vb)
sana-|to can; to craft or skill; to have knowledge; to know how to (vb)
sanc|jag (n)
santha-|to declare; to make known or clear; to point out; to show (vb)
santhi|experience (in) or skill (in); knowledge (n)
saptha-|to bite into (vb)
sara-|to ait (vb)
sard|table (n)
sarn|a stone (n)
sarofarn|the seashore (n)
saros|sea; surf (n)
sarothod; sarothwad|(lit.) foreigner from overseas; seafarer; voyager (n)
saroth|sea (n)
sath|ten (cardinal)
saul|great wind (n)
saur|wild dog (n)
sauth|a hole; tunnel (n)
sectha-|to aim at (vb)
secthadron; segron|midmost (adj)
sectha|centre (n adj)
segrin|middle (adj)
seg|middle point (n)
sempios|(lit.) *red-berry; holly (n)
sentha|russet (adj)
sen|brown-red; russet (adj)
seth; suib; tarf; tarp; thisc|dry (adj)
sethra-|to dry up (vb)
si(n)-|granddaughter of (pref)
sibra-|to whimper (vb)
sigweth|lamentation; weeping (n)
sigwithiel|lamentation; weeping willow (n)
silc|flint (n)
sinc|metal (n)
singrin|salt (adj)
sing|salt (n)
sinta-|to sparkle (vb)
sin|*here (adv)
sion|grandson (n)
siptha-; tif-|to whistle (vb)
siriol|flowing; fluent; melliflous (adj)
sirp|straw (n)
sitha (adj)|this (adj)
sitha (n)|fly (n)
sithagong; sithaling|dragonfly (n)
sithaling|fly snake (n)
soctha-|to give to drink; to quench (vb)
socthor; sogli; sogridâr|a drinking-horn (n)
sog-|to drink (vb)
soros|ash-tree (n)
sovriel|purification (religious) (n)
sovri|cleansing (n)
sui; suil|daughter (n)
suitha-|to dry; to wipe (vb)
suithlas|tea (n)
suithli|towel (n)
suith|draught; drink (n)
sulus|air-spirit (n)
suss (interj)|hush (interj)
suss (n)|hush; sudden quiet (n)
suthra-|to hush; to make or go quiet (vb)
sâd|riches; wealth (n)
sâ|fire (n)
sî|bead; small gem or pearl (n)
sô-|to bathe; to wash clean (vb)
sôm|custom; law; rule (n)
sôn (adj)|pure (adj)
sôn (n)|craft (n)
sôr|billow; wave (n)
sûr|long; trailing (adj)
sûtha-|to blow (of wind) (vb)
sû|noise of wind (n)
tab-|to cut to shape; to fashion (vb)
tag-|to construct; to fix; to make firm (vb)
taglos; tagor; tagros; ûr; ŷr|smith (n)
tair|gaze; guard; look-out; regard; watch (n)
taitha-|to teach (vb)
taith|a letter; mark; sign (n)
talc|upright (adj)
taleg; taloth|(foot)path (n)
talgrin(d)|ankle (n)
talpa-|to buttress up; to prop up (vb)
talpon|a slender pillar (n)
talp|prop; support (n)
taltha|base; foot (of things); pedestal; pediment (n)
tambin|of copper (adj)
tambos|cauldron (n)
tambrin|like copper (adj)
tam|copper (n)
tanc|firm; settled; steady (adj)
tand|enclosure; garden (n)
tanga-; tantha-; tusta-|to set light to (vb)
tangar; tangor|hearthgrate (n)
tanta|a dance (n)
tan|firewood (n)
tarc|root (especially edible roots) (n)
tarf; tarp|stale (adj)
tarnon|porter (n)
tarn|gate (n)
taru (adj)|horned (adj)
taru (n)|cross; crossing (n)
tast (Quantity and Number)|amount; total (n)
tast (Spatial Relations)|border; fringe (n)
tath-|to count (vb)
tathna-|to count; to number; to reckon (vb)
tathn|number (n)
tathrin|willow (n)
taudha|phosphorous (n)
tauga|convenient; fitting; suitable (adj)
taul|pillar (n)
taur (Body Parts and Functions)|ability; power (n)
taur (Physical World)|dense wood or forest (n)
taura|powerful (adj)
taus|shaggy (adj)
tavor|wood fay (n)
tavros|wooded land (n)
teb|neb; nib; nose (n)
tectha-|to write (vb)
tefla-|to scorn (vb)
teflarol; tefra|abject; mean (adj)
teglath|feast year; noted year; special year (n)
teglos|awning (n)
teg|dot; spot (n)
teilian|mockery (n)
teilin|stunt or jest (n)
teld; telm; telthon; telum|roof (n)
telfod|final end; the very last (n)
teloth|canopy; roofing; shelter (n)
teltha-|to cover in (vb)
telthion; telwed|protected; roofed in; sheltered (adj)
telt|lid (n)
telu-|to close; to end; to finish (vb)
telu|end (n)
tenc|nib; pen (n)
tentha-|to feel with the feet; to walk on tiptoe (vb)
tent|toe (n)
teraith|destruction; ruin; waste (n)
tercha-; tertha-|to destroy; to devour (vb)
tess(il)|little flower; †maiden (n)
teth; thed|bud (n)
tethla-|to bud (vb)
tethlas|*(lit.) bud-leaf; petal (n)
thaf; thafwen|hay (n)
thafwen|harvest (n)
thaigra|choice; elegant; select (adj)
thaig|choice (n)
thairin|magic (adj)
tham|chamber; room (n)
thanc|loathing (n)
thang|a crowd; crush (n)
thar-|to saw (up) (vb)
tharm; thram|saw (n)
thasc|shaven (adj)
thasgim|(lit.) shave-blade; *razor (n)
thastril|razor (n)
thast|shaving (n)
thas|thy (pron)
thathri|sawdust; shavings (n)
thegin|chief; leading (adj)
thegla|first lights of dawn (n)
thegor|chief (n)
thegra|first; foremost (adj)
ther-|to tie (vb)
theres|ribbon; tie (n)
thest|a sight; sight (sense of); vision (n)
thibindon|flute-playing (n)
thibinweg|piper (n)
thibin|flute (n)
thig-|to choose; to pick out; to select (vb)
thimli|piccolo; whistle (n)
thimpa-|to play a flute or whistle (vb)
thimpion|a piper (n)
thimp|the stop on a flute (n)
thim|milk (after separation) (n)
thin-; thinta-|to skim (vb)
thinc|a bunch; a choice; a pick; posy (n)
thisc|waterless (adj)
thisin|parched; withered (adj)
thista-|to dry up (tr.) (vb)
thithrin|dusty (adj)
thith|dust (n)
thlib-|to lap up; to suck; to sup (vb)
thlibri|soup (n)
thlid-|to discriminate; to sieve; to sift; to sort out (vb)
thlidhra|gracile; ‘willowy’ (adj)
thlid|sieve (n)
thlim|kind; race; sort; species (n)
thlind|fine (adj)
thloth|breakers; surf; waves (n)
thol-|to roll (vb)
tholos (Motion and Transportation)|axle of a wheel (n)
tholos|sea-marge (n)
thothri|black magic (n)
thoth|evil enchantment of magic; spell (n)
thrad|a plank; board; shelf (n)
thred|knot (n)
thribin|lean (adj)
thripthon|stem (n)
thrond|(eyrie); pinnacle (n)
throthriol|wizardous (n)
throth|beat (of oars, wings, etc.) (n)
thuctha-|to adhere to; to cleave (vb)
thugli|resin (n)
thug|?resin (n)
thuif; thuith|any adhesive substance; resinous juice (n)
tibli|sleet (n)
tifin|small flute (n)
tigla-|to prick (vb)
tiglas; tiglath|remorse (n)
tilithli|little elf (n)
tilithril|f. elf (n)
tilithrin|elfin (adj)
tilithron|m. elf (n)
timpa-; timpintha-|to jingle; to ring; to tinkle (vb)
timpi|little bell (n)
timp|hoot; note of a flute (n)
tim|(star); gleam (n)
tinc|a flicker (n)
tintiltha-|to twinkle (vb)
tinwin|a small star (n)
tinwithli|constellation; group of stars; star-cluster (n)
tion|a straight line (n)
tir-|to await; to expect; to look (out) for; to watch for (vb)
tirin; tirion|turret (n)
tisca-|to tickle (vb)
tisc|ticklish (adj)
togli|cap (n)
tol|isle (with high steep coast) (n)
torc|a sear; mark of a burn (n)
torn|dark-brown; sunburnt; swart (adj)
torod|violent (adj)
tram|bridge (n)
tranc|at cross purpose; criss-cross; cross; crossed; perverse (adj)
trantha-|to cross (tr. and intr.); to mark with a cross (vb)
trath|ford; passage (n)
tricthon|(fibrous fine) root (n)
trug|convenient; docile; easy to handle; tractable (adj)
trôn|a cross; a crossing (n)
tub-|to cover (vb)
tubla-|to hide (intr.) (vb)
tubrin|hidden (adj)
tufrin|fluffy (adj)
tuf|down; fluff (n)
tug-|to arrive; to be convenient; to chance on; to find; to fit; to hit; to light on; to occur; to reach mark; to suit; to ‘do’ (vb)
tuig|sapling; shoot; sprout (n)
tuilir|spring(time) (n)
tuim|steam (n)
tuitha-|to gush; to spring; to sprout (vb)
tul-|to bring; to come to; †to support (vb)
tulga-|to comfort; to confirm; to make firm; to steady (vb)
tulog; tulug|firm; steady (adj)
tultha-|to carry; to lift (vb)
tumbol|excavated; valley-like (adj)
tumla-|to excavate; to hollow out (vb)
tump|shed (n)
tum|hollow (n)
tunc|arrival; chance; hit at shooting; luck; occurrence (n)
tund|log for the fire (n)
tungol|knowing; wise (adj)
tung|a thought; an idea (n)
tur-|to can; to have power to (vb)
turinthir|*queen (n)
turinthi|princess (n)
turioth|kingship (n)
turm|authority; rule; strength (n)
tusc; tustarol|inflammable (adj)
tusc|explosive; irritable; touchy (adj)
tusta-|to burn (tr.); to inflame (vb)
tuthli|match (n)
tuthlos|a teazle (n)
tuth|tinder (n)
tâl (tald-)|foot (n)
târ|horn (n)
tê|line; mark; track (n)
tîf|bitterness; ill feeling; resentment (n)
tîl|cicatrice; healing of a wound; scab (n)
tîr; tûr|king (n)
tîr|esteem; honest (aj.); honour; regard; upright; †straight (adj n)
tî|line; straight (adj n)
tôb(a)|fashion; shape (n)
tôdhi|paddock (n)
tôd|hat (n)
tôg|floor (of a house); storey (n)
tôl|mantle (n)
tôn|fire (on a hearth) (n)
tô|wool (n)
tû-|to become; to get; to receive; to take (vb)
tûm|valley (n)
tûs-|to comb out; to tease wool (vb)
ub (Grammar)|no; none (adj)
ub (Sense Perception)|damp; moist; wet (adj)
ubra-|to rain (vb)
ubri|rainfall (n)
uchirin|secure (adj)
uchirthol|reckless (adj)
uchir|carelessness; recklessness (n)
udathnarol|countless; innumerable (adj)
udathriol|countless (adj)
udrug|intractable; untamed (adj)
uf (n)|down; fine wool (n)
uf (prep)|forth; out of (prep)
uf(f)edhin|one who changes his clan and goes to a new kinship; outcast; outlaw (adj n)
ufedhron|lawless man (n)
ufedhwed|lawless (adj)
ufestog|breathless (adj)
ufra|outer (adj)
ug-|to negative verb (vb)
ugwedriol|awful; ineffable; unspeakable (adj)
uimoth|(lit.) sheep of the waves; whale (n)
uin|whale; †wave (n)
uir-|to mean not to; to not mean to; to not to wish (vb)
uirol|unwilling (adj)
uista-|to not to notice (vb)
uitha-|to lay eggs; to nest (vb)
ul-|badly; ill; miss-; wrongly (pref)
ulcarm; ulcrum|sin (n)
ulcoth|wickedness (n)
ulc|evil; wicked (adj)
ulin|liquid (adj n)
ulm|flagon; jar (n)
uluch; uluchnir; ulugwin|she-dragon (n)
ulvon|*monster; giant (n)
um (adj)|lowlying (adj)
um; umin (pron)|we (pron)
umbart; umrod|fate (n)
umbath; umboth|nightfall (n)
umbel; umli|a dell (n)
umir|no one (fem.); nobody (n)
unath; unt|nothing (n)
unathriol|impossible; unreal (adj)
unaudrathrol|shameless; unabashed (adj)
unc (n)|ear; handle (of a jar) (n)
unc (pron)|ourselves (pron)
ungathos; unthos|eighteen (n)
ungra|eighth (adj)
untha|no; none (adj adv)
unweg|no one; nobody (n)
uptha-|to shout (vb)
urf|apple (tree) (n)
urin|very hot (adj)
urm|brazier; grate (n)
urna-|to blaze; to burn (intr.) (vb)
urtha-|to devise; to fashion; to make; to work; to wreak (vb)
urthu|*death (n)
us-; usta-|to depart; to leave (vb)
usb; usc; usg|mist (n)
usfeg-|to release (vb)
ust|cloudy air (n)
uthairiol|unintended; unintentional (adj)
uthra-|to escape; to get away (vb)
uthwen|escape; exit; way out (n)
uvin|eight (n)
u|no; nor; not (adv)
yrin|made (by craft of hand) (adj)
áugwila|sunlit; sunny (adj)
âl|wood (material) (n)
í|indefinite indeclinable relative particle (pron)
îr-|to be willing; to intend to; to mean to; to will (vb)
ôf|hood (n)
ôl (Agriculture and Vegetation)|bough; forearm (n)
ôl (Spatial Relations)|height; stature (n)
ômgulin|patient (adj)
ôm|mind; thought (n)
ôn (Possession and Trade)|gift (n)
ôn (Spatial Relations)|crown of head; top (n)
ôr|dry sand (n)
ôs|bog (n)
ôth|hole; opening (n)
ô|the sea (n)
û-|to not to be; to not to do (vb)
ûgrin|muddy (adj)
ûg|mud (n)
ûl|a ghost (n)
ûmi|large (adj)
ûm|voice (n)
ûna-|to hope (vb)
ûtha-|to emit; to issue (vb)
ûthi|outside (n)
