(a)larca|rapid; swift (adj)
(a)ranya; mirima|free (adj)
(a)vaháya|*far away (adv)
(ec)coiru-|to come to life (vb)
(nai)naina-|to lament (vb)
-(n)dil; -dildo; -iel; -nil; -nildo (Emotion)|-friend (suf)
-(n)dur|*servant (suf)
-(u)va|future suffix (suf)
-(á)re; -nde; -ste|general action verbal suffix (suf)
-alima; -ima|-able; -ible; able to be done (suf)
-ando|agent (male) (suf)
-a|adjectival suffix (suf)
-el; -ser|friend (suf)
-ello; -llo|ablative element (suf)
-esta|*close grouping (suf)
-i; -r|plural suffix (suf)
-iel; -ien (Mankind)|daughter (suf)
-ien; -ndor|-land (suf)
-ie|abstract noun; gerund suffix; perfect suffix; stative suffix (suf)
-ina|adjective suffix; passive participle (suf)
-inqua|*-ful; complete (suf)
-ion|-son (suf)
-ite; -maite|(verbal) adjective ending (suf)
-le; -me; -sse|abstract noun (suf)
-li|plural (suffix) (suf)
-lya; -rya|imperfect participle (suf)
-lóra|less; without (suf)
-ma|instrumental (suf)
-mo; -ro|agental suffix (suf)
-ndon|as; like (suf)
-ndo|*agent (male) (suf)
-nta|to become or be made (suf)
-nwa|perfective adjective (suf)
-nye|I (suf)
-n|genitive suffix (suf)
-on (Grammar)|great (suf)
-on; -we (Mankind)|masculine suffix (suf)
-o|*genitive ending (suf)
-rasta|twelve (suf)
-re|gerund (suf)
-rin|-ian; language; racial-adjective (suf)
-r|*archaic allative (suf)
-sse|locative ending (suf)
-sta (Grammar)|*noun suffix (suf)
-sta; -tta (Quantity and Number)|close grouping (suf)
-ta|causative (suf)
-tur|lord; master; victor (suf)
-ula|apt to; aptitude); likely to do so; verbal adjective (likelihood (suf)
-umne|future-past (suf)
-va|adjectival (suf)
-voite|adjective suffix (suf)
-we|abstract suffix (suf)
-ya|adjective suffix; aorist active participle; general verbal adjective (suf)
Aini|angelic spirit (f.); holy one (n)
Ainu|angelic spirit; holy one (n)
Aldarya|*Tuesday (n)
Alfírimo|Immortal (n)
Ambar|Earth; World (n)
Anar (Anár-)|Sun (n)
Anarya|(lit.) Sun-day; Sunday (n)
Atan|Man (n)
Cermie; Nólairë|July (n)
Earenya|*Thursday; Sea-day (n)
Ea|all that is; the World (n)
Elda; Quen; Quende|Elf (n)
Eldalie|Elf-folk; People of the Elves (n)
Eldarin|Elvish; of the Elves (adj n)
Elenya|*Star-day; Saturday (n)
Ercoire|*First-stirring; February (n)
Erlaire|*First-summer; June (n)
Erquelle|*First-autumn; September (n)
Erríve|*First-winter; November (n)
Ertuilë|*First-spring; April (n)
Eru|The One God (n)
Fírien|Winter (n)
Hísime [þ]|*Misty-one; November (n)
Isil [þ]|(lit.) Sheen; Moon (n)
Isilya [þ]|*Monday; Moon-day (n)
Lótesse|*(lit.) Flower-ness; May (n)
Menelya|*Wednesday; Heavens-day (n)
Metelaire|*(lit.) End-summer; August (n)
Meterríve|*(lit.) End-winter; January (n)
Narquelie; Nóquelle|October (n)
Narquelion|Autumn; Fire-fading (n)
Narvinye|*New-fire; January (n)
Nendesse|*Wet-ness; February (n)
Norríve|*After-winter; December (n)
Nárie|*Fire-ness; June (n)
Nócoire|*After-stirring; March (n)
Nólairë|*After-summer (n)
Nóquelle|*After-autumn (n)
Nótuile|*After-spring; May (n)
Quenderin|Quendian (adj n)
Quendya|Elvish (n)
Quenya|Elf-latin; Elfspeech; Elvish (Tongue); Quendian; belonging to the Qendi (n)
Rana|(lit.) Wayward; Moon (n)
Ringare|*Coldness; December (n)
Súlime [þ]|March (n)
Tuilear|Springdays (n)
Tárinar|*alternate name of Valanya (n)
Valarya|*Friday; Vala-day (n)
Vala|God; Power (n)
Vanimo|Fair Folk; The Beautiful (n)
Víresse|*Freshness; April (n)
Yavannie|*Yavanna-ness; September (n)
aha|rage (n)
ahto|maker; wright (n)
ahtumat|supper (n)
aiano|stranger (n)
aica; laica|sharp (adj)
aicale; antaro; mintye|peak (n)
aicasse|mountain peak (n)
ailin|lake; pool (n)
aina|holy (adj)
aiqua|steep (adj)
aira|copper-coloured; red; ruddy (adj)
aire; airen; earen; vea|sea (n)
aista-|to dread (vb)
aiwe|(small) bird (n)
ai|maybe; suppose; supposing (adv)
al(a)-|negative prefix; not (pref)
al-|to thrive (vb)
ala-|to grow (vb)
ala; are|day (n)
alaco|rush; rushing flight; wild wind (n)
alalme; lalme|elm-tree (n)
alan; arie|daytime (n)
alaninquitálima|that cannot be made white (again) (adj)
alanwa|adult; fully grown; mature (adj)
alasse|joy; merriment (n)
alat-|great in size; large (pref)
alcar(e)|brilliance; radiance (n)
alcarinqua|glorious; radiant (adj)
alca|ray of light (n)
alcárima|impossible to make (adj)
aldarwa|having trees; tree-grown (adj)
alda|tree (n)
alfárima|impossible to pursue (adj)
alfírima; ilfirin|immortal (adj)
alistima|secret; unknowable (adj)
alla|hail! (interj)
almare; almie|blessedness; blessings; bliss; good fortune (n)
alma|*well-being; good fortune; weal; wealth (n)
almárea; alya; herenya; mána|blessed (adj)
alqua|swan (n)
alquettima|unutterable (adj)
alta-|to (make) grow (vb)
altancanta-|to become unfixed (vb)
alta|great in size; large (adj)
alwara|*worthless; useless (adj)
alwa|well-grown (adj)
alya|abundant; prosperous; rich (adj)
alómea; ómalóra|voiceless (adj)
am(ba)penda|uphill (adj)
am-|up (pref)
aman; núte; vére|bond (n)
amatixe|dot or point placed above the line of writing (n)
ama|up (adv)
ambale|yellow bird; yellow hammer (n)
ambal|flag [stone]; shaped stone (n)
ambar (ambart-)|fate (n)
ambaróne|Orient; sunrise; uprising (n)
amba|up(wards) (adv)
ambo; taras; tundo|hill (n)
ambon|hill-side; upward slope (n)
ambor|breast (n)
amil; amme|mother (n)
ammale|yellow bird; ‘yellow hammer’ (n)
ampana-; ampanóta-; car-|to build (vb)
ampanotalea|architectural (adj)
ampanotaste|architecture (n)
ampano|building (especially of wood); construction; edifice; wooden hall (n)
ampanóta-|to construct; to erect a (large) building (vb)
ampa|crook; hook (n)
ampende|upward slope (n)
an(a); na|to; towards (prep)
an(ner)|at hand (adv)
an-|intensive prefix (pref)
ana-|to; towards (pref)
ananta|and yet; but yet (conj)
anaróre|sunrise (n)
anca|jaw; row of teeth (n)
andalúme|for a long while (adv)
andamunda|elephant (n)
andatehta|long mark (n)
andatelco|long leg; long stem (n)
andave|*long (adv)
anda|long (adj)
ando (adv)|long (adv)
ando (n)|door; gate (n)
andon (andond-)|great gate (n)
andul|long pole (n)
andólama|long consonant (n)
andúne|sunset (n)
angaina|of iron (adj)
anga|iron (n)
ango (angu-)|dragon; snake (n)
angulóce; lungu; lóce|dragon (n)
anna|gift (n)
anquale|*death agony (n)
anta-|to give (vb)
antaro|high mountain (n)
anta|face (n)
ante|giver (f.) (n)
anto (Possession and Trade)|giver (m.) (n)
anto; assa; pé (Body Parts and Functions)|mouth (n)
anwa|actual; real; true (adj)
apsa-; auta-|to away; to go away (vb)
apsa|cooked food; juice; meat (n)
ar-|beside; outside (pref)
aran; haran; tár|king (n)
aran; seldo (arn-)|child (n)
aranaite|*kingly; royal (adj)
aranyalle|*kingdom (n)
araníe|kingship (n)
arat (arak-)|weed (n)
ara|beside; outside (prep)
arca|narrow (adj)
arda|realm; region (n)
arinya|early; morning (adj)
arin|morning (n)
armar|goods (collective-noun)
arta|fort; fortress (n)
artuile|dayspring; early morn (n)
arwa|having; in control of; possessing (adj suf)
arya|day (twelve hours) (n)
aryon; hilde|heir (n)
ar|and; but (conj)
ascat-; saccat-|to break asunder; to rend (vb)
asea [þ]|*healing herb (n)
asea aranaite [þ]|*kingsfoil (n)
assa|hole; opening; perforation (n)
asto (astu-)|bone (n)
asto; mulo|dust (n)
astula|bony (adj)
at(a)-|again; back; re- (pref)
atalta-|to collapse; to fall down; to fall in; to slip down in ruin (vb)
ataltare|collapse (n)
ataque|building; construction (n)
atar|father (n)
ata|*(lit.) a second time; again (adv)
atintila-; tintila-|*to sparkle (vb)
atsa (Clothing and Adornment)|fringe; fryse; tassel (n)
atsa (Spatial Relations)|catch; claw; hook (n)
atta|two (cardinal)
atto|father (hypocoristic) (n)
attul-|to come back; to return (vb)
atwa; tanta|double (adj)
au(ve)|might (have); would (have) (adv)
au-; ava-|without (pref)
aule|invention (n)
auta- (Mind and Thought)|to devise; to invent; to originate (vb)
avahaira|*far beyond; very remote (adj)
avanóte|numberless; without number (adj)
avaquet-|to forbid; to refuse (vb)
ava|beyond; exterior; outer; outside (adv adj)
axa|edge; narrow path; ravine (n)
a|indefinite subject; it; one (pron)
cacarra-|to keep on doing (vb)
caila|bedridden; lying in bed; sickness (adj)
caimasan [þ] (kaimasamb-)|bedchamber (n)
caimasse; líve; quáme|sickness (n)
caimassea|bedridden; sick (adj)
caimasse|lying in bed (n)
caima|bed (n)
cainen|ten (cardinal)
caita-|to lie (vb)
cala; calma|light (n)
calarin(a)|*brilliant (adj)
calima|*bright (adj)
calina|light (adj)
callo|hero; noble man (n)
calma; calumet|lamp (n)
calmatéma|k-series (n)
calpa-|to bale out; to draw water; to scoop out (vb)
calpa|bucket; water-vessel (n)
calta-|to (cause to) shine; to kindle (lamp etc.); to light up (vb)
calya-|to illuminate (vb)
cambe|hollow (of hand) (n)
camparu|?flea (n)
canta (cardinal)|four (cardinal)
canta (n adj)|frame; shape; shaped (n adj)
canta-|to shape (vb)
cantea|shapely (adj)
cantele; lindale|music (n)
canya|bold; wise (adj)
cap-|to leap (vb)
capsa; cas|case; vessel (n)
capta-|to make spring; to scatter (vb)
car (kard-) (Dwelling and Furniture)|building; house (n)
car (kard-) (Physical Acts and Materials)|deed (n)
car-|to do; to make (vb)
caraite; caramaite (karaiti-)|able to make; craftsmanlike; crafty; handy; skilled (adj)
caranya-|to make red; to redden (vb)
caraste|construction; making; manufacture (n)
caraxe|jagged hedge of spikes (n)
carca; nelce; nele; nelet|tooth (n)
carcane|row of teeth (n)
carie|making (n)
carina|made (adj)
carino-|to get finished/made (vb)
carne (karni-)|red (adj)
cas; cár (kas-)|head (n)
cassa; harna; harpa (n)|helmet (n)
cas|towards the top; upwards (adv)
cata|after (prep)
cato|afterwards (adv)
cav-|to be able (vb)
celma|channel (n)
celu-|to (begin to) flow; to spring forth (of water) (vb)
celulinde; tuile (kelulindi-)|spring (n)
celume|flow; stream (n)
celure|fountain (n)
celuste|outflow (n)
celut; siril|rivulet (n)
celya-|to (lit.) to send running down; to rain (vb)
cemen|Great Lands; earth; soil (n)
cemnaro; centano|potter (n)
cemna|earthen; of earth (adj)
cen-; cenya-|to see (vb)
cesta-|to ask (vb)
ce|you (sg) (pron)
chus-|to come up; to emerge (vb)
cilya|chasm; cleft; gorge; pass between hills (n)
cim-; hir-; tuv-|to find (vb)
circa|sickle (n)
cirisse|gash; slash (n)
ciryahto|shipwright (n)
ciryasta-|to sail (vb)
cirya|boat; ship (n)
ciuca; noa; tiuco; tyúca|thigh (n)
coire|Stirring (n)
coita-|to be alive; to have life; to live (vb)
colma|ring (?on finger) (n)
corco|crow (n)
corin|circular enclosure (n)
corna|globed; round (adj)
coromindo|cupola; dome (n)
coron (corn-)|ball; globe (n)
costa-|to quarrel (vb)
cotumo; untamo|enemy (n)
cotya|hostile (adj)
cucua|dove (n)
cucumba-|to (lit.) keep on bowing; to nod repeatedly (vb)
cuile|being alive; life (n)
cuina|alive (adj)
cuive; cuivie|awakening (n)
cuivea|wakening (adj)
culda; culina|flame-coloured; golden-red (adj)
cullo|red gold (n)
culo; nár(e)|flame (n)
culuina|golden; of gold; orange (coloured) (adj)
culuma|orange [fruit] (n)
culu|gold (metal) (n)
cumba|*bellied (adj)
cumbe|heap; mound (n)
cumna; lusta|empty (adj)
cunduina|of princes; princely (adj)
cundu|prince (n)
curwe; tanwe|craft (n)
cuv-|to bow (vb)
cáne|valour (n)
cáno|chief (n)
cárima|able to be made; feasible (adj)
cáro; tyaro|actor; agent; doer (n)
cén (kem-)|earth; soil (n)
cénima|able to be seen; visible (adj)
cóma|*ball (n)
cúma|void (n)
cúvima; cúvula|flexible (adj)
cúvula; maxa|pliant (adj)
cú|bow (n)
ea-|to be; to be found extant in the real world; to exist; to have being (vb)
eare|(open) sea (n)
earuile|seaweed (n)
ear|(open) sea; water (n)
easte|being; essence (n)
eccaira|?out-far (adj)
eccoita-|to awake (vb)
ecco|point; spine; thorn (n)
ef-|to emerge (especially from water) (vb)
ehta-|to stab (vb)
ehte (*ehti-)|spear (n)
ehtele|issue of water; spring (n)
ehtelu-|to bubble up; to well (vb)
ehtyar|spearman (n)
elen; elena; ellen; él|star (n)
ella|for you; of you (pron)
elle|2nd pl emphatic (pron)
elloa|next year (n)
en; es (end-)|far away; in that (future) case; look yon(der); that; there; yonder (pron adv)
enar|tomorrow (n)
ence|spear point (n)
ender|bridegroom (n)
ende|centre; core; middle (n)
enga|*except; save (prep)
enge|ago; once (in past); †it was (adv)
engwa; laiwa|sickly (adj)
enna (n)|fact (n)
enna; esta; inga (adj)|first (adj)
enne|purpose; thought (n)
ennie|*being (female); person (female) (n)
enno|*being; person (n)
enque|six (cardinal)
enta|that yonder; then (fut.) (pron adv)
enwa|existent; fact; real; true (adj n)
enya|middle (adj)
enyáre|in that day (adv)
erca-; nasta-|to prick (vb)
ercasse; erce|holly (n)
erca|prickle; spine (n)
erde (Agriculture and Vegetation)|germ; seed (n)
erde (Spatial Relations)|repose (n)
eressea|lonely (adj)
eresse|solitude (n)
erume|desert (n)
erya|only; single; sole (adj)
er|alone; one (adj adv)
esce|noise of leaves; rustle (n)
esse (Language and Music)|name (n)
esse (Time)|beginning (n)
esse; men (Spatial Relations)|place (n)
essea (Quantity and Number)|?primary (adj)
essea (Spatial Relations)|in place; local (adj)
esta- (Language and Music)|to name (vb)
esta- (Spatial Relations)|to place; to plant; to set (vb)
esta- (Time)|to precede (vb)
estaina|named (adj)
et-|forth; out (pref)
etse|exterior; outside (n)
etsir|mouth of a river (n)
etta|his (pron)
ette (adj adv)|outside (adj adv)
ette (pron)|he (emphatic) (pron)
ettelea|foreign (adj)
ettele|foreign parts; outer lands (n)
ettul-|*to come forth; to come out; to issue (vb)
etya|exiled (adj)
et|out of (prep)
e|he; it; she (pron)
fafarra-|*to keep on hunting (vb)
faica|contemptible; mean (adj)
faina-|to emit light (vb)
faire (Body Parts and Functions)|natural death (as act) (n)
faire (Sense Perception)|radiance (n)
falasse; fára|beach (n)
falle; vinge|foam (n)
falmar(in) (falmarind-)|nymph; sea-spirit (n)
falma|(crested) wave (n)
fanga|beard (n)
fanya|sky; white (n adj)
fara-|to hunt (vb)
farale; faraste; roime|hunting (n)
farastea|*of prey; of the chase (that it is proper to hunt) (adj)
faraste|the chase (n)
faren|enough (adv)
farina|fugitive; hunted (adj)
farino|fugitive; hunted man; outlaw (n)
farma|?carpet (n)
farme; fáre|all that is wanted; plenitude; sufficiency (n)
farna|prey; quarry (n)
farne|foliage (n)
farya-|to suffice (vb)
fas (fass-)|border; fringe (n)
fasse|shaggy lock; tangled hair (n)
fasta- (Body Parts and Functions)|to tangle (vb)
fasta- (Emotion)|to please (vb)
fasta|pleased (adj)
fauca|(lit.) open-mouthed; parched; thirsty (adj)
fealóce|spark-dragon (n)
felya; rondo; rotto|cave (n)
fenda|threshold (n)
feren; ferne (fern-)|beech-tree (n)
ferinya|beechen (adj)
ferna|beechnuts; mast (n)
feuya-|to abhor; to feel disgust at (vb)
filet; líne (filek-)|cobweb (n)
filince|*finch (n)
filit (filik-)|small bird; sparrow (n)
finde|braid of hair; tress (n)
fine|larch (n)
fion (fiond-)|?hawk or haste (n)
fir-|*to fade (vb)
fire|mortal man (n)
firin|dead (by natural cause) (adj)
firya|human (adj)
formaite|dexterous; righthanded (adj)
formenya|northern (adj)
formen|north; right hand (n)
forte (forti-)|right or north (adj)
forya|dexter; right (hand) (adj)
fuine|deep shadow (n)
fána|cloud; white (adj n)
fára|shore (n)
fárea|enough; sufficient (adj)
fírima|mortal (adj)
fírimáre|mortality; the state of being mortal (n)
hahta|(piled) mound; heap; pile (n)
haime|habit (n)
haira|far; remote (adj)
haiya; háya|far away; far off (adv)
halatir(no) (halatirn-)|(lit.) fish-watcher; kingsfisher (n)
hala|(small) fish (n)
halda (Physical World)|hidden; shadowed; shady; veiled (adj)
halda; halla; tunda (Spatial Relations)|tall (adj)
halla (Body Parts and Functions)|naked (adj)
halma; helma|fell; skin (n)
halya-|to conceal; to screen from light; to veil (vb)
ham-|to be situated in; to sit (down) (vb)
hamma; handa|chair (n)
hamu-|to sit down; to take a seat (vb)
hanaco; norsa [þ]|giant (n)
hana|post (n)
handa (adj)|intelligent; understanding (adj)
handasse|intelligence (n)
handele|intellect (n)
hande|knowledge; understanding (n)
hando|agent (male) (n)
hanuvoite|*masculine (adj)
hanu|male; male animal; man (of Men or Elves) (n)
hanwa|male (adj)
hanya-|to be skilled in dealing with; to know about; to understand (vb)
har-|to abide; to dwell; to reside; to sit (vb)
haran|chieftain; lord or king of a specified region (n)
harda|realm (n)
harma (Possession and Trade)|treasure; treasured thing (n)
harma; huan (hún-)|hound (n)
harma; narmo [ñ-]; ráca|wolf (n)
harmen|south (n)
harna (adj)|wounded (adj)
harna-|to wound (vb)
haro|hawk (n)
harwe (Body Parts and Functions)|wound (n)
harwe (Possession and Trade)|treasure; treasury (n)
harya-|to possess (vb)
haryon|prince (heir) (n)
hat (haht-)|comb; crest; ridge (n)
hat- (Motion and Transportation)|?to throw down (vb)
hat- (Physical Acts and Materials)|to break asunder (vb)
hauta-|to cease; to stop; to take a rest (vb)
ha|it; subjective abstract particle (pron)
he; intin; toi|they (pron)
helca|ice-cold (adj)
helcelimbe|(lit.) ice-drop; *icicle (n)
helce|ice (n)
helda (Body Parts and Functions)|naked; stripped bare (adj)
helda (Emotion)|friendly; having love (for) (adj)
helde; heldo; helmo; málo; nilmo; sermo; seron; sondo|friend (n)
helen (helem-)|icicle (n)
helle|frost; sky (n)
helme; nilme|friendship (n)
helor|frost (n)
helwa|(pale) blue (adj)
helyanwe|(lit.) sky-bridge; rainbow (n)
hen; yé (hend-)|eye (n)
henulca|*evil-eyed (adj)
herenya|fortunate; rich; wealthy (adj)
heren|(lit.) governance; fortune (n)
heri; nissa|lady (n)
heru|lord; master (n)
hesto|captain (n)
hilya-|to follow (vb)
him-; himya-|to adhere (vb)
himba|adhering; sticking (adj)
himya-|to abide by; to cleave to; to stick to (vb)
himíte (himíti-)|able to stick on; clinging (adj)
hinna|still (adv)
hiswa [þ]; sinde [þ]|grey (adj)
hiswe [þ]|fog (n)
hiuta-|to hint (vb)
hlasta-|to hear (vb)
hlic-|to creep (vb)
holme; olme; xenna|odour (n)
holmo|from the middle (adv)
hondo|*hearted (adj)
hont|inwards (adv)
hopasse|harbourage (n)
hora-|to wait for (vb)
horme|urgency (n)
horro; orro (interj)|alas!; ow!; ugh (interj)
horta-; lhit-|to speed (vb)
horta-|to send flying; to urge (vb)
hortale|speeding; urging (n)
horya-|to be compelled to do something; to have an impulse; to set vigorously out to do (vb)
hos; hosto|assembly; crowd (n)
hosta-|to collect (vb)
hosta|large number (n)
ho|from (prep)
hríve|winter (n)
huine|deep shadow; nightshade (n)
humpe|in the middle (adv)
huo|dog (n)
hu|howl (n)
hwan (hwand-)|fungus; sponge (n)
hwarin; raica; rempa|crooked (adj)
hwarma|crossbar (n)
hwesta-|to puff (vb)
hwesta|breath; breeze; puff of air (n)
hwinde|eddy; whirlpool (n)
hwinya-|to eddy; to gyrate; to swirl (vb)
hyalma|conch; horn of Ulmo; shell (n)
hyanda|a throng; crowd (n)
hyando|cleaver; hewer (sword) (n)
hyanna; hyarna|compact; compressed (adj)
hyapat|shoe (n)
hyar-|to cleave (vb)
hyarmaite|left-handed (adj)
hyarmenya|southern (adj)
hyarmen|left hand; south (n)
hyarya|left (hand) (adj)
hyatse|cleft; gash (n)
hyelle; maril|glass (n)
hyóla|trump (n)
héra|chief; principal (adj)
híse [þ] (hísi-)|fog; mist (n)
hó; yello|shout (n)
hón (hom-)|heart (physical) (n)
hópa|harbour; haven; small landlocked bay (n)
hórea|impulsive (adj)
hóre|impulse (n)
hún; mar (hun-)|earth (n)
húna-|to howl (vb)
i (article)|the (article)
i; in; sa; ta (pron)|that (pron)
ia; oi; voro|ever (adv)
iale; oiale|everlasting age (n)
il-|no; not (pref)
ilduma|heaven (n)
ilin; vinde; vinya|pale blue (adj)
illume; íqua; í|when; whenever (conj)
ilqua|all; everything (n)
ilu|universe; world (n)
ilya|all; the whole (adj)
ilúve|Heaven; universe; world (n)
imbe (adv)|in(wards) (adv)
imbe (n)|deep vale; dell; glen; ravine (n)
inca; intya; noa; nó|idea (n)
indis (indiss-)|bride (n)
indo|heart; mood (n)
indyalme; yalme|clamour (n)
indyo|descendant; grandchild; grandson (n)
ingole|deep lore; magic (n)
inimeite|*feminine (adj)
intya-|to guess; to suppose (vb)
intyale; nause [þ]|imagination (n)
intya|guess; notion; supposition (n)
inya (adj)|female (adj)
inya (pron)|*mine (pron)
inye|I (emphatic) (pron)
isse|where (conj)
ista-|to know (vb)
ista; istare; istya|knowledge (n)
istalima|ascertainable; knowable (adj)
istima|having knowledge; learned; wise (adj)
istyar|learned man; lore-master; scholar; wizard (n)
lah-|to kick (vb)
laica|acute; keen (adj)
laice|acuteness; keenness of perception (n)
laime|shade; shadow (cast by an object or form) (n)
laiqua; venya|green (adj)
laira|shady (adj)
laire (Language and Music)|poem (n)
laire (Time)|summer (n)
laita-|to ?live; to praise (vb)
laite|colour (n)
laive|ointment (n)
laiwa|ill; sick (adj)
lai|very (adv)
lala-|to deny (vb)
lala; lá (adv)|no; not (adv)
laman (lamn-)|tame beast (n)
lamba; lambe; quetil (Body Parts and Functions)|tongue (n)
lamba; namba|hammer (n)
lambe; questa; quetil|language (n)
lamma|sound (n)
lamya-|to sound (vb)
lanat|weft (n)
lanco; lango|throat (n)
landa; lanna; palar (n)|plain (n)
landa; palla (adj)|wide (adj)
lango|broad sword; prow of a ship (n)
lanne|cloth; tissue (n)
lanta-; talta-|to fall (vb)
lanta|fall (n)
lanwa|loom (n)
lanya-|to weave (vb)
lapsa-|to lick (frequentative) (vb)
lapsa|gluttonous eating; licking up (food or drink) (n)
lapse|babe (n)
larma|(?pig-)fat; flesh (n)
lar|fat; riches [richness?] (n)
lassecanta|leaf-shaped (adj)
lasselanta|October; autumn; leaf-fall (n)
lasse|leaf (n)
lasta-|to hear; to listen (vb)
lasta|hearing; listening (n)
lat-|to be extended; to be situated (of an area); to lie (of lands or regions); to stretch (vb)
latimbe|glen (n)
latina|cleared (of land); free; open (adj)
latta (Clothing and Adornment)|strap (n)
latta (Spatial Relations)|hole; pit (n)
lau(me)|no; no indeed not; on the contrary (adv)
lauca|warm (adj)
laurea|*golden (adj)
laure|gold (n)
lauta-|to abound (vb)
lav- (Body Parts and Functions)|to lick (vb)
lav- (Social Relations)|to allow; to grant; to yield (vb)
lavaralda|tree with long green leaves with golden undersides and pale flowers with a yellow flush (n)
lavar|*(golden) blossom (n)
le (prep)|by; with (prep)
le (pron)|you (pron)
lehta-; lenca-|to loose; to slacken (vb)
lemba|left behind (adj)
lemnar|(Valarin five-day) week (n)
lempe|five (cardinal)
lemya-|to remain; to tarry (vb)
lenda-|to linger (vb)
lenna-|to come; to depart; to go (vb)
leo|shade; shadow cast by any object (n)
lepse; let|finger (n)
lepta|*fingered (suf)
lesta-|to leave (vb)
lesta|measure (n)
lesto (lestu-)|journey (n)
liante|spider (n)
lia|fine thread; spider filament (n)
lie|folk; people (n)
lihlicca-|to sneak about (vb)
lilta-|to dance (vb)
lilótime|*many-flowered (adj)
limba|drop (n)
limpe|drink of the Valar; wine (n)
lin- (pref)|many (pref)
lin- (vb)|to sing (vb)
linda|beautiful (of sound); fair (adj)
linde (Language and Music)|air; tune (n)
linde; linya; nende|pool (n)
lindornea|having many oaks (adj)
lindo|singer; singing bird (n)
linga- (Language and Music)|to ring; to twang (vb)
linga- (Motion and Transportation)|to dangle; to hang (vb)
lingwe (lingwi-)|fish (n)
lingwilóce|fish-dragon; sea-serpent (n)
linque; mixa (linqi-)|wet (adj)
lintyulussea|having many poplars (adj)
linwe|short lay (n)
linyenwa|having many years; old (adj)
lipsa|soap (n)
lir-|to chant; to sing (vb)
liri|finch (n)
liru-|to sing (gaily) (vb)
liruima|able to be sung (adj)
lirule|merry song (n)
lirustea|fit for singing; to be sung (adj)
liruste|chant; singing (n)
lis (liss-)|honey (n)
lisce; rí|reed (n)
litse|sand (n)
loa; yén|year (n)
londe|entrance to harbour; fairway; gulf; road (in sea) (n)
lopotun; lopotundo (lopotundu-)|rabbithole (n)
lopo|rabbit (n)
lor-|to sleep (vb)
lorna|asleep (adj)
losse|(white) blossom; flower (n)
loxe|hair (n)
lu-|to be heavy; to be sad (vb)
luhta-|to enchant (vb)
luina; malwa; marya; sinde [þ]|pale (adj)
lumba|weary (adj)
lumbe|gloom; shadow (n)
lumenyáre|*history (n)
lumna-|to be heavy; to lie heavy (vb)
lumna|burdensome; lying heavy; ominous; oppressive (adj)
lunga|fraught; heavy (adj)
lunte|boat (n)
luppo (luppu-)|clumsy piece or lump (n)
lussa-|to whisper (vb)
lusse|whispering sound (n)
lusta|void (adj)
lá (interj)|(?please) (interj)
lá-; um-|to not be (vb)
láma|echo; ringing sound; sound (n)
lámina|echoing (adj)
lár-|to happen (vb)
lára (adj)|flat (adj)
lára (n)|grave (n)
lárea|fat; rich (adj)
lár|ear (n)
ló (n)|a night; night (n)
ló (prep)|ablative element (prep)
lóme (lómi-)|gloom; night; night-time; shades of night (n)
lómelinde; morilinde|nightingale (n)
lóna (n)|island; remote land difficult to reach (n)
lóna; more; nulla (adj)|dark (adj)
lóre|slumber (n)
lóte|(large single) flower (n)
lúce|enchantment (n)
lúmequentale; nyáre; quenta; quentale; quentasse|history (n)
lúmequentalea|historical (adj)
lúmequenta|chronological account; history (n)
lúme|hour; time (n)
lúmie; yénie|annals (n)
lúne (lúni-)|blue (adj)
lúpe|plume (n)
lú|occasion; time (n)
macal; macil|sword (n)
macar|tradesman (n)
mahta-|to deal with; to feel; to fight; to handle; to stroke; to treat; to wield; to wield a weapon (vb)
mahtar; ohtacáro; ohtatyaro; vé|warrior (n)
mailea|lustful (adj)
maile|lust (n)
maite (maisi-)|handy; skilled (adj)
maiwe|gull (n)
malca|how great (adj)
malda; malta|gold (as metal) (n)
malina|yellow (adj)
malle|(made or stone) road; street (n)
mallo|whence (adv)
malo (malu-) (Agriculture and Vegetation)|pollen; yellow powder (n)
malo (malu-) (Physical Acts and Materials)|rust (n)
malwa; marya|fallow (adj)
mammata-|to devour; to gobble up; to gorge (vb)
manar; mande|doom; fate; final bliss; final end; fortune (n)
mana|who (pron)
manca-|to trade (vb)
mancale|commerce (n)
manda|*duress; prison (n)
mandos|doomsman; judge (n)
mandu; turo|lord (n)
manima|of what kind; of what sort (adj)
manna|whither (adv)
manu|departed spirit (n)
man|what (pron)
mapa-|to grasp; to seize (vb)
mar (mar(d)-)|dwelling; habitation; home; house (n)
mar(dar)|homewards (adv)
mar-|to abide (vb)
maranwe|destiny (n)
maril|crystal (n)
marre; marye|at home (adv)
marta (adj n)|fate; fated; fey (adj n)
marta (adv)|home (adv)
martya-|to destine (vb)
marya|fawn [light yellowish tan colour] (adj)
masse (adv)|where (adv)
masse (n)|handful; just portion (in distribution); measure or capacity (of a person); share (n)
masta-|to bake (vb)
masta|bread (n)
mat (matt-)|food; meal (n)
mat-|to eat (vb)
matie|eating (n)
mattima|edible (adj)
maure|need (n)
mausta|compulsion (n)
mauya-|to compel (vb)
maxa; milya|soft (adj)
maxe|dough; meat (n)
maxo|mire; sticky substance (n)
ma|interrogative particle (adv)
mel-|to love (as friend) (vb)
melda|beloved; dear; sweet (adj)
meldo|(friend); lover (n)
melima|fair; loveable (adj)
melin; moina; sonda|dear (adj)
melindo|lover (m.) (n)
melisse|lover (f.) (n)
melme|love (n)
men-|to intend; to mean; to wish (vb)
mena-|to be making for; to be on way to (vb)
menel|firmament; sky; the heavens (n)
meneste|intention (n)
mennai|until (conj)
mente|end; point (n)
men|spot (n)
mer-|to desire; to want; to wish (vb)
merca; verca|wild (adj)
merca|untamed (adj)
meren(de) (merend-)|feast; festival (n)
meryale|holiday (n)
merya|festive (adj)
mestanyatse|suffixion (n)
metta; tyelma|ending (n)
metya-|to put an end to (vb)
me|us; we (pron)
milca|greedy (adj)
milme|desire; greed (n)
milya-|to long for (vb)
milya|gentle; weak (adj)
min; mine|one (cardinal)
minda|conspicuous; prominent (adj)
mindo; mindon|(isolated) tower (n)
minna; mir|into; to the inside (prep adv)
minquetyarme|accentuation (n)
minque|eleven (cardinal)
minta; mitta|(?into); inwards (prep adv)
minya|first (ordinal)
miquilis|kiss (n)
miril (mirill-)|shining jewel (n)
mirilya-|to glitter (vb)
mista-|to stray about (vb)
miste; rosse|fine rain (n)
mitsa; míwa|small (adj)
mitta-|to come in; to insert (vb)
mittande|infixion; insertion (n)
mitya|interior (adj)
miue (miuy-)|cat (n)
miule|mewing; whining (n)
mi|in; within (prep)
moina|familiar (adj)
morco|bear (n)
mordo|[dark] stain; dimness; obscurity; shadow; smear (n)
more (mori-)|black (adj)
morimaite|*black-handed (adj)
morna|gloomy; sombre (adj)
motto|blot (n)
muile|secrecy (n)
muina|hidden; secret (adj)
mun-|to dislike; to not like (vb)
mundo (mundu-)|cape [of land]; nose; snout (n)
má (Social Relations)|land; region (n)
má; quár(e) (Body Parts and Functions)|hand (n)
mál|grit (n)
mára|fit; good (of things); useful (adj)
ména|region (n)
míre|jewel; precious thing; treasure (n)
míwa|frail; tiny (adj)
mí|small fly (n)
móla|enslaved (adj)
mólome|burden; hard work (n)
mól|slave; thrall (n)
móre (móri-)|blackness; dark; night (n)
móta-|to labour; to toil (vb)
na-súrima|aspirate (n)
nac-|to bite; to hate; to kill; to slay (vb)
naham-; tulta-|to summon (vb)
nahamna|summoned (adj)
nahta (cardinal)|eighteen (cardinal)
nahta (n)|bite (n)
nahta-|to slay (vb)
naháme|summons (n)
nai (adv)|*may it be (adv)
nai (interj)|alas (interj)
naicea; nwalca [ñ-]|cruel (adj)
naicelea|painful (adj)
naicele|*anguish (n)
naice|sharp pain (n)
nairea|sorrowful (adj)
naire|lament; sorrow (n)
nalláma|echo (n)
namba-|to hammer (vb)
namárie|farewell (interj)
nan- (pref)|backwards (pref)
nan- (vb)|to go back (vb)
nanda- [ñ-]|to harp (vb)
nandaro [ñ-]|harper (n)
nanda|water-mead; watered plain (n)
nande [ñ-]|harp (n)
nandele|*repetition; harping (n)
nandelle [ñ-]|little harp (n)
nangwa|jaw (n)
nan|again; but; on the contrary; on the other hand (conj adv)
napanna|additional letter (n)
naraca|harsh; rending; violent of (?sounds) (adj)
narca-|to rend (vb)
narda; núte|knot (n)
narta-; tinta-|to kindle (vb)
narwe|sign; token (n)
nasse|spike; thorn (n)
nasta-|to sting (vb)
nasta|gore; spear-head; spear-point; triangle (n)
nasto|animal; beast (n)
natse|net; web (n)
nat|thing (n)
nauco|dwarf (n)
naule [ñ-]|wolfhowl (n)
nauro [ñ-]|werewolf (n)
nauta|bound; obliged (adj)
nau|*under (prep)
nehte|honeycomb (n)
nel-|tri- (pref)
nelde|three (cardinal)
nelle|brook (n)
neltil (neltild-)|triangle (n)
nem-|to appear; to seem (vb)
nemestea|apparent (adj)
nemeste|appearance (n)
nenemma-|to keep on (re-)appearing (vb)
nengwe; nin (nengwi-)|nose (n)
nengwea|nasal (adj)
nengwetanwa|nasal-infixed (adj)
nengwetehta|nasal sign (n)
nerte|nine (cardinal)
nessa; vinya|young (adj)
nesse; nése [þ]; vén; vírie|youth (n)
nessima|youthful (adj)
neuma|snare (n)
neuna; nyûna|second (adj)
neuro|follower; successor (n)
ngolfine; nolfine [ñ]|magical skill (n)
ni; nye|I (pron)
nie; níre|tear (n)
nieninque|(lit.) white tear; snowdrop (n)
nil (nild-)|blue-bell; harebell (n)
nilda|friendly; loving (towards) (adj)
nilde; serme|friend (f.) (n)
nildo|friend [m.] (n)
nin (ning-)|beak (n)
nindari|nymph; river-maid (n)
ninde; teren; terene|slender (adj)
ninque (ninqi-)|white (adj)
ninqueri|*white (female thing or personification) (n)
ninqueru|white (male thing or personification); white male swan; white man; white ship (n)
ninquinta-|to grow pale (vb)
ninquisse|whiteness (n)
ninquita-|to make white; to shine white; to whiten (vb)
ninquitáre|whitening; whitewashing (n)
ninya|my (pron)
nique|snow (n)
nirwa (adj)|scarred (adj)
nirwa (n)|bolster; cushion (n)
nirwe|scar (n)
nis (niks-)|minnow; ‘little fish’ (n)
nis; nisse (niss-)|woman (n)
nixe|little fish; minnow (n)
no; nu|under (prep)
noa|conception (n)
nolwe [ñ-]; nóle [ñ-]|wisdom (n)
nolwe [ñ-]|(secret) lore (n)
nornea|*of oak (adj)
norno|oak (n)
norta [ñ-]|horrible (adj)
norto [ñ-]|horror (n)
nosse|clan; family; ‘house’ (n)
not-|to reckon (vb)
nov-|?to think; to form idea; to imagine (vb)
nucumna|humbled (adj)
nui|lament (n)
nulda|secret (adj)
nulla|dusky; hidden; obscure; secret (adj)
numbe|foundation; root (n)
nuquerna|inverted (adj)
nur-|to grow/be dark (vb)
nuru [ñ-]; unquale|death (n)
nusta-|to smell [something] (vb)
nut-|to tie (vb)
nwalma [ñ-]; sút|pain (n)
nwalme [ñ-]|torment (n)
nwalya- [ñ-]|to pain; to torment (vb)
nwara- [ñ-]|to erode; to gnaw; to wear away (vb)
nwe [ñ-]|*we (inclusive) (pron)
nyar(a)-|to recite (in sing-song voice); to relate; to talk; to tell (vb)
nyarie|talking (n)
nyarna; nyáre|saga; tale (n)
nyarro|rat (n)
nyelle|bell (n)
nyello|singer (n)
nye|me (pron)
nyárula|apt to talk (adj)
ná(n)|but; on the contrary; on the other hand (conj adv)
ná-; ye-|to be (vb)
né; yá|ago (adv)
néme|*permission; leave (n)
nén (nen-)|water (n)
nér (ner-)|adult male; man (n)
níte (*níti-)|dewy; moist (adj)
ní|female; woman (n)
nó (nów-)|conception; thought (n)
nóla [ñ-]|learned; wise (adj)
nóla|knoll; round head; round hilltop; summit (n)
nóloa|yesteryear (n)
nón [ñ-]|groan; growl (n)
nóna- [ñ-]|to groan (vb)
nóre|clan; country; folk; kindred; land; race; region where certain people live (n)
nóte|number (n)
nó|*after; yester- (prep)
núme; númen|west (n)
númenya|western (adj)
nún|down below; underneath (adv)
núra; tumba; tumna|deep (adj)
núre|night (n)
núro|servant (n)
núta-|to set; to sink (of Sun or Moon) (vb)
o-; va-|together (pref)
ocamna; samna|diphthong (n)
ohta|war (n)
oi-|to live; to pass one’s days (vb)
oia|everlasting (adj adv)
oio (oiw-)|bird (n)
oira; íra|eternal (adj)
oire|everlasting (?age) (n)
ol-|to become (vb)
ola-|to grow [up] (vb)
olar; olor|dream (n)
olaste|growth (n)
olinwa|adult; fully grown (adj)
ololla-|*to keep on growing (vb)
olombo|horse (n)
olos(se)|fallen snow; snow (n)
olwa|branch (n)
omentie|meeting (n)
ondo|stone (as a material) (n)
onna|creature (n)
onot-|to count up (vb)
onta-|to beget; to create (vb)
ontale|descent (n)
ontare|begetter; parent (f.) (n)
ontaro|begetter; parent (n)
onóne|kinswoman; sister (n)
onóro|brother; kinsman (n)
opele|town; walled house or village (n)
opto|back (n)
orc; orco (orcu-)|goblin (n)
orhal-|to exalt (vb)
orme|haste; rushing; violence; wrath (n)
orna|hasty (adj)
orne|(high isolated) tree (n)
oron (oront-)|mountain (n)
ororia-|to keep on rising (and falling) (vb)
orro (adv)|on high; up in the air (adv)
orro-|to rise (from ground) (vb)
orta-|to lift; to raise; to rise (vb)
ortalima|able to be raised (adj)
ortare|lifting up (n)
orto|mountain-top (n)
orya-|to rise (vb)
oselle [þ]|[sworn] sister; associate [f.] (n)
osse|terror (n)
ostirion; osto|fort (n)
osto|city; town with wall round (n)
otornasse|brotherhood (n)
otorno|associate [m.]; sworn brother (n)
otso|seven (cardinal)
ovesta|compact; contract; treaty (n)
o|*from (prep)
palantir|far-seer (n)
palan|distant; far; over a wide space; to a distance; to a great extent; wide (adj adv)
palar|flat field; ‘wang’ (n)
palca-|to beat flat (vb)
palla|expansive (adj)
palme; palúre|surface (n)
palpa-|*to clap; to applaud (with palms); to batter; to beat (vb)
palu-; palya-|to expand; to extend; to open wide; to spread (vb)
palúre|(Old English) folde; bosom; bosom of Earth (n)
pamba|ball (n)
panda|enclosure (n)
pano|piece of shaped wood (n)
panta-|to open; to spread out; to unfurl (vb)
panta|open (adj)
panya-|to fix; to set (vb)
parca|dry; thirsty (adj)
parmaina|literary; of books (adj)
parmatéma|p-series (n)
parma|book (n)
pasta [þ]|smooth (adj)
pa|about (prep)
pel-|to go round; to return; to revolve (vb)
pelco|leg (n)
peler|fenced field (n)
peltas (peltaks-)|pivot (n)
penda|inclined; sloping down (adj)
pende|declivity; downslope; slope (n)
per-|half; semi (pref)
perya-|to divide in middle; to halve (vb)
perómanda|*semi-vowel; semivocalic (adj n)
pilen; quesse|feather (n)
pilin (pilind-)|arrow (n)
pirya|juice; syrup (n)
pis- [þ]; piuta-|to spit (vb)
pite; sáva|juice (n)
poica|clean; pure (adj)
poinesse|?cleanliness (n)
polda|burly; strong (adj)
poldore|*physical strength (n)
poldórea|strong; strong-bodied (adj)
pole; pore (pori-)|flour; meal (n)
psar-|to fret; to rub (vb)
psára|peel (n)
punta|stopped consonant (n)
pupso|blow fly (n)
pusta-|to cease; to put a stop to; to stop (vb)
pusta|in punctuation full stop; stop (n)
putta|stop (in punctuation) (n)
qualin; vanwa|dead (adj)
qualme|(death) agony; (process of) death (n)
quanta-tencele|full writing (n)
quanta|full (adj)
quantien|(lit.) full year; century (n)
quel-|†to fail (vb)
quelesta|dying; fading (n)
quelet (qelett-)|corpse (n)
quelie|*fading (n)
quelle|Autumn (n)
quenso; quentaro|minstrel (n)
quentale|account (n)
quentaro|narrator; reciter (n)
quenta|account; story; tale (n)
quequetta-|to keep on saying; to repeat (vb)
quesset (*qessek-)|pillow (n)
quessetéma|q-series (n)
questa|speech (n)
quet-|to say (vb)
quetil|talk (n)
quettima|utterable (adj)
que|if (conj)
quilir|quiet (n)
quingatelco|*bow-legged (adj)
quinga|bow (for shooting) (n)
quáqui|all (adv)
quár(e)|fist (n)
quéne|petrel (n)
raccalepta|*claw-fingered (adj)
racca|*claw (n)
raf-|to seize; to snatch (vb)
raica|bent; wrong (adj)
raiqua|angry (adj)
ramba (Dwelling and Furniture)|wall (n)
ramba; ran (ramb-)|beam of wood (n)
ranco (ranku-)|arm (n)
randa|age (100 Valian Years); cycle (n)
rangwe|fathom (n)
ranta; tie|course (n)
ranya-|to *wander; to stray (vb)
rasco; romba; tilde|horn (n)
rasse|horn [of both animals and mountains] (n)
rauco|demon (n)
rauta; tinco|metal (n)
ravanda|wilderness (n)
rempa|hooked (adj)
rer-|to sow (vb)
resta|acre; sown field; ‘sown’ (n)
rihta-|to give quick twist or move; to jerk; to twitch (vb)
rille|brilliance (n)
rilma|glittering light (n)
rilya|glittering (adj)
rimba|frequent; numerous (adj)
rimbe|crowd; host (n)
rimpa|flying; rushing (adj)
rinca|jerk; sudden move; trick; twitch (n)
rince (rinki-)|flourish; hook; quick stroke (n)
rinda|circular (adj)
rinde|circle (n)
ringe (ringi-)|cold (n)
ringwe|cold pool or lake (in mountains) (n)
rip-|to hurl (vb)
rista-|to cut (vb)
rista|cut (n)
rocco|(swift) horse (n)
rohta-|?to run on foot (vb)
roime|hunt (n)
roina|ruddy (adj)
roita-|to pursue (vb)
romba|trumpet (n)
rondo|cavern; roof (n)
ronyo|*hunting dog; hound of chase; ‘chaser’ (n)
rosse|dew (n)
rotto|tunnel (n)
ruc-|to pluck (vb)
runda|rough piece of wood (n)
runya|footprint; slot (n)
russe|corruscation; †sword-blade (n)
rá; ráva; rú (ráv-)|lion (n)
rámalóce|winged dragon (n)
ráma|wing (n)
ránen|errant (adj)
ráne|straying; wandering (n)
ráva (adj)|untamed; wild (adj)
ráva (n)|bank (especially of a river) (n)
réna|border; edge; margin (n)
ríe|crown (n)
ríma|border; edge; hem (n)
rína|crowned (adj)
rí|grass-stem (n)
róma|loud sound; trumpet-sound (n)
rómenya|eastern (adj)
rómen|east (n)
róminya|*eastern (adj)
róna|east (adj)
sa-rince (sa-rinki-)|hooked stroke in tengwa; s-hook (n)
sac-|to hurt (vb)
saira|wise (adj)
sairon|wizard (n)
salpa-|to lick up; to sip; to sup (vb)
salque|grass (n)
sambe [þ]|chamber; room (n)
samna [þ]|wooden post (n)
samno [þ]|builder; carpenter; wright (n)
sampane|combination (n)
sana|that (adj)
sanca [þ]|cleft; split (adj)
sanda [þ]|abiding; firm; true (adj)
sanga [þ]|crowd; crowded; pack; packed; press; throng (n adj)
sanga- [þ]|*to press (vb)
sanguma [þ]|*thing that presses; press (n)
sangwa|poison (n)
sanya [þ]|law-abiding; normal; regular (adj)
sanye [þ]|law; rule (n)
san|*then (conj adv)
sapsarra-|to fray away; to keep on rubbing (vb)
sar (sard-)|stone (small) (n)
sara [þ]|bent; stiff dry grass (n)
sarna|of stone (adj)
sarne|stony place (n)
sat; uphto (sap-)|pit (n)
saura [þ]|evil-smelling; foul; putrid (adj)
sauricumba [þ]|*foul-bellied (adj)
selda|child [n.] (n adj)
selde|child [f.] (n)
seler [þ] (sell-)|sister (n)
senda|at peace; resting (adj)
sen|them (pron)
ser-|to at the moment; to be for a while; to repose; to rest; to stay; to stop; to tarry (vb)
seru-|to come to rest on; to settle on; to sit or lie down (vb)
sicil|dagger; knife (n)
sil-|to shine (vb)
silma|shining white; silver (adj)
silme|light of Silpion; moonlight; †silver (n)
sin; sí|now (adv)
sinan|at present (adv)
sinar|this morning; today (n)
sinome; símane; símen|here (adv)
sinta [þ]|short (adj)
sinta- [þ]|to *(lit.) become grey; to fade (vb)
sinya; vinya|new (adj)
sinye [þ]; vinye|evening (n)
sir-; ulya-|to flow (vb)
sirya-|to flow [smoothly] (vb)
sisilla-|to glitter (white) (vb)
siule|incitement (n)
solor|surf (n)
sonda|fond (adj)
sorasta|equipment (n)
sorne [þ]; soron [þ] (sorn-)|eagle (n)
suc-|to drink (vb)
suhto|draught (n)
sulca|root (especially as edible) (n)
sulpa-|to drink greedily; to lap up (vb)
sumba-|to submerge (vb)
sundo [þ]|base; root; root-word (n)
sundóma [þ]|determinant vowel; vocalic determinant (n)
sungwa|drinking-vessel (n)
surya|spirant consonant (n)
suv-|to sink (esp. in water) (vb)
sára|bitter (adj)
sáro [þ]|saviour (n)
sére|peace; repose; rest (n)
síre (síri-)|river (n)
súle [þ]|breath; spirit (n)
súlo (*súlu-)|goblet (n)
sút|(esp.) death-throe (n)
súya- [þ]|to breathe (vb)
ta; te; the|it (pron)
tac-|to fasten (vb)
taile|extension; lengthening (n)
taima|extension (n)
taina|extended; lengthened; prolonged (adj)
taita-|to prolong (vb)
talan (talam-)|floor; ground (n)
talat|sheet (n)
tallune|sole of foot (n)
talma|base; foundation; root (n)
talta (adj)|inclined; leaning; sloping; tilted (adj)
talta (n)|incline (n)
talta-|to slide down; to slip (down); to slope (vb)
talte|at the bottom; down (adv)
tal|downwards (adv)
tam-; ton-|to tap (vb)
tamba-|to keep on knocking; to knock (vb)
tambaro|(lit.) knocker; woodpecker (n)
tambe (tambi-)|pot (n)
tampa|stopper (n)
tana|that (anaphoric) (pron)
tancal(a)|brooch; clasp; fastener (n)
tancata-|to confirm; to make fixed or firm (vb)
tanca|firm; fixed; sure (adj)
tancil|brooch; clasp; fastener; pin (n)
tanga-; tinga-|to twang (vb)
tango; tinge|twang (n)
tangwa|clasp; hasp (n)
tanna; tar|thither (adv)
tano|craftsman; smith (n)
tanwe|construction; device; thing made (n)
tap-|to block; to stop (vb)
tar-|high; king or queen (in compounds) (affix)
taras (tarass-)|mount (n)
tarca|horn [of animals] (n)
tarci-|to trouble (vb)
tarya|stiff; tough (adj)
tar|beyond (adv)
tasar(e) [þ]|willow-tree (n)
tasse; yasse|there (adv)
tatalla-|to admire; to marvel; to wonder at (the excellence of) (vb)
tatya-|to double; to repeat (vb)
taura|mighty (adj)
taure|forest; great wood (n)
taurina|of wood (adj)
tavaril|dryad; spirit of woods (f.) (n)
tavaron|dryad; spirit of woods (m.) (n)
tavar|wood (material) (n)
taxe|nail (n)
tea|road; straight line (n)
tec-|to write (vb)
tecco|accent [´]; stroke (of pen or brush) (n)
tecil|pen (n)
tehta|diacritic; mark (in writing); sign (n)
tel-|to intend (vb)
telco|leg; stem (n)
telemna|*of silver (adj)
telepsa; telpina|of silver (adj)
tella|hindmost; last (adj)
telle|rear (n)
telme|covering; hood (n)
telpe; tyelpe|silver (n)
telta-|to canopy; to overshadow; to screen (vb)
telumet (telumett-)|canopy (n)
telume|dome (of heaven); vault (n)
tencele|spelling; writing (system) (n)
tengwanda|alphabet (n)
tengwa|grammar; letter; writing (n)
tengwesta|collection of writing; grammar (n)
tengwe|writing (n)
tenna (n)|a letter (n)
tenna (prep)|until (prep)
ten|for (conj)
ter; tere|through (prep)
tereva|acute; fine (adj)
terhat-|to break apart (vb)
terra|fine pierced hole (n)
tet(ta)|baby (n)
te|him (pron)
thar-; tol-|to stand (vb)
tie|direction; line; path; way (n)
tilde|spike (n)
tin-|to glint (vb)
tincotéma|t-series (n)
tinda|glinting (silver) (adj)
tinde|glint (n)
tindóme|(starry) twilight; starlit dusk (n)
tingahondo|flint-hearted (adj)
tinga|*flint (n)
tingilinde; tingilya|twinkling star (n)
tinta-|to make to spark (vb)
tintina-|to sparkle (vb)
tinwe|spark (star) (n)
tir-|to watch (vb)
tirion|tower; watch-tower (n)
tiriste|*watch; guard (n)
tis; titse (tits-)|kitten (n)
tithilla-|to twinkle (vb)
titta|little; tiny (adj)
tiuca|fat; thick (adj)
tiuya-|to grow fat; to swell (vb)
tixe|dot; point; tiny mark (n)
toa|of wool; woollen (adj)
tol (toll-)|island (n)
tolto|eight (cardinal)
tolu-|to get up; to leave one’s seat; to stand up (vb)
ton-|to knock (vb)
top-|to cover (vb)
tormen|north (n)
toron (torn-)|brother (n)
to|in (prep)
tsette|fly (n)
tuc-|to *pull (toward); to draw (vb)
tuia-|to spring; to sprout (vb)
tuile|spring-time (n)
tuilindo|(lit.) spring-singer; swallow (n)
tuilu-|to bud; to open (of flowers and leaves) (vb)
tuima|bud; sprout (n)
tul-|to come (vb)
tulca|firm; immovable; steadfast; strong (adj)
tulco (*tulku-)|prop; support (n)
tulma|event (n)
tulta-|to (lit.) cause to come; to fetch; to send for; to send hither (vb)
tulumaite|likely to come; probable (of future events) (adj)
tulurya; évea|future (adj)
tulurya|coming (adj)
tuluste|arrival (n)
tumba-|to cast down (into a pit[?]) (vb)
tumba; tumna|lowlying (adj)
tumbo (tumbu-)|deep valley (under or among hills; with high sides) (n)
tumna|low (adj)
tumpo|hump; lump (n)
tundo (tundu-) (Physical World)|mound (n)
tundo; unque (tundu-) (Spatial Relations)|hole (n)
tunga|resonant (of strings); taut; tight (adj)
tunt (tump-)|lump (n)
tuo|muscle; physical strength; sinew; vigour (n)
tupse|thatch (n)
tur-|to control; to govern; to wield (vb)
turma; umbas [þ]|shield (n)
turo|master; victor (n)
turut (turuk-)|tree-stem (n)
turya-|to strengthen (vb)
turyande|fortification; strengthening (n)
turyanwa|fortified (adj)
tussa|bush (n)
tutulla-|to keep on coming (and going) (vb)
tyal-|to play (vb)
tyalangan (*tyalangand-)|harp-player (n)
tyalie|game; play; sport (n)
tyar-|to cause (vb)
tyatyamba-|*to keep on tasting (vb)
tyav-|to taste (vb)
tyaz-|to like (vb)
tyel (tyeld-)|end (n)
tyel-|to cease; to end (vb)
tyelca|agile; swift (adj)
tyelima|final (adj)
tye|thee (pron)
tyulma|mast (n)
tyulusse|poplar-tree (n)
tál (tal-)|bottom; foot (n)
tára|high; lofty (adj)
táre|*that day (adv)
tári|queen (n)
téma|line; row; series (n)
téna; téra|right; straight (adj)
té|path (n)
tópa-|to roof (vb)
tópa|roof (n)
tó|wool (n)
túlima|*able to be brought (adj)
túre|mastery; victory (n)
ufárea|not enough (adj)
uile|long trailing plant (n)
ullume|forever (adv)
ululla-|to keep on pouring (vb)
ulunde|flood (n)
ulundo|deformed and hideous creature; monster (n)
ulya-|to pour (vb)
um-|to not do (vb)
uman|at one time (adv)
umbar (umbart-)|doom; fate (n)
umpano|build[ing] (n)
un-/um-|intensive prefix with evil sense (pref)
unca-|to hollow out (vb)
undo|down; low down (adv)
undu|beneath; down; under (prep adv)
ungo|cloud; dark shadow (n)
ungwale|torture (n)
ungwe|gloom (n)
unquale|agony; death agony (n)
unqua|hollow (adj)
unque|cavity; hollow (n)
unta-|to come down; to descend (vb)
unutixe|dot or point placed below the line of writing (n)
uruite; úruva|fiery (adj)
urulóce|fire-dragon (n)
urya-|to blaze (vb)
usque|dusk; reek; twilight (n)
uvana|wicked (adj)
vahai(y)a; vaháya|far away (adv)
vahta-|to soil; to stain (vb)
vai(y)a|envelope (n)
vainar; veaner|sailor (n)
vaita-|to enfold (vb)
vaiwa|wind (n)
valaina|divine; of or belonging to the Valar (adj)
valasse|divinity (n)
valya|having (divine) authority or power (adj)
vanima; vanya|fair (adj)
vanta-|to walk (vb)
vanta|walk (n)
vanwa|departed; gone (for good); lost; over; past; vanished (adj)
vanwie|past time; the past (n)
vanya-|to depart; to disappear; to go (vb)
vanya|beautiful (adj)
var-|to err (vb)
varile|protection (n)
varnasse|security (n)
varna|protected; safe; secure (adj)
varne (varni-)|brown; dark brown; swart (adj)
varya-|to protect (vb)
vaxe|stain (n)
va|away (prep)
veaner|(adult) man (n)
veasse; vie|vigour (n)
vea|adult; manly; vigorous (adj)
vende|maid; maiden (n)
venesse|virginity (n)
venno; veru|husband (n)
venya|fresh; yellow-green (adj)
veo; vé|man (n)
verie|boldness (n)
veru (collective-noun)|husband and wife; married pair (collective-noun)
verya-|to dare (vb)
verya|bold (adj)
vesse|wife (n)
vesta (Mankind)|matrimony (n)
vesta (Possession and Trade)|contract (n)
vesta- (Law and Judgment)|to contract; to make a compact; to swear (to do something) (vb)
vesta- (Mankind)|to wed (vb)
vestale (Law and Judgment)|oath (n)
vestale (Mankind)|wedding (n)
ve|with (prep)
vie|manhood (n)
vil-|to fly (vb)
vilma|inner or lower air (n)
vilwarin (wilwarind-)|butterfly (n)
vilwa|lower air (n)
vinda-|to fade (vb)
vinge|crest; crest of wave (n)
vingil (wingild-)|foam-maid; mermaid; nymph (n)
vingi|foam-maid; mermaid (n)
virya|fresh (adj)
vista|air as substance (n)
vor(o)-|continual repetition (pref)
vorongandele|(lit.) harping on one tune; continual repetition (n)
voronwa|enduring; long-lasting (adj)
voronwie|endurance; lasting quality (n)
vorosanya [þ]|*ever-law-abiding (adj)
voro|continually (adv)
ván|goose (n)
vára|dirty; soiled (adj)
véne|girl (n)
vén|freshness; greenness (n)
vére|compact; oath; troth (n)
vórea|continuant; continuous; enduring; lasting (adj n)
vóre|lasting (n)
vórima|continuous; enduring; repeated (adj)
xara-|to long for; to yearn (vb)
yaiwe|mocking; scorn (n)
yallume|at last (adv)
yalúmea; yárea|olden (adj)
yalúme|former times (n)
yana|that (the former) (pron)
yanga-|to yawn (vb)
yanta|bridge; yoke (n)
yanwe|bridge; isthmus; joining (n)
yasse|once upon a time (adv)
yat (yaht-)|neck (n)
yat (yak-)|goat (n)
yatta|isthmus; narrow neck (n)
ya|relative pronoun (pron)
yelca|sword? (n)
yelda|dear as friend; friendly (adj)
yelde; yen(de)|daughter (n)
yello|call; cry of triumph (n)
yelme|loathing (n)
yelta-|to abhor; to loathe (vb)
yelwa|loathsome (adj)
yenya|last year (n)
yerna|old; worn (adj)
yerya-|to get old; to wear (out) (vb)
yesta-|to desire (vb)
yeste|being; existence (n)
ye|at (prep)
yo; yu|and (conj)
yondo|son (n)
yuale; yúcale|twilight (n)
yul-|to smoulder (vb)
yulma|brand (n)
yulme|red (?heat); smouldering heat (n)
yurasta|twenty four (cardinal)
yána|fane; holy place; sanctuary (n)
yár; yór (yar-)|blood (n)
yára|ancient; belonging to or descending from former times; old (adj)
yáre|former days (n)
yáve|fruit (n)
yáwe|cleft; gully; ravine (n)
yá|formerly (adv)
yére|*sexual desire (n)
yé|*lo! (interj)
yú-|both (pref)
yúla|ember; smouldering wood (n)
yúyo|both (adj)
yú|too (adv)
Úrime|*Hot-one; August (n)
á (interj)|Oh! (interj)
á (particle)|imperative particle (particle)
áratencele|(lit.) daywriting; writing of A (n)
ára|dawn; day (n)
éle|beam; flashing of [?starry] light; star-ray (n)
ére|existence; existing (n)
é|indeed (interj)
íquallume|when; whenever (adv)
íre (conj)|when (conj)
íre (n, Emotion)|desire; longing (n)
íre (n, Time)|eternal; eternity? (n)
írima|desirable; lovely (adj)
ólamaite|consonantal (adj)
ólama|consonant (n)
ómaite|voiced [stop] (n)
óman (omand-)|vowel (n)
ómanda|vocalic (adj)
ómataile|vowel-lengthening (n)
ómataima|vocalic extension (n)
óma|voice (n)
ómea|voiced (adj)
óre|rising (n)
ú-|in-; not; un- (pref)
úlea|flooding; flowing; pouring (adj)
úmahta(le)|nuisance (n)
úmea|evil (adj)
úra|large (adj)
úr|fire; heat (n)
úvanimo|monster (n)
úvea|abundant; in very great number; very large (adj)
úve|abundance; great quantity (n)
úvie|considering a matter (with a view to decision) (n)
