(a)larca|rapid; swift (adj)
(a)nacca|cut; defile; narrows; pass (n)
(a)taryo|daddy (n)
(a)vaháya|*far away (adv)
(ana)tarwesta|crucifix(ion) (n)
(apa)ruivë|fire as conflagration; wild fire (n)
(cirya)talan|deck (of a ship); main deck (n)
(e)mecima|accurate; always aiming at the mark (adj)
(ec)coiru-|to come to life (vb)
(h)róna|east; eastern (adj)
(i)missë|inside (n)
(lu)lútië|cruise; (lit.) floating/sailing about (n)
(n)ungwar-|to hinder; to sabotage; to sap; to undermine; to weaken; (lit.) to under/down-fret (vb)
(nai)naina-|to lament (vb)
(o)combëa|assembled; collective; concerted; consolidated; cooperative; corporate (adj)
(o)combë|assemblage; assembly; collection; gathering; *congregation (n)
(o)notasta|amount (n)
(y)otulma|coincidence; concurrence; simultaneity; synchronicity (n)
-(i)la|active participle (suf)
-(i)llo; -ccë; -ilco; -stë; -xë|you (dual) (suf)
-(n)dil|-friend; -lover; devotion; disinterested love (suf)
-(n)duinë|(large) river (suf)
-(n)dur|servant (suf)
-(n)dórë|-illion; *large number suffix (suf)
-(u)va|future suffix (suf)
-(á)rë; -ndë|general action verbal suffix (suf)
-arya|*inceptive (suf)
-a|adjectival suffix (suf)
-carya|-doing (suf)
-carë|action; doing; making (suf)
-cca; -sta; -xa|your (dual) (suf)
-da|product of an action (suf)
-dildo; -nil; -nildo|-friend (suf)
-dil|-friend; -lover (suf)
-dur|-servant; *servant (suf)
-el; -ser|friend (suf)
-ello|ablative element (suf)
-enca|-less; without (suf)
-esta|*close grouping (suf)
-ima|-able; -ible; able to be done; possible; [with short base vowel] *having a (strong) nature of (suf)
-ina|adjective suffix; passive participle (suf)
-incë|diminutive ending (suf)
-inqua|-ful; complete (suf)
-inquë; -nquë|thou-and-I (dual) (suf)
-ion|-son; masculine patronymic (suf)
-issë|ending in feminine names (suf)
-ita|particular infinitive (suf)
-itë (-iti-)|[with verbs] capable of doing; adjectival ending; generally (and naturally) doing (suf)
-itë; -maitë|(verbal) adjective ending (suf)
-i|general plural for nouns; plural suffix; simplest aorist infinitive (suf)
-iël|-daughter; daughter; feminine suffix (suf)
-iën; -ndor|-land (suf)
-iën|daughter; feminine ending (suf)
-ië|-ing; abstract noun; adverb; gerund suffix; perfect suffix (suf)
-l(yë)|you (polite) (suf)
-lda|a comparative suffix; your (plural) (suf)
-ldë; -llë; -ndë|feminine agent (suf)
-ldë; -llë|you (plural) (suf)
-li|a lot of; many; partitive plural (suffix); plural (suffix); some (suf)
-lla|your (plural polite) (suf)
-llo|(movement) from; ablative element; ablative suffix; out of (suf)
-llumë|-times (suf)
-llë|you (dual polite) (suf)
-lma|our (exclusive); our (inclusive dual) (suf)
-lmo; -ngo; -ngwë; -ngë|we (inclusive dual) (suf)
-lmë|we (exclusive) (suf)
-lta; -ltya; -ntya|theirs (suf)
-ltë; -ntë|they (suf)
-lva; -lwa|our (inclusive) (suf)
-lvë; -lwë|we (inclusive) (suf)
-lya|imperfect participle; your (polite) (suf)
-lë; -më; -rë; -ssë; -vë|abstract noun (suf)
-lóra|less; without (suf)
-ma; -nen|instrumental (suf)
-matya|-eating (suf)
-men(d-)|a single action (suf)
-mië|*noun ending (suf)
-mma|our (exclusive dual) (suf)
-mmo; -mmë; -nwë|we (exclusive dual) (suf)
-mo; -r(o)|agental suffix (suf)
-n(yë)|I (suf)
-nca|your (plural familiar) (suf)
-ncë; -ntyë|you (plural familiar) (suf)
-ndacil|-slayer; -victor (suf)
-ndon|-ily; -like; as; like (suf)
-ndor; -nor|country; land (suf)
-ndo|(masculine) agent; *agent (male) (suf)
-ngwa; -nqua|our (inclusive dual) (suf)
-nil|-lover (suf)
-nna|(movement) to; allative suffix; at (arriving at a point); onto; towards (suf)
-non (-nóm(e)-)|-place; -spot (forms place-names, area nouns) (suf)
-nta|their; they (neuter); to become or be made (suf)
-nur|-servant (suf)
-nwa|active participle (intransitive verbs); passive suffix; perfective adjective; perfective participle (suf)
-nya|my (suf)
-n|dative (suf)
-on; -wë|masculine suffix (suf)
-on|augmentative; great (suf)
-o|genitive ending; of (suf)
-r (Grammar)|plural suffix (suf)
-r (Spatial Relations)|motion to or towards a point; *archaic allative (suf)
-rasta|twelve (suf)
-rin|-ian; language; racial-adjective (suf)
-rya (Grammar)|her; his; its; their (colloquial) (suf)
-rya|imperfect participle (suf)
-rë|gerund (suf)
-s(sa)|3rd person singular neuter (suf)
-s(së)|he; her; him; it; she (suf)
-ssa|her; his; its (suf)
-ssë|locative ending (suf)
-sta (Grammar)|verbal noun suffix; *noun suffix (suf)
-sta (Quantity and Number)|close grouping; *part (suf)
-stir|face (suf)
-sto; -stë; -ttë|they (dual) (suf)
-s|he; it; she (suf)
-t; -tyë|you (familiar) (suf)
-tar|honorific (suf)
-ta|causative; causative verb suffix (suf)
-tië; -ya|verbal suffix (suf)
-tta (Grammar)|their (dual) (suf)
-tta|close grouping (suf)
-tur|lord; master; ruler; victor (suf)
-tya|your (familiar) (suf)
-t|dual ending; they (object suffix) (suf)
-ula|apt to; likelihood or aptitude; likely to do so; verbal adjective (likelihood, aptitude) (suf)
-umnë|future-past (suf)
-uva|future tense suffix (suf)
-u|dual ending (suf)
-va|adjectival; possessive or adjectival ending (suf)
-voitë|adjective suffix (suf)
-vë|adverb (suf)
-wë|abstract suffix; ancient name suffix (usually but not always masculine) (suf)
-xë|reflexive verbal inflection (suf)
-ya|adjective suffix; aorist active participle; general verbal adjective; her; his; its (colloquial); suffix of endearment (suf)
-yë|and (pairs) (suf)
-ëa|continuative present; ordinal suffix (suf)
-ë|plural of adjectives (suf)
-úmë|[large]; of quantity (suf)
AQu|to P.S.; to abbreviation of an quetta; to postscriptum (vb)
Aini|angelic spirit (f.); holy one (n)
Ainu|angelic spirit (m.); holy one (n)
Aldëa|Tree-day (Númenórean); *Tuesday (n)
Aldúya|Day of the Two Trees; *Tuesday (n)
Alfírimo|Immortal (n)
Ambar|Earth; Settlement; The World; World; (lit.) Habitation (n)
Américárin|American (adj)
Anahristo|Antichrist (n)
Anar (Anár-)|Sun (n)
Anarya|Sunday; (lit.) Sun-day (n)
Asiya|Asia (n)
Atan|Man; (lit.) the Second (People) (n)
Casar; Norno; naucon (naucond-)|Dwarf (n)
Cermië|July (n)
Cimrinórin|Welsh (n)
Eldalië|Elf-folk; Elven-folk; People of the Eldar; People of the Elves (n)
Eldarin (Language and Music)|Elvish (language); of the Eldar (adj n)
Eldarin (Religion and Beliefs)|Elvish; of the Elves (adj n)
Elda|Elf; (lit.) one of the Star-folk (n)
Elenya|Saturday; *Star-day (n)
Endëranda|Middle-Ages (n)
Ennosta|Renaissance (n)
Erutercáno|prophet; (lit.) God-herald (n)
Eruva; valaina|divine (adj)
Eru|God; The One; The One God (n)
Faranconórë|France (n)
Foinicer|Phoenicians (n)
Foralcar|aurora; (lit.) northern radiance (n)
Hellenórë|Greece; Greek people (n)
Hristondur|Christian; (lit.) Servant of Christ (n)
Hyaralcar|aurora; (lit.) southern radiance (n)
Hísimë [þ]|November; *Misty-one (n)
Isil [þ]|Moon; (lit.) Sheen (n)
Isilya [þ]|Moon-day; *Monday (n)
Italinórë|Italy (n)
Lótessë|May; *(lit.) Flower-ness (n)
Maia|(angelic) spirit; the Beautiful (n)
Maiya|(angelic) spirit (n)
Menelya|Heavens-day; *Wednesday (n)
Metelairë|August; *(lit.) End-summer (n)
Meterrívë|January; *(lit.) End-winter (n)
Máya|angelic spirit (n)
Narquelië|October; Sun-fading (n)
Narvinyë|January; *New-fire (n)
Nárië|June; *Fire-ness (n)
Nénimë|February; *Wet-ness (n)
Perian (Periand-)|Halfling (n)
Portucalëo|Portuguese (n)
Quenderin|Quendian; belonging to the Elves as a whole; of the Quendi (adj n)
Quendya|Elvish (n)
Quendë|Elf; (lit.) One That Speaks (n)
Quenya (Language and Music)|Elf-latin; Elvish; High-elven; †speech (n)
Quenya (Religion and Beliefs)|Elf-latin; Elfspeech; Elvish (Tongue); Quendian; belonging to the Qendi (n)
Quenyarin|*of Quenya (adj)
Rana; Rána|Moon; (lit.) Wayward (n)
Ringarë|December; *Coldness (n)
Romënórin|Roman (n)
Sindarin [þ]|Grey-elven (n)
Sindel (Sindeld-) [þ]|Grey-elf (n)
Súlimë [þ]|March; *Windy-one (n)
Torco|Troll (n)
Tyena|China (n)
Tárion|alternate name of the last day of the Eldarin six-day week (n)
Valanya|Vala-day; *Friday (n)
Vala|(Angelic) Power; Authority; God (n)
Valië|Female Vala (n)
Vanimo|Fair Folk; The Beautiful (n)
Víressë|April; *Freshness (n)
Yavannië|September; *Yavanna-ness (n)
a (article)|accusative definite article (article)
a (interj)|O; Oh (interj)
a-|infinitive prefix (pref)
accal-|to blaze; to shine (suddenly and) brilliantly (vb)
accamatië|over-eating (n)
accamátala|over-eating (adj)
accasucië|over-drinking (n)
accasúcala|over-drinking (adj)
aha; ursa [þ]|rage (n)
ahta-|to narrow (tr. and intr.) (vb)
ahtar-|to avenge; to do back; to react; to requite (vb)
ahtarië|reaction (n)
ahtarulas(së)|responsibility; (lit.) aptitude to react (n)
ahtassë|narrowing (n)
ahto|maker; wright (n)
ahtumat|supper; *(lit.) maker’s meal (n)
ahya-; virya-|to change (vb)
ai (adv, Grammar)|maybe; suppose; supposing (adv)
ai (adv, Mind and Thought)|maybe; suppose; supposing; *any (adv)
ai (interj)|ah; alas (interj)
aia; alla|hail (interj)
aiano|stranger (n)
aian|holy thing or object or place (n)
aia|strange; unusual (adj)
aicalë; antaro; mintyë; tildë|peak (n)
aicassë|mountain peak (n)
aica|dire; fell; sharp; terrible (adj)
aico (aicu-); varassë|cliff (n)
ailin|(large) lake; pool (n)
ailumë|anytime (adv)
aimahto|martyr; (lit.) blessed slain (n)
aimanen|however (adv)
aima|anything; whatever (pron)
aimo|saint (n)
aina-|to bless; to hallow; to treat as holy (vb)
ainas (*ainass-)|fane; hallow; holy place; sanctuary; *shrine (n)
aina|holy; numinous; revered; *divine (adj)
ainima|blessed; holy (of things) (adj)
ainolóra|godless (adj)
ainolórië|godlessness (n)
ainomë|anyplace; anywhere (adv)
aino|god (n)
aipio; pio|cherry (n)
aiqualë|a steep [thing]; steepness (n)
aiquassë|precipice (n)
aiqua|steep (adj)
aiquen|anybody; if anybody; whoever (pron)
airalindë|hymn; (lit.) holy song (n)
airasëa [þ]|hyssop (n)
aira|holy; sanctified; worshipful (adj)
airemma|icon; (lit.) holy image (n)
airilírë|hymn (n)
airimossë|priesthood (n)
airimo|priest (n)
airita-|to hallow (vb)
airon; váya; ëaren; ëaron|ocean (n)
airë (airi-)|holiness; holy; sanctity (adj n)
airë; ëar; ëaren|sea (n)
airëa|holy (applied to persons) (adj)
aista-; sorya- [þ-]|to dread (vb)
aita- (Emotion)|to (orig.) make aghast; to astound; to shock; to surprise (vb)
aita- (Religion and Beliefs)|to revere; to worship (vb)
aitalëa|religious; reverent; worshipful (adj)
aitalë|religion; reverence; worship (n)
aitamo|worshiper (n)
aitë|of any sort; of some sort (adj)
aivë|anyhow; anyway; in any way (adv)
aiwë|(small) bird (n)
aiya|behold; hail; lo (interj)
al(a)-|in-; negative prefix; not; un-; without; †-less (pref)
ala-; apta-|to deny (vb)
ala-; lauya-; ola-|to grow (vb)
ala-|to flourish (of other creatures); to grow (of plants) [intr. and trans.]; to plant; *to thrive (vb)
alacarna|well-done; well-made (adj)
alacestaima|unsearchable (adj)
alaco|rush; rushing flight; wild wind (n)
alacénima; úcénima|invisible (adj)
alafasta|orderly; tidy (adj)
alahasta; vanya; úharin; úχarin|unmarred (adj)
alahastaima|incorruptable (adj)
alahen (alahend-)|eyeless (adj)
alahta-; hyasta-|to rush (vb)
alahírima|impossible to find; unfindable (adj)
alaica|blunt (adj)
alairë|unholy (adj)
alalla-|*to keep on growing (vb)
alaloitala|unfailing (adj)
alalvëa|having many elms (adj)
alamen|good omen on departure (n)
alamirwa|cheap; not expensive; not precious (adj)
alamo|cultivator; grower (n)
alamára|no-good (adj)
alanancárima|indestructible (adj)
alanessë|nicotiana; pipeweed; *tobacco (n)
alaninquitálima|that cannot be made white (again) (adj)
alapihta|unshrunk (adj)
alapulúna|unfermented; unleavened (adj)
alaquenta|well (happily) said (adj)
alarya-|to be happy or merry; to rejoice (vb)
alas (alast-)|marble (n)
alasaila|unwise (adj)
alasatya [þ]|common; general; *communal; (lit.) not private (adj)
alassëa|happy; joyful; *merry (adj)
alassë|happiness; joy; merriment (n)
alasta-|to cheer (up); to make happy (vb)
alasta|marble; of marble (adj)
alasóvina|unwashed (adj)
alat-|great in size; large (pref)
alatya-|to shield; to ward off (vb)
alavahtaina|undefiled (adj)
alavistaima|unchangeable (adj)
albë; alvë|elm (n)
alca-|to flash; to glitter; to *shine out (vb)
alcar(e)|brilliance; radiance (n)
alcarin(qua)|brilliant; glorious; radiant (adj)
alcarinqua|glorious; radiant (adj)
alcarvalda; laitima|honourable (adj)
alcarya-|to glorify (vb)
alcar|brilliance; glory; radiance; splendour (n)
alca|ray of light (n)
aldarembina|tree-meshed (adj)
aldarwa|having trees; tree-grown (adj)
alda|tree (n)
aldinga|tree-top (n)
aldomë; únomë|nowhere (pron)
aldëon (aldëond-)|avenue (of trees) (n)
aleldarinwa|unElvish (adj)
aleldarin|unelvish (adj)
alenessë|nicotiana; pipeweed (n)
alermaitë (alermaiti-)|abstract; non-concrete (adj)
alfárima|impossible to pursue (adj)
alfírima|immortal (adj)
alima|fair; good (adj)
alla (Grammar)|hail! (interj)
alla (Language and Music)|welcome (interj)
allumë|never (adv)
almaicata-|to blunt; to make or become less sharp (vb)
almarë|blessedness; blessings; bliss; good fortune (n)
almiën|cheers; (lit.) to good fortune (interj)
almo|shoulder (n)
almárëa; alya; herenya; mána|blessed (adj)
almë|blessing; good (or blessed) thing; piece of good fortune (n)
alon (alond-)|limestone; (lit.) grow-stone (n)
alpa|bat [instrument not animal]; (lit.) beater (n)
alqua|swan (n)
alquen|no one; nobody (pron)
altancanta-|to become unfixed (vb)
altarnië|empire (n)
alta|great in size; large (adj)
alumo|leather-worker (n)
alu|(dressed) leather (n)
alwara|useless; *worthless (adj)
alwa|well-grown (adj)
alya-|to bless (a work); to cause to prosper; to help one (vb)
alya|abundant; prosperous; rich (adj)
alómëa; ómalóra|voiceless (adj)
am(a)-; an-|intensive prefix (pref)
am(ba)penda|arduous; difficult; tiresome; uphill; *sloping up (adj)
am(be)na|nearer to (adv)
am(il)yë|*mummy (n)
am-|up; upwards (pref)
ama-|happily; *well (pref)
amacarastië|upbuilding (n)
amanya; manaitë|*blessed (adj)
amapta-|to ravish; to seize and carry off forcibly (vb)
amaquat-|to fulfill; (lit.) to up fill (vb)
amatixë|dot or point placed above the line of writing (n)
amatulya|welcome (of something blessed) (adj)
amatúlië|blessed arrival (n)
amaurëa|dawn; early day; morning (adj)
amaurë|dawn; early day; morning (n)
amavil-|to fly up; to soar (vb)
ama|up (adv)
amba (adj pron)|more (adj pron)
amba (adv)|up(wards) (adv)
ambahep-|to maintain; (lit.) to upkeep (vb)
ambalasar (ambalasarn-)|stalagmite; (lit.) up-growing stone (n)
ambalotsë|uprising-flower (n)
ambal|flag [stone]; shaped stone (n)
ambalë|yellow bird; yellow hammer (n)
ambar (ambart-)|doom; fate; lot (n)
ambarya|global; international; world-wide; worldwide (adj)
ambarónë|Orient; dawn; sunrise; uprising (n)
ambela|far away beyond; further still beyond (adv)
ambon|hill-side; upward slope (n)
amboraxosta|rib cage (n)
amboremma|bust; (lit.) breast-picture (n)
ambos (ambor-)|breast; *chest (n)
ambostulco|bra; (lit.) breast-support (n)
ambo|hill; rising ground (n)
ambuna|hilly (adj)
ambë|more (adv)
amil(lë); ammë|mother (n)
amilessë|mother-name (n)
amilosto|metropolis (n)
ammalë|yellow bird; ‘yellow hammer’ (n)
ammë; amya; emya|mummy (n)
amna|almost (adv)
amorta-; solta-|to heave (vb)
ampana-; ampanóta-; car-; carasta-|to build (vb)
ampanotalëa|architectural (adj)
ampanotastë|architecture (n)
ampano|building (especially of wood); construction; edifice; wooden hall (n)
ampanóta-|to construct; to erect a (large) building (vb)
ampa|crook; hook (n)
ampenda|uphill (adj)
ampendë|upward slope (n)
ampollië|great effort; struggle (n)
ampícië; undë|less (adv)
amya; amë; lio|much (adv)
amya; emya|(orig.) my mother (n)
an(a)|alongside; to; to a point near; towards (prep)
an(da)-; ar(i)-|superlative prefix (pref)
an(ner)|at hand (adv)
ana-|to; towards (pref)
anahtai|although; even though; (lit.) against-that-which (conj)
analelya-|to approach (vb)
ananta|and yet; but yet (conj)
anarórë; rómen|sunrise (n)
anasirë|tributary (n)
anastorna|*extremely hard (adj)
anat; apa; pá|against (prep)
anca|jaw; jaws; row of teeth (n)
ancárima|easy; (lit.) very doable (adj)
andalango|giraffe; (lit.) long-neck (n)
andalúmë|for a long while (adv)
andamacil|long sword (n)
andamba-|to smite (vb)
andamunda|elephant (n)
andanyarro|ferret; mink; polecat; stoat; weasel; (lit.) long-rat (n)
andanéya|long ago; once upon a time (adv)
andarestë|long-suffering; patience (n)
andarma-|to crash (vb)
andatehta|long mark; long-mark (n)
andatelco|long leg; long stem (n)
andavë|at great length; long (adv)
anda|far; long (adj)
ando (adv)|long (adv)
ando (n)|[great] door; approaches; door; gate; †entrances (n)
andon (andond-)|great gate (n)
andorië|dock; landing (place) (n)
andorya-|to dock; to land (vb)
andosan (andosamb-) [þ]|vestibule; (lit.) gate room (n)
andul|long pole (n)
andë|length (n)
andólama|long consonant (n)
andú-; nú-|going down; setting (of sun); west (pref)
andúna; númenya; núna|western (adj)
andúnë|(orig.) going down; evening; sunset; west (n)
andúta-|to lower (vb)
andúya-|to descend (vb)
anessë|given (or added) name; nickname; surname (n)
angaina|of iron (adj)
angal|mirror; *reflective surface (n)
angamendar (angamendár-)|train station; (lit.) iron way-stop (n)
angaraxa; raxasta|train (n)
angatië|railroad track; railway line; (lit.) iron-road (n)
anga|iron (n)
ango (angu-)|dragon; snake; *serpent (n)
angulóceluntë|dragon boat (n)
angulócë; hlócë (hlóci-); lócë (lóci-)|dragon (n)
anna|(orig.) thing handed; brought or sent to a person; gift; *present (n)
annún|at least (adv)
anqualë|*death agony (n)
anquantaina|complete; thoroughly filled (adj)
anqua|against; opposite (adj adv)
anta-|to give; to present; †to add to (vb)
antac-|to apply (vb)
antaro|high mountain; *(lit.) great height (n)
anta|cheek; face; jaw; *front of the head (n)
antelwa|later; (lit.) very late (adj)
anto (Body Parts and Functions)|mouth; mouth [as a thing for eating] (n)
anto (Possession and Trade)|giver (m.) (n)
antorya-|to strengthen [of sound] (vb)
antoryamë; turyandë|strengthening (n)
antë|giver (f.) (n)
anwa|gift (n)
anya-|to arrive at; to go to; to reach; to suceed (at something) + infinitive; *to manage (vb)
anyaitië|distance of capability; range; reach (n)
anyára|elder; *senior (adj)
an|but; for; furthermore; moreover; or; then (conj adv)
ap-|to affect; to concern; to touch one (vb)
apa; ar; mal|but (conj)
apa; epë; pó|after (of time) (prep)
apacendo|prophet; seer (n)
apacenya|of foresight (adj)
apacen|foresight; *(lit.) after-sight (n)
apanaina-|to regret; (lit.) to after-lament (vb)
apanta-|to display; to open; to reveal; to show (vb)
apantië|display; *revealing (n)
apaquet-|to forebode; to foretell; to predict (vb)
apa|on (above but touching); touching (prep)
appa-|to touch (vb)
appalë|feeling [physical]; sensation; sense of touch (n)
apsa|cooked food; meat (n)
apsen-|to forgive; to release; to remit (vb)
apta-|to refuse; to say nay (vb)
apterya-|to fix; to repair (vb)
apárilë|afternoon (n)
aquapahtië|privacy; *(lit.) full-closedness (n)
aqua|altogether; completely; fully; wholly (adv)
ar(a)-|high; noble (pref)
ar(a)|beside; next [to]; *by (prep)
ar-|beside; by-; near; outside (pref)
ar; yo|and (conj)
aralussë|aorist; (lit.) beside-tense (n)
aramallë|side-street (n)
aran; tár|king (n)
aranaitë|royal; *kingly (adj)
arandil|king’s friend; royalist (n)
arandur|minister; steward; (lit.) king’s servant (n)
aranel|princess (n)
aranisquë|frankincense (n)
aranië|kingdom (n)
aranta-|to turn over; (lit.) to give by (vb)
arantyalmë|chess; (lit.) king-game (n)
aranus(së)|kingship (n)
aranya|*royal (adj)
arasso|(male) deer; hart; stag (n)
arat (arac-)|weed (n)
arata; arta|exalted; high; lofty; noble (adj)
arauco; rauca|demon (n)
ara|beside; outside (prep)
arca-|*to petition (vb)
arca; náha|narrow (adj)
arcandë|*petition (n)
arcanwa|*throne (n)
arcólima|equivalent; (lit.) beside-bear-able (adj)
ardahyalma|[planetary] crust (n)
arda|particular land or region; realm; region (n)
arimaitë|[most] skillful; *gifted (adj)
arin; aurë|morning (n)
arinwat|breakfast; (lit.) morning-meal (n)
arinya|early; morning (adj)
arië|daytime (n)
armaro; asambar(o)|*neighbor (n)
armar|goods (collective-noun)
arma|ray of sunlight (n)
armen-|to accompany (vb)
aromundo|auroch; kine of Araw (n)
arosto|outskirts (of city, town); suburb(s); suburbia (n)
arpo|seizer; thief (n)
arquenië; arátië|nobility (n)
arquen|knight; noble (n)
arrongo|promptly; right away; very soon (adv)
arta (adv)|etcetera (adv)
arta (n)|fort; fortress (n)
artanwa|award (n)
artapano|chessboard (n)
artarindo; astarindo|bystander; supporter (n)
artatúrë; ohérë|government (n)
arwa|having; in control of; possessing (adj suf)
arya-; lahta-; ráta-|to excel (vb)
aryata-|to improve (vb)
arya|excelling; *better (adj)
aryon; hildë (hildi-)|heir (n)
aryonië|inheritance (n)
aryë|also; as well; besides; too (adv)
aráto|champion; eminent man; lord; noble (n)
arë (adv)|along; beside; near (adv)
arë (n)|day (n)
arëassë|nearness; proximity; vicinity (n)
arëa|close; nearby (adj)
as(a)- [þ]|easily (pref)
asa [þ]; sá [þ]|I agree of course; of course I do (adv)
asa- [þ]|to agree; to be willing (vb)
asahanyë [þ]|of course; understandably; (lit.) easily understood (adv)
asalastë [þ]|easily heard (adj)
asamahtë [þ]|simple; (lit.) easily handled (adj)
asanótë [þ]|*easily counted (adj)
asar [þ]|festival; fixed time (n)
asar(o) [þ]; asarta [þ]|doctor; leech (n)
ascara|impetuous; rushing; violent (adj)
ascarë [þ]|easily done (adj)
ascat-; saccat-|to break asunder; to rend (vb)
ascenë [þ]; ascénima [þ]|easily seen; visible (adj)
ascárima [þ]|easy [to do] (adj)
ascénië [þ]|obviously; *(lit.) easily seen (adv)
asië [þ]|comfort; ease (n)
asquétima [þ]|easy to say (adj)
assa|hole; mouth; opening; perforation (n)
asta-|to bake (by exposure to sun); to heat (vb)
astaincë|particle (n)
astai|whereas; (lit.) beside-that-which (conj)
astalda|strong; *valiant (adj)
astal|valour (n)
astamo|member (n)
astarmo|bystander; witness (n)
astar|faith; loyalty (n)
asta|division; month; part (esp. one of other equal parts) (n)
asto; mulo (mulu-)|dust (n)
asumo [þ]|colleague; friend at need; friend with shared interests (n)
asya- [þ]|to assist; to comfort; to ease (vb)
asyar [þ]|assistant (n)
asëa [þ]|healing herb (n)
asëa aranion [þ]|asëa of the Kings; kingsfoil (n)
at(a)-|[repeat a] second time; again; back; bi-; double; re-; twi- (pref)
at-|to capture; to catch (vb)
ataformaitë|ambidextrous (adj)
atahenta-|to revise; (lit.) to re-examine (vb)
atalantëa|downfallen; ruinous (adj)
atalantë|collapse; downfall (n)
atalta-|to collapse; to fall down; to fall in; to slip down in ruin (vb)
atamaitë|two-handed (adj)
atamenta-|to transmit (vb)
atamentië|transmission (n)
atamir|heirloom (n)
atannahtar|man-slayer (n)
atapengëa|bilabial (of consonants) (adj)
ataquanta-|to double fill; to fill a second time; *to refill (vb)
ataquer|bicycle; bike (n)
ataquetië|repetition; saying again (n)
ataquë|building; construction (n)
atar (n)|father (n)
atar (prep)|*for (prep)
atatya; atwa|double (adj)
ata|again; *(lit.) a second time (adv)
atesta-; pententa-|to mention (vb)
atintila-|*to sparkle (vb)
atsa|catch; claw; hook (n)
atsinta-|to recognize (vb)
attalya|biped; *(lit.) two-footed (n adj)
atta|two (cardinal)
attindo|doubt; (lit.) two mind (n)
attië|couple; group of two; pair (n)
atto|daddy; father (familiar/family); father (hypocoristic) (n)
attëa; atya; tatya|second (ordinal)
atya|(my) father; daddy (n)
atyenárë|anniversary (n)
atyo|*daddy (n)
au (Mind and Thought)|if only (adv)
au (Spatial Relations)|away; not here (of position); off (adv)
au(ve)|might (have); would (have) (adv)
au-; ava-; nec-|without (pref)
au-|away (from) (pref)
auca|foolish (adj)
aucelië|sewer; (lit.) away-flowing (n)
aucir-|to cut off (and get rid of or lose a portion) (vb)
aucië|foolishness (n)
aucol-|to remove; (lit.) to bear away (vb)
auhanta|garbage; refuse; trash; (lit.) thing thrown away (n)
aulerya-|to free somebody of something; to rid (vb)
aulë|invention (n)
aumanca-|to sell; (lit.) to trade away (vb)
aumapando|abductor; (lit.) away-seizer (n)
aumenta-|to dismiss; to divorce; (lit.) to away-send (vb)
aumentalë|dismissal; divorce (n)
aunotë(a); únotë(a)|not counted; uncounted (adj)
aupenya|complete; without lack (adj)
auqua|awkward; clumsy (adj)
auquer-|to reject; (lit.) to turn away (vb)
aura|possession; thing owned (n)
aurehen (aurehend-)|dandelion; (lit.) day-eye (n)
aurië|property; wealth [in possessions] (n)
aurëa|sunlit; sunny; *daytime (adj)
aurë|day (as opposed to night); daylight (n)
ausa [þ]|dim shape; spectral or vague apparition (n)
ausatië|especially; (lit.) setting aside (adv)
aut (auc-)|clumsy fellow; fool (n)
auta- (Mind and Thought)|to devise; to invent; to originate (vb)
auta- (Motion and Transportation)|to [variant: vanya-] to pass away; to be lost; to depart; to disappear; to go (away); to leave (vb)
auta-; hep-; öa-|to keep (vb)
auta-; öa-|to own; to possess (vb)
autaila|going away; passing away (adj)
autas (*autass-)|a former occur[rence] (n)
autulya-|to deport; (lit.) to bring away (vb)
autulyalë|deportation (n)
auvië|possession (abstract); *the act of possessing (n)
ava (adv adj)|beyond; exterior; outer; outside (adv adj)
ava (interj)|strong or curt refusal (interj)
ava-; vá-|negation (refusing or forbidden) (pref)
ava-|to forbid; to refuse (vb)
avahaira|very remote; *far beyond (adj)
avalda|excited; move[d]; stirred (adj)
avalerya-|to deprive of liberty; to restrain (vb)
avamarwa|homeless (adj)
avamat-|to fast; (lit.) to refuse to eat (vb)
avanev-|to avoid; (lit.) to refuse to face (vb)
avanir|unwill (n)
avanwa|banned; forbidden; refused (adj)
avanyárima|not to be told or related; unspeakable; what one must not tell (adj)
avaquétima|not to be said; that must not be said (adj)
avarta-; hehta-|to abandon (vb)
avatup-|to expose; to uncover (vb)
avatyar-|*to forgive; (lit.) to do away with (vb)
avëalta-|to resemble closely (vb)
axanwëa|logical (adj)
axanwë|(orig.) law of thought; logic (n)
axan|[divine] law or rule; commandment (n)
axendë|marrow (n)
axosta|skeleton (n)
axo|bone (n)
axula|bony (adj)
axë (axi-)|steel (n)
axë|neck [vertebrae]; rock ridge; *(upper) spine (n)
axína|(of) steel; *like steel (adj)
ca(na)sta|one fourth; *quarter (fraction)
ca(ta)|after; at back of place; behind (prep)
ca; cana|at back of place; behind (prep)
cacanna-|to advertise; to announce repeatedly; to herald; to propagate (vb)
cacannalë|advertisement (n)
cacarra-|to keep on doing; to *continue (vb)
cacátu-|to design; to shape or fashion slowly (vb)
cacáva|cocoa (n)
cahta|cause; motive; reason (n)
caila|lying in bed; *abed (adj)
caimasan (caimasamb-) [þ]|bedchamber (n)
caimassëa|a-bed; bedridden; confined to bed; sick (adj)
caimassë|sickness; (lit.) lying in bed (n)
caima|bed; couch (n)
caimenya|horizontal (adj)
caimen|horizontal direction (n)
cainen; quain; quëan|ten (cardinal)
cainu-|to [with locative] to endure; to lie down; to suffer (from); to *bend down (vb)
caira|eager [to do] (adj)
caita-|to lie (down); to place; *to lay (transitive) (vb)
cal-; sil-|to shine (vb)
cala; calma|light (n)
calaina|serene (adj)
calainë|serenity (n)
calambar|*light-fated (adj)
calampa|spoon (n)
calar; calma|lamp (n)
calarus (calarust-)|polished copper (n)
calarwa|optical (adj)
calas (calass-)|brass (n)
calassina|brazen; *made of brass (adj)
calatengwë|photograph; (lit.) light-writing (n)
calcata-|to glaze (vb)
calca|glass (n)
calcëa|glassy; of glass (adj)
calima|bright; luminous (adj)
calina; linda|light (adj)
calina|bright; light; sunny; (lit.) illumined (adj)
calleva|fair (weather or complexion) (adj)
callië|heroism (n)
callovëa|hero-like; heroic (adj)
callo|hero; noble man (n)
callë|blue sky; clear sky; fair weather (n)
calmatan|lampwright (n)
calmatarma|lampstand (n)
calmatéma|k-series (n)
calma|(device for shining) light (n)
calpa-|to bale out; to draw water; to scoop out (vb)
calpa|bucket; water-vessel (n)
calta-|to (cause to) shine; to kindle (lamp etc.); to light up; to set light to (vb)
calwa|lurid (adj)
calya-|to illuminate (vb)
camba|(cupped) hand; hollow of the hand (n)
cambië|gain; income; intake; profit (n)
cambë|hollow (of hand) (n)
camma|receptacle (n)
campo|flea (n)
camya-|to contain; to hold (vb)
can-|to claim; to demand (when applied to things) (vb)
candóla|crown of head (n)
canguru|kangaroo (n)
canquain|forty (cardinal)
canquëa|fourteenth (ordinal)
canquë|*fourteen (cardinal)
canta (cardinal)|four (cardinal)
canta (n adj)|frame; shape; shaped (n adj)
canta (n)|frame; framework; shape; shaped (n)
cantallumë|four times (adv)
cantalya|four-legged; quadruped; (lit.) four-footed (adj n)
cantemma|sculpture; shaped image (n)
cantil (cantild-)|quadrangle; rectangle; square; *quadrilateral (n)
cantilya|quadrangular (adj)
cantië; ocantië|pattern (n)
canton (cantond-)|soapstone; (lit.) sculpted rock (n)
cantëa; maitë (maiti-)|shapely (adj)
cantëa|fourth (ordinal)
canuina|of lead (adj)
canuva|leaden (adj)
canu|lead [metal] (n)
canwahimië|obedience (n)
canwahimya|obedient (adj)
canwa|announcement; order (n)
canya-|?to command (vb)
cap-|to jump; to leap (vb)
capaitë|bounding; leaping (adj)
capanda|jump (n)
capsa|case; vessel; *container (n)
capta-|to make spring; to scatter; to startle (vb)
car (card-)|building; house (n)
car-|to do; to make (vb)
caraitië|activity; business (n)
caraitë (caraiti-)|able to make; active; busy; craftsmanlike; crafty; handy; skilled (adj)
caramaitë|able to make; craftsmanlike; crafty; handy; skilled (adj)
caranya-|to make red; to redden (vb)
caras (caras-)|lettuce (n)
carassë|built fort or dwelling surrounded by bulwarks (n)
carasta-|to construct (vb)
carastanyarro|beaver; (lit.) build-rat (n)
carasta|construction; making; manufacture (n)
caraxë|jagged hedge of spikes; row of spikes or teeth (n)
carcanë|row of teeth (n)
carcapolca|boar; *(lit.) tusk-pig (n)
carcaran|crocodile; (lit.) toothed-beam (n)
carcara|toothed (adj)
carcasarma [þ]|large saw (n)
carca|fang; tooth; tusk (n)
carda|deed; *action (n)
carina (Physical Acts and Materials)|done; finished; made (adj)
carina (Time)|made (adj)
carino-|to get finished/made (vb)
cariquetta|verb (n)
cariëndë|process of manufacture; production (n)
carië|doing; making (n)
carmatan (carmatam-)|toolsmith (n)
carma|implement; means; tool; weapon (n)
carmen (carmend-)|recipe (n)
carmë|making; production; structure (n)
carniambos|robin; (lit.) red-breast (n)
carnë (carni-)|red; scarlet (adj)
carpalos [þ]|tulip; (lit.) hat-flower (n)
carpë|hat (n)
carranta|strategy; (lit.) action-course (n)
carrëa|tressure; *headdress (n)
cas (adv)|towards the top; upwards (adv)
cas (car-)|head; top (n)
cas (n)|head (n)
cas(ta)|to(wards) the top; upwards (adv)
castol(o)|helmet (n)
castor|beaver (n)
castëa|top (with added sense of prominent, chief) (adj)
cat-|to fashion; to shape (vb)
catamen|background; milieu (n)
catassa|anus; arsehole; (lit.) behind-hole (n)
cata|after (prep)
cato|afterwards (adv)
catta|back (n)
cauma|protection; shelter; shield (n)
cav-|to receive; to *accept (vb)
cecenna-|to visit (vb)
cecet|pheasant (n)
cehtecet|clucking (n)
celeta|trickle (n)
celima|fluent; *able to flow freely (adj)
celma|channel (n)
celu-|to (begin to) flow; to spring forth (of water) (vb)
celumë|flood (tide); flow(ing); stream (n)
celundë|welling forth (n)
celurë|fountain (n)
celussë|freshet; water falling out swiftly from a rocky spring (n)
celusta|outflow (n)
celut; siril|rivulet (n)
celuva|original (adj)
celu|origin; source (n)
celvacir|butcher (n)
celvamatta|animal food (n)
celvamatya|carnivorous; (lit.) animal-eating (adj)
celvatarwa|zoo; (lit.) life-garden (n)
celvavëa; lamanwa|animal-like (adj)
celva|animal; living thing that moves (n)
celvë|deer; doe; hind (n)
cemellet (cemellept-)|asparagus; (lit.) earth-finger (n)
cemendur|farmer (n)
cemenquasië [þ]|earthquake (n)
cemen|Great Lands; earth; soil; the earth (n)
cemiëvëa|chemical (adj)
cemië|chemistry (n)
cemnaro|potter (n)
cemnassë|earthenware; pottery (n)
cemna|earthen; of earth (adj)
cemorva|potato; (lit.) earth-apple (n)
cen-|to behold; to look; to see; to *perceive (vb)
cenai|if it be that (conj)
cenasit; cenasta|if it be so; may be; perhaps (adv)
cenda-|to observe (for some time); to read; to watch (intensively) (vb)
cenda|inspection; reading (n)
cendelë|face; *visage (n)
centa|enquiry; *essay (n)
cenya|*seeing (adj)
cen|sight; *sense of sight (n)
cenítë|seeing; *able to see (adj)
certa|rune (n)
ces- [þ]|to examine (in order to find something); to search (vb)
cesië [þ]|search (n)
cesta-|to ask (vb)
cesula [þ]|curious; inquisitive (adj)
cesya- [þ]|to cause interest; to interest (oneself); (lit.) to cause one to enquire (vb)
cesyarë [þ]|interest (n)
cesyarëa [þ]|interesting (adj)
ceu; céva|fresh; new (adj)
ceula|?alive (of vegetable) (adj)
ceulë|*renewal (n)
ceura; ceurë|renewed (adj)
ceuran (*ceurán-)|new-moon (n)
ceuranar (ceuranár-)|new sun after solstice (n)
ceuta-|to refresh; to renew (vb)
cil-|to choose; to select (vb)
cilintilla|looking-glass; *mirror (n)
cilintír|looking-glass (n)
cilinyul (*cilinyulm-)|drinking-vessel (made of glass) (n)
cilin|glass [transluscent or reflective] (n)
cilmessë|self-name (n)
cilmë|choice; choosing; *selection (n)
cilometer|kilometer (n)
cilta-|to divide; to separate (vb)
ciltië|division; separation (n)
cimba-|to care (vb)
cimba|brink; edge (n)
cir-|to cleave; to cut; *to separate from (vb)
circa|sickle (n)
cirda|splinter; wood shaving (n)
cirihta-|to harvest; to reap (vb)
cirihtor|reaper (n)
cirincë|scarlet-plumed species of bird (n)
cirissë|gash; slash (n)
cirma; sicil|knife (n)
cirmacin (cirmacim-)|knife-edge (n)
cirya (Motion and Transportation)|(sharp-prowed) ship; boat; swift gliding (n)
cirya (Physical World)|cleft; pass (n)
ciryamo|mariner (n)
ciryampa|anchor; (lit.) boat-hook (n)
ciryando; ciryaquen|sailor (n)
ciryaquen|shipman (n)
ciryasta-|to sail [a ship]; to *make a ship go (vb)
ciryasta|fleet (of ships) (n)
ciryatan|shipbuilder; shipwright (n)
citya-|to tickle (vb)
cityalëa|sensitive; susceptible; ticklish (adj)
cityalë|tickling (n)
ciuca; tiuco|thigh (n)
coilemma|biological artifact/relic; fossil (n)
coimas (*coimass-)|lembas; life-bread (n)
coimen (coimend-)|life-year (n)
coina|alive (adj)
coingolmë|biology (n)
coirëa|living (adj)
coirë|Stirring; early spring (n)
coita-|to be alive; to have life; to live (vb)
coiva; coivenqua; nesya [þ]|lively (adj)
coivenqua|vibrant; vivacious; (lit.) full of life (adj)
coivië|life; liveliness (n)
col-|to bear; to carry; to wear (vb)
colbanavië|gestation; *(lit.) womb-being (n)
colcallë|phylactery; (lit.) little box (n)
colca|box (n)
colindo|bearer (n)
colla|borne; cloak; vestment; worn (adj n)
collo|cloak (n)
colma|stretcher (n)
coloitië|endurance; fortitude; staunchness (n)
coloitë (coloiti-)|capable of bearing; enduring; tolerant (of) (adj)
colonda|burdened; sad; weighed down (adj)
colosta|cucumber (n)
colta-|to burden; to lade; to weigh down (vb)
colucë|strainer (n)
combë|assemblage; assembly; collection; gathering (n)
comya-; hosta-|to collect (vb)
comë (comi-)|group (n)
coranar (coranár-)|(solar) year; (lit.) sun-round (n)
corco|crow (n)
cordamo|cleric (n)
corda|temple (n)
cordon|idol (n)
corin|circular enclosure; great circular hedge (n)
corma|ring (n)
corna|globed; round (adj)
cornë; masta|loaf (n)
coromindo|cupola; dome (n)
coron (corn-) (Physical World)|ball; globe; mound (n)
coron (corn-) (Spatial Relations)|ball; globe (n)
corpë|skull (n)
corta-|to pack; to roll (up) (vb)
cortangwa|button; (lit.) circle-fastener (n)
corto; rindë|circle (n)
costa-|to debate; to dispute; to quarrel; to *argue (vb)
costaima|debatable (adj)
costula|belligerent; quarrelsome (adj)
costë|dispute; legal action; quarrel (n)
cotto|*enemy (n)
cotumo|enemy (n)
cotwë|struggle; wrestling (n)
cotya|hostile (adj)
cucua|dove (n)
cucumba-|to nod repeatedly; (lit.) to keep on bowing (vb)
cucuollë|turtledove (n)
cuilórëa|absent-minded; (lit.) day-dreamy (adj)
cuilórë|day-dream; (lit.) awake-dream (n)
cuita-|to live; to rouse; to waken (vb)
cuitar|alarm; device to waken somebody (n)
cuiva|awake (adj)
cuivië; cuivë|awakening (n)
cuivëa|wakening (adj)
culda; culina|flame-coloured; golden-red (adj)
cullingwë|goldfish (n)
cullo|red gold (n)
culmírë|carneol [carnelian]; sardius; (lit.) orange-jewel (n)
culuina|orange (coloured) (adj)
culumalda|laburnum; *(lit.) orange-tree (n)
culuma|orange [fruit] (n)
culvelyávë|pumpkin (n)
cumba|*bellied (adj)
cumbo|belly (n)
cumna; lusta|empty (adj)
cumya-|to empty (vb)
cundo (cundu-)|guardian; lord; prince (n)
cunduina|of princes; princely (adj)
cundu|prince (n)
cungandë|violin; (lit.) bow-harp (n)
cunta-; heru-|to rule (vb)
cunya-|to reign over; to rule; to *govern (vb)
cupta-|to deceive; to lie (vb)
cuptalë|deceit; deception (n)
cuptamo|deceiver; liar (n)
cupta|deception; lie (n)
curo (curu-)|skillful (?device) (n)
curu; maitilë|skill (n)
curuni|female magician (not necessarily evil); witch; *sorceress (n)
curwa|cunning; skillful (adj)
curwesta|technology (n)
curwë|craft; skill of the hand; technical skill and invention (n)
cuv- (Physical Acts and Materials)|to bow [the body] (vb)
cuv- (Spatial Relations)|to conceal; to *hide (vb)
cuvoitë (cuvoiti-)|hiding; secretive; treacherous (adj)
cuvo|hider (n)
cámalóra|innocent (adj)
cámayanca|guilt-offering (n)
cáma|guilt; responsibility (n)
cána|backward (adv)
cáno; turco|chief (n)
cáno|chief(tain); commander; governor; herald; ruler; †crier (n)
cárima|able to be done; able to be made; feasible; possible (to do) (adj)
cávima|acceptable (adj)
céla|maybe not (adv)
cénima|able to be seen; visible (adj)
céta-|to offer; to propose; to suggest; (lit.) to make an opportunity (vb)
cé|may (be) (adv)
cëa|*hedge (n)
cë|you (sg) (pron)
címa|edge of a cutting weapon/tool (n)
címëa|edged (adj)
cólemaina|patient (adj)
cólema|endurance; hardship; patience (n)
cóleva|passive (adj)
cólima|bearable; light (of burdens and things comparable, troubles, labors, afflications) (adj)
cólo; mólomë|burden (n)
cólë|a passive individual; endurance; passivity; patience (n)
cómë|file (n)
cöacalina|indwelling spirit; light of the house (n)
cöacolindo|snail; (lit.) house-bearer (n)
cöantur|householder; master of the house (n)
cöa|booth; building used for a dwelling or other purposes; house; hut; outhouse; shed; †body (n)
cúma|void (n)
cúna-|to bend (vb)
cúna|bent; curved (adj)
cúnë|arch; crescent (n)
cúvima|concealable (adj)
cúvula|flexible; pliant (adj)
cú|bow (n)
ec-|to can; to have a chance of; to may (vb)
eccahta|hawthorn; (lit.) thorn-hedge (n)
eccaira|?out-far (adj)
eccalda|cactus; (lit.) spine tree (n)
eccan-|to assert; to proclaim; (lit.) to forth-call out (vb)
ecca|hole; *lair (n)
ecces- [þ]|to find out; to bring out by examining or eyeing[?] (vb)
eccoia|thorny (adj)
eccol-|to export (vb)
ecco|point; spine; thorn (n)
eccuinu-|to awake; to wake up (vb)
ecellë|hedgehog; urchin (n)
ecesta|chance; opportunity (n)
ecet|short stabbing sword (n)
ef-|to emerge (especially from water) (vb)
effírië; unqualë|death (n)
ehta-|to stab (vb)
ehtelu-|to bubble up; to well (vb)
ehtelë|issue of water; spring (n)
ehten|outlook; sight; spectacle; view (n)
ehtipolca|porcupine; (lit.) spike-pig (n)
ehtyar|spearman (n)
elanar|pimpernel; (lit.) sun-star (n)
ela|behold! (interj)
eldafindë|maidenhair fern; (lit.) elf tress (n)
eldë|you (plural emphatic) (pron)
elecetomacnetëa|electromagnetic (adj)
elen; él|star (n)
elengolmë|astronomy (n)
elenitsë|firefly; (lit.) star-fly (n)
elenya|adjective referring to the stars; stellar; *of the stars (adj)
elhísë [þ]|nebula; star cloud (n)
ella|for you; of you (pron)
ellumë; millumë|once; one time (adv)
ellë|2nd pl emphatic (pron)
ellöa|next year (n)
elma-|to admire; to marvel at (vb)
elma|miracle; wonder (n)
elmenda|wonder; wonderment (n)
elmendëa|wonderful (adj)
elmë|we (emphatic inclusive); *we (emphatic exclusive) (pron)
elvëa|starlike (adj)
elvë|we (emphatic inclusive) (pron)
elyë|thou (emphatic polite) (pron)
em-|to depict; to portray (vb)
emba-|to draw (something); to paint (vb)
embë|drawing; painting (n)
emel|love [abstract] (n)
emer-|?to herd (sheep) (vb)
emerro|herdsman; shepherd (n)
emerwen|shepherdess (n)
emino|character (in a story) (n)
emmata-|to draw/create (a picture); to photograph (vb)
emma|picture; *image (n)
emmë|we (emphatic exclusive); *we (dual emphatic exclusive) (pron)
empatyellë|advancement; progress (n)
en (end-)|far away; in that (future) case; look yon(der); that; there; yonder (pron adv)
en-|again; re- (pref)
enar|tomorrow (n)
endaurë|noon; (lit.) mid-day (n)
enda|centre; heart; *interior (n)
endemat (endematt-)|lunch; (lit.) mid-meal (n)
ender|bridegroom; *groom (n)
endëa|middle (adj)
endë|centre; core; middle (n)
enelmo|go-between; intermediary; intervener; mediator (n)
enel|between; in the middle (prep)
enenquëa|sixteenth (ordinal)
enenquë|sixteen (cardinal)
eneques|rumor; (lit.) re-saying (n)
ener(a)|further; on; onward (adv)
enet-; enetya|extra; more than needed; spare (adj)
enga|save; *except (prep)
engwa; hlaiwa; quolina|sickly (adj)
engwë|thing [that exists] (n)
engë|ago; once (in past); †it was (adv)
enna|fact (n)
ennë|purpose; thought (n)
ennóna|born again (adj)
enortalë|resurrection (n)
enquain|sixty (cardinal)
enquanta-|to refill (vb)
enquellumë|six times (adv)
enquesta|one sixth (fraction)
enquet-|to repeat; to say again (vb)
enquië|Elvish week of six days (n)
enquëa|sixth (ordinal)
enquë|six (cardinal)
enta (adj)|another; one more; that yonder; then (fut.) (adj)
enta (pron adv)|that yonder; then (fut.) (pron adv)
entul-|to come again; to *return (vb)
entulessë|return (n)
entë|further(more); moreover; what is more; *next (of time or in a sequence) (adv)
envinyata-|to heal; to renew; to *restore (vb)
enwina; linyenwa; yerna; yára|old (adj)
enya (adj)|*central (adj)
enya (adv)|then soon (adv)
enyal-|to recall; to *remember (vb)
enyalië|memory; (lit.) recalling (n)
enyálëa|memorial (adj)
enyárë|in that day (adv)
en|(then) soon; in that (future) case; look yon(der); there; yonder (adv)
ep(e)ta|following that; thence; thereupon; whereupon (conj)
epeharmo; nóriëcáno|president (n)
epemat (epematt-)|dessert; (lit.) after-meal (n)
epemma; hócilmë|example (n)
epessë|after-name (n)
epetai|consequently; thence; thereupon; whereupon; (lit.) following which (fact) (conj)
epta-|to offer; to place at somebody’s disposal; (lit.) to [make be in] front (vb)
epë|before (in all relations but time); following (prep)
eques (equess-)|(current or proverbial) dictum; quotation from someone’s uttered words; saying; statement; *quote (n)
equi|even if; even though; (lit.) indeed-if (conj)
equë|to said; to say; to says (vb)
erca-; irta-; nasta-|to prick (vb)
ercassë|holly (n)
erca|prickle; spine (n)
erda|deserted; solitary (adj)
erdevainë|peapod; seed pod (n)
erdë (Agriculture and Vegetation)|germ; seed (n)
erdë (Quantity and Number)|singularity (n)
eressëa|lonely (adj)
eressë|solitude (n)
eretildo|unicorn (n)
erinqua|alone; single (adj)
eritë|singular (adj)
erië|oneness (n)
ermaitë (ermaiti-)|concrete; material (adj)
ermangolmë|[possibly also] chemistry; physics; study of matter (n)
erma|(physical) matter (n)
ernóna|only-begotten; only-born (adj)
erta-|to unite (vb)
ertië|union (n)
erumë|desert (n)
erya|only; single; sole (adj)
er|alone; one (adj adv)
escë|noise of leaves; rustle (n)
essë; issë|he; it (emphatic); *she (pron)
essë|name (n)
esta-|to name (vb)
estaina|named; *called (adj)
estat-|to distribute (in even portions); to *partition (vb)
estatina|distributed; divided; shared (adj)
estatië|portion; share (n)
esta|outwards (adv)
estelenca|despairing; desperate; hopeless (adj)
estelya-; mer-|to hope (vb)
estel|hope; trust; *faith (n)
estirnë|brow (n)
estolië|camp (n)
esto|they (dual emphatic) (pron)
et(e)-|forth; out (pref)
etanta-|to publish; (lit.) to out-give (vb)
etehat-|to throw out (vb)
etelehta-; eterúna-|*to deliver (vb)
etelehto|deliverer (n)
etelelya-; etemen-; etsurya- [þ]|to go out (vb)
etelesta-|to measure (out) (vb)
etemen-|to go forth (vb)
eteminya; minda; tolya|prominent (adj)
etequet-|to confess; to speak out (vb)
eterahta-|to reach out (vb)
etevatta-|to trample out (vb)
ethenta-|to read aloud (vb)
etil|ivy (n)
etsat-|to distribute in even portions (vb)
etsatië|especially (adv)
etsen-|to forget; to let loose; to release (vb)
etserca-|to bleed out; to exsanguinate (vb)
etsir|mouth of a river; *(lit.) outflow (n)
etsurya- [þ]|to *blow out (vb)
etsë|exterior; outside (n)
etta (conj)|*therefore; (lit.) out of that (conj)
etta (pron)|his (pron)
ettalan|balcony (n)
ettanië|spectacle; (lit.) showing forth (n)
ettelëa|foreign (adj)
ettelë|foreign parts; outer lands (n)
ettemo|foreigner (n)
ettir-|to spy on; to watch out (vb)
ettirno|spy (n)
ettuc-|to draw out (vb)
ettul-|to come out; to issue; *to come forth (vb)
ettë (adj adv)|outside (adj adv)
ettë (pron)|they (two) (pron)
etulya-|to pour forth; to pour out (vb)
etyanetië; imnetyalë|hypocrisy (n)
etya|exiled (adj)
et|out (of) (prep)
eulë|lamb (n)
evandilyon|gospel (n)
evandil|[Christian] missionary (n)
exanen|in an other way; otherwise (adv)
ezel(la); laiqua; venya|green (adj)
fafarra-|*to keep on hunting (vb)
faica|contemptible; mean (adj)
failanta|justified (adj)
failassë|fair-mindedness; justice (n)
failata-|to justify (vb)
failatië|justification (n)
faila|fair-minded; generous; just (adj)
faina-|to emit light (vb)
fairë; nalta [ñ-]|radiance (n)
fairë|phantom; spirit (disembodied); †radiance (n)
fai|*before of time (adv)
falampa|whip (n)
falarië|splash; splashing (n)
falarya-|to splash (vb)
falassëa|coastal (adj)
falassë|(wave-beaten) shore; beach; line of surf; seashore (n)
falasta-|to foam; to make a sound like surf; to surge (vb)
fallë; ving(a); vingë|foam (n)
falmar(in) (falmarind-)|nymph; sea-fay (male); sea-spirit; spirit of the sea foam (n)
falmaril|aquamarine; (lit.) wave-crystal (n)
falma|(crested or foaming) wave; (crested) wave; breaker (n)
falpa-; ripta-|to flog (vb)
falwa|turquoise; (lit.) pale surf colour (adj)
fana|(bright) shape or figure; bodily form of an angelic spirit; raiment; veil (n)
fanga|beard (n)
fanorcarnë|sardonyx (n)
fanta-|to cloak; to mantle; to muffle; to veil (vb)
fantercenya|penetrating of sight or understanding; perspicacious (adj)
fanto|whale (n)
fanwa|screen; veil (n)
fanwë|steam; vapour (n)
fanya (n adj)|sky; white (n adj)
fanya (n)|(white) cloud; white and shining [thing] (n)
fanyarë|the skies (not heaven or firmament); the upper airs and clouds (n)
fara-|to hunt (vb)
faralë; farasta; roimë|hunting (n)
farasta|the chase (n)
farastëa|of the chase (that it is proper to hunt); *of prey (adj)
faren|enough (adv)
farina|fugitive; hunted (adj)
farino|fugitive; hunted man; outlaw (n)
farinë|vermin (n)
farma|?carpet (n)
farmë; fárë|all that is wanted; plenitude; sufficiency (n)
farna|prey; quarry (n)
farnë (farni-)|ash; rowan (n)
farta-|to sate; to satisfy (vb)
farya-|to suffice (vb)
fas (fass-)|fringe; tassel (n)
fassalë|(tasseled) fringe (n)
fassitë|tasseled (adj)
fassëa|shaggy; tangled [hair] (adj)
fassë|shaggy lock; tangled hair (n)
fasta- (Body Parts and Functions)|to tangle (vb)
fasta- (Emotion)|to please (vb)
fasta|pleased (adj)
fauca; soica|thirsty (adj)
fauca|parched; (lit.) open-mouthed (adj)
fel-|to feel (emotions) (vb)
felehta-|to mine; to tunnel; *to excavate (vb)
felminqua|full of feeling; passionate (adj)
felmë|impulse; *emotion (n)
felya|boring; cave; mine; tunnel (n)
fendassë|doorway; gateway (n)
fenda|threshold (n)
fendë|door (n)
fennatir|door-watcher (n)
feren (fern-); fernë|beech-tree (n)
ferinya|beechen (adj)
ferna|beechnuts; mast (n)
ferya-|to make ready (promptly); to *prepare (vb)
ferya|prompt; quick; ready (adj)
feuna|abhorred; aghast (adj)
feuya-|to abhor; to feel disgust at (vb)
fifíru-|to slowly fade away (vb)
filiculumpë|ostrich; (lit.) sparrow-camel (n)
filincë|finch (n)
filit (filic-)|small bird; sparrow (n)
fillannë|sack-cloth (n)
filquë|fern (n)
fimbë (fimbi-)|slender; *thin (adj)
finca|clever (in petty ways); *tricky (adj)
finda (Body Parts and Functions)|-haired; having hair (adj)
finda (Spatial Relations)|fine and delicately made (adj)
findelë|lock [of hair]; tress (n)
findessë|head of hair; person’s hair as a whole (n)
findimaitar|barber; hairdresser (n)
findori|barley (n)
findë|braid of hair; hair (especially of the head); tress; tress or plait of hair (n)
finië|cunning (n)
finta-|to decorate a thing with delicate work; to finish off; to make; to show skill (vb)
fintalë|trick (n)
fintemótalë|industry; (lit.) making toil (n)
finwa; formaitë; fínëa|dexterous (adj)
finwa|clever; delicate; fine (adj)
finya-|to do/make a thing (with fine work) (vb)
finyalë|cleverness (n)
finya|clever (adj)
finë (fini-)|(single) hair; filament (n)
finëa|downy; hairy [specifically fine, light hair] (adj)
finë|larch (n)
fion (fiond-)|hawk (n)
fir- (Body Parts and Functions)|to breathe forth; to die; to fade; to †expire (vb)
fir- (Motion and Transportation)|*to fade (vb)
firinga|carcanet; necklace (n)
firin|dead (by natural cause) (adj)
firya|human; mortal (adj)
firë|mortal man (n)
fisica|physics (n)
for-|north; right-hand (pref)
formaitë|righthanded (adj)
forma|right-hand (n)
formenya; forna|northern (adj)
formen|north; right hand; right-hand [direction] (n)
fornúmen|northwest (n adj)
fornúna|northwestern (adj)
forrómen|northeast (n adj)
forróna|northeastern (adj)
fortë (forti-)|right or north (adj)
forya|dexter; right (hand) (adj)
fuinë|deep shadow (n)
fána; fánë; ninquë (ninqui-)|white (adj)
fána|cloud; white (adj n)
fárëa|enough; sufficient (adj)
férima|(quickly) available; ready to hand (adj)
fëafelmë|*spirit-impulse (n)
fëa|(indwelling or incarnate) spirit; soul (n)
fínë|dexterity (n)
fírima|mortal; *(lit.) able to die (adj)
fírimárë|mortality; the state of being mortal (n)
fírië|death (of Men); *natural death (n)
fó|nay; no (interj)
föalócë|*breath-dragon (n)
föa|breath; puff of breath (n)
hac-; yanga-|to yawn (vb)
hac-|to squat (vb)
hacca|buttocks; the hams (n)
hahta|fence; hedge (n)
haila|far beyond (adj)
hailë|distancing; removal (n)
haimelëa|cultural (adj)
haimelë|culture (n)
haimë; sito (situ-)|habit (n)
haimëa; sitina|habitual (adj)
haira|far; remote (adj)
hairië|distance; (lit.) farness (n)
haita-|to remove; (lit.) to make distant (vb)
haiya; háya|far away; far off (adv)
hala (Animals)|(small) fish (n)
hala (Physical World)|cast shadow; *shade (n)
halatir(no) (halatirn-)|kingsfisher; (lit.) fish-watcher (n)
halda; halla; tunda; tára|tall (adj)
halda|hidden; shadowed; shady; veiled (adj)
halya-|to conceal; to screen from light; to veil (vb)
hamna|(artificial) mound; heap; pile (n)
hampa|delayed; kept; restrained (adj)
hampë|clothing; garment (n)
han-|*back as an answer or return by another agent (pref)
han; lá|beyond (prep)
hana; talca|post (n)
handassë|intelligence (n)
handa|intelligent; understanding (adj)
handelë|intellect (n)
handelóra; úhandëa|witless (adj)
hando|big brother; ‘big bro’ (intimate) (n)
handë|knowledge; understanding (n)
hanno|brother (diminutive) (n)
hanquenta|answer; *response (n)
hanquet-|to answer; to *respond (vb)
hanta-|to give thanks; to thank (vb)
hantalë|thanksgiving (n)
hanustar|monk (n)
hanusta|monastery (n)
hanuvoitë|*masculine (adj)
hanu|male; male animal; man (of Men or Elves) (n)
hanwa (adj)|male (adj)
hanwa (n)|seat; *chair (n)
hanya-|to be skilled in dealing with; to know about; to understand (vb)
hanúrë|manliness; masculinity (n)
hanúva|doughty; *manly (adj)
hanúvië|doughtyness; manhood (n)
hap-|to bind; to restrain (vb)
hapta-|to ejaculate; to eject (vb)
hapya-|to delay; to keep (temporarily); to retain (vb)
har- (Dwelling and Furniture)|to abide; to dwell; to reside; to sit (vb)
har- (Spatial Relations)|to remain; to sit; to stay (vb)
haranyë|century (100 years) (n)
harina; hastaina; sahta; úvana; χarina|marred (adj)
harivë|closely; nearly (adv)
harma; huan (hún-)|hound (n)
harma; narmo [ñ-]; ráca|wolf (n)
harma|treasure; treasured thing (n)
harna-|to wound (vb)
harnalassë|malicious enjoyment derived from observing someone else’s misfortune; schadenfreude; (lit.) wound-joy (n)
harnalë; hyanda|damage; harm (n)
harna|wounded (adj)
harno|possessor (n)
haru-|to sit down; to take a seat (vb)
haruni|grandmother (n)
haru|grandfather (n)
harwë; nahtë|wound (n)
harwë|treasure; treasury (n)
harya-|to have; to possess; to *hold (vb)
hasa- [þ]|to (help to) cure; to make easy; to treat (medically); to treat kindly (vb)
hasaino [þ]|patient; (lit.) medically treated one (n)
hasarë [þ]|medicine (n)
hasarëa [þ]|medical (adj)
hasiëndë [þ]|a process of treating medically; therapy (n)
hassë (hass-)|little brother; ‘lil bro’ (intimate) (n)
hasta-|to mar (vb)
hastalë; quelehtië|corruption (n)
hastima|corruptible (adj)
hat (haht-)|comb; crest; ridge (n)
hat- (Motion and Transportation)|to fling; to hurl; to *throw; to through[?] down[?] (vb)
hat- (Physical Acts and Materials)|to break asunder (vb)
hatal; ehtë (*ehti-)|spear (n)
hatal|*javelin (n)
hatar|thrower (of spears and darts) (n)
hatta|missile (n)
haura|hoard; store (n)
hauro|cupboard; piece of furniture used for storing; wardrobe (n)
hausta|nest (n)
hauta-|to cease; to stop; to take a rest (vb)
havarcë|cookie (n)
havar|a loaf or cake of [unleavened] bread (n)
ha|it; subjective abstract particle (pron)
heca|be gone!; stand aside! (interj)
hecilo|one lost or forsaken by friends; outcast; outlaw (m.); waif (n)
hecil|one lost or forsaken by friends; outcast; outlaw; waif (n)
hecilë|one lost or forsaken by friends; outcast; outlaw (f.); waif (n)
hecima|special (negative) (adj)
heconna|bastard; child born out of wedlock (n)
hehta-|to exclude; to forsake; to leave out; to put aside (vb)
hehtar|renegade (n)
hel-|to freeze (of water) (vb)
hela|*other than (conj)
helca|ice-cold; icy (adj)
helcehtyar|narwhal; (lit.) ice-spearman (n)
helcelimbë|*icicle; (lit.) ice-drop (n)
helcelmë|glacier; (lit.) frozen flow (n)
helcë|ice (n)
heldassë|nakedness (n)
helda|naked; stripped bare (adj)
helet (helets-)|fur; fur-coat (n)
helexë|hail (n)
helillos [þ]|wisteria; (lit.) purple cluster (n)
helina|frozen (adj)
helinillëa|*violet [colour] (n)
helinillë|violet [flower] (n)
helinquila|mauve (n)
helinwa|(of colour) a blue-violet; of pansies (n)
helin|pansy (n)
helissar|amethyst (n)
hellë; menel; telumë; vilya|sky (n)
helma|fell; skin; *hide (n)
helmolpë|wine-skin; (lit.) skin-bottle (n)
helmunquë|wrinkle; (lit.) skin-hollow (n)
helquir (helquirm-)|ice cream (n)
helta-|to bare; to denude; to despoil; to peel; to strip (vb)
helwa|(pale) blue (adj)
helyanwë|rainbow; *sky-joining; (lit.) sky-bridge (n)
hempa|cord (n)
hen (hend-)|eye (n)
hencalcat|eye-glasses; spectacles (n)
henca|rare (as opposite of dense) (adj)
hencúnë|eyebrow; (lit.) eye-arch (n)
hendelúpëa cecet|peafowl; (lit.) eye-plumed pheasant (n)
hendumaica|sharp-eye[d] (adj)
henfanwa|eye-screen; veil upon eyes (n)
henta-|to examine; to eye; to read; to scan (vb)
hententa-|to spot with eye (vb)
hentië; tengwië|reading (n)
hentópa|eyelid (n)
henulca|*evil-eyed (adj)
hequa|except; excluding; leaving aside; not counting (prep adv)
heren (Possession and Trade)|fortune; (lit.) governance (n)
heren (Quantity and Number)|order; *association (n)
herenya|fortunate; rich; wealthy (adj)
heri|lady (n)
heru-|to be master of; to lord it over; to own (vb)
herulatsë|domain; estate (n)
heru|lord; master (n)
hes (hest-)|*sibling (n)
hessa|withered (adj)
hesta(lë)|the nearest consanguinity (n)
hesta-|to wither (vb)
hesto|captain (n)
hexan (hexamb-)|lavatory; toilet (n)
hildë (hildi-); neuro|follower (n)
hilië|following (act of) (n)
hilmë|offspring; *descendant (n)
hilya-|to follow (vb)
hilyalë|dynasty; succession (n)
him-; himya-|to adhere (vb)
himba|adhering; sticking (adj)
himya-|to abide by; to cleave to; to stick to (vb)
himyalë|connection (n)
himítië|compliance (n)
himítë (himíti-)|chronic; clinging; persistent; sticking; (lit.) able to stick on (adj)
hinna; tensi; tenta|still (adv)
hinta-|to adopt (vb)
hir-; tuv-|to find (vb)
hirdë|bowels; entrails (n)
hiswa [þ]|grey [of weather]; overcast; *foggy (adj)
hiswë [þ]|fog (n)
hiuma|clue; hint (n)
hiuta-|to hint (vb)
hlaimar (hlaimard-)|hospital (n)
hlaiwa|ill; sick (adj)
hlapil|flag (n)
hlappo|dress; (lit.) flying cloth (n)
hlapu-|to blow; to fly or stream in the wind (vb)
hlar-; lasta-|to hear (vb)
hlaraitë|able to hear (adj)
hlarindo|hearer (n)
hlarië; lasta|hearing (n)
hlarma|earpiece; receiver (n)
hlas (hlar-)|ear (n)
hlic-|to creep; to *sneak (vb)
hlimba|sled (n)
hlimbon|sleigh (n)
hlimbë|gliding; sleek; sliding; slippery (adj)
hlintë (hlinty-)|down; fluff; soft stuff (adj)
hlit-|to dash; to hurtle; to race; to speed swiftly (vb)
hloima|poison; poisonous substance (n)
hloirëa|venomous; *poisonous (adj)
hloirë|poison; poisonousness; venom (n)
hloita-|to envenom; to fill with poison; to poison (vb)
hlonaitë; hlonitë|phonetic (adj)
hlonda-|to bang; to boom; to make (loud) noise (vb)
hlondë|loud noise (n)
hluc-; undulav-|to swallow (vb)
hlunco (hluncu-)|gullet; pharynx (n)
hlussa-|to whisper (vb)
hlussë|whispering sound; *whisper (n)
hlívë|sickness; *disease (n)
hlócë (hlóci-)|reptile; serpent; snake; worm; *lizard (n)
hlón(a) (hlon-)|noise; sound; speech sound; *phone (in linguistics) (n)
hlónemma|phoneme (n)
hlöa|fenland; flood (n)
hlúvo (hlúvu-); lúvo (lúvu-)|fat; greasy (adj)
holla; holma|?shut (adj)
hollo|cock; cockerel; rooster (n)
hollë; yello|shout (n)
holmo|from the middle; heartily; sincerely; *(lit.) from the heart (adv)
holmë|odour; smell [not necessarily bad]; *scent (n)
holtu-|to call out; to *shout (vb)
holya-|to close; to shut (vb)
holyë; porocë|hen (n)
homanca-|to buy (vb)
hondacil|belladonna; (lit.) heartsbane (n)
honda|hearted (adj)
hondo|(seat of the) deepest feelings (n)
hont (adv)|inwards (adv)
hont (n)|sneeze (n)
hontompa|heartbeat (n)
hontossë|loud sneeze (n)
hopassë; londië|harbourage (n)
hora-|to wait for (vb)
horina|driven under compulsion; impelled (adj)
hormë|urgency (n)
horna|rough; rude; uneven (adj)
hornië|roughness; rudeness (n)
horro; orro|ugh; alas!; ow! (interj)
horta-|to send flying; to speed; to urge (vb)
hortalë|speeding; urging (n)
horya-|to be compelled to do something; to have an impulse; to set vigorously out to do (vb)
hos (host-); hosto|assembly; crowd (n)
hosta-|to assemble; to gather (hastily together); to pile up (vb)
hostaitë|able to gather (adj)
hosta|large number (n)
hototyossë|a cough and a sneeze (n)
hotsë|army; band; troop (n)
hotya-|to sneeze (vb)
hrai(a)|awkward; difficult (adj)
hrai-|hard; *difficult (pref)
hraicenë; hraicénima|hard to see; scarcely visible (adj)
hrainotë|*hard to count (adj)
hraitasta|detail (n)
hrai|awkward; difficult; stiff (adj)
hrambundo|bison; buffalo (lit. wild ox); gaur; wisent (n)
hranga-|to thwart (vb)
hranga|awkward; difficult; hard; stiff (adj)
hrangwë|difficulty; problem (n)
hravanda|wilderness (n)
hravan|wild beast (n)
hresta|beach; shore (n)
hris-; nicu-|to snow (vb)
hrissë|fall of snow (n)
hristil|snow (?peak) (n)
hritya-|to accomplish; to achieve (vb)
hru-; ru-|evil- (pref)
hruhirdië|dysentery (n)
hruo|*wickedness (n)
hrupuhta-|to fornicate (vb)
hrupuhtië|fornication (n)
hrupuhto|fornicator (n)
hrá; rá|on behalf of; *for (prep)
hráva|savage; untamed; wild (adj)
hrávëa|carnal; fleshly (adj)
hrávë|flesh (n)
hríma|border; edge; hem (n)
hrívë|winter (n)
hró-; orró-|east (pref)
hróta|artificial cave or rockhewn hall; dwelling underground (n)
hröafelmë|*body-impulse (n)
hröaloica|cripple (n)
hröangolmë|lore of the body and arts of healing (n)
hröava|bodily; corporeal (adj)
hröa|bodily form; body (n)
hrú(y)a|evil; wicked (adj)
hrúcarë; rúcarë|evil-doing (n)
hrúcen|envy; (lit.) evil-sight (n)
hrúfinta-|to cheat (vb)
hu-|to bark; to bay (vb)
huarda|pack (of dogs, wolves) (n)
huar|jackal; wild dog (n)
huinë|(unrelieved) darkness; deep shadow; gloom; nightshade (n)
huiva|murky; *(nearly) lightless (adj)
humpë|in the middle (adv)
hundo|thunder (n)
hundu-|to thunder (vb)
huo; röa|dog (n)
huolë|litter (of pups, cubs, etc.) (n)
hwan (hwand-)|fungus; sponge (n)
hwandasar (hwandasarn-)|pumice; (lit.) sponge-stone (n)
hwarin; raica; rempa|crooked (adj)
hwarma|crossbar (n)
hwarrissë|blizzard; (lit.) blowing fall of snow (n)
hwarwa; hwá|violent wind (n)
hwat-|to spill (vb)
hwermë|gesture-code (n)
hwesta sindarinwa [hwesta þindarinwa]|Grey-elven hw (n)
hwesta-|to puff (vb)
hwesta|breath; breeze; puff of air (n)
hwinda|crazy; mad (adj)
hwindë (Agriculture and Vegetation)|birch (n)
hwindë (Physical World)|eddy; whirlpool (n)
hwinquetë|confused talk; nonsense (n)
hwinta-|to confuse; to mix; to stir (vb)
hwintaila|confusing (adj)
hwinwaiwa|whirlwind (n)
hwinya-|to eddy; to gyrate; to swirl (vb)
hya (conj)|or (conj)
hya (pron)|other thing (pron)
hyal-|to resound; to ring (vb)
hyalin|paper (n)
hyallë|another way; differently; otherwise (adv)
hyalma|conch; horn of Ulmo; shell (n)
hyalta-|to [with dative] make a phone call to; to make ring; to ring; to strike (vb)
hyam-|*to pray (vb)
hyamië|prayer (n)
hyan-|to injure (vb)
hyana|other (adj)
hyanda|a throng; crowd (n)
hyando|cleaver; hewer (sword) (n)
hyanna|compact; compressed (adj)
hyano|rather (adv)
hyapallë|slipper; (lit.) little shoe (n)
hyapat|shoe (n)
hyaqui|or else; otherwise (conj)
hyar- (pref)|left-hand; south (pref)
hyar- (vb)|to cleave; to plough (vb)
hyarehtë|halberd (n)
hyarma; hyarmen|left hand (n)
hyarmaitë|left-handed (adj)
hyarmenya|southern (adj)
hyarmen|south; (lit.) left-hand direction (n)
hyarna|compact; compressed; southern (adj)
hyarnúmen|southwest (n)
hyarnúna|southwestern (adj)
hyarrómen|southeast (n)
hyarróna|southeastern (adj)
hyarya|left (hand) (adj)
hyar|plough (n)
hyassë|rushing noise; *rustling (n)
hyasta-|to rustle (vb)
hyatsë|cleft; gash (n)
hyuxo|hiccup (n)
hyë|him (the other); other person (pron)
hyólamo|trumpeter (n)
hyóla|trump; *trumpet (n)
hácala|yawning (adj)
háno; toron (torn-)|brother (n)
háva|[unleavened] bread (collective) (n)
hér; turo; túrin|lord (n)
héramat (héramatt-)|main course; (lit.) chief meal (n)
héra|chief; principal; *main (adj)
hérincë|*little lady (n)
hérosto|capital city (n)
hérë|lordship (n)
hë; intin; toi|they (pron)
híma|sticky; viscous (adj)
hína; onna|child (n)
hísilanya [þ]|grey elvish rope; mist thread (n)
hísië [þ]|mist; mistiness (n)
hísë (hísi-) [þ]|fog; haze; mist (n)
hísëa|misty (adj)
hó (Animals)|owl (n)
hó-|away; from; from among (pref)
hócilmë|outtake; representative item; selection (n)
hócir-|to cut off (so as to have or use a required portion) (vb)
hón (hom-)|heart (physical organ); heart (physical) (n)
hópa|harbour; haven; small landlocked bay (n)
hórista|citation; quotation; (lit.) something cut out (n)
hórëa|impulsive (adj)
hórë|impulse (n)
hótul-|to come away (to leave a place and go to another) (vb)
hó|hound (or ?heart) (n)
höahan (höahán-)|big brother (informal/familiar) (n)
höanet (höanés-) [þ]|big sister (informal/familiar) (n)
höassë|size (n)
höa|big; large (adj)
húmë|thousand; †great number (cardinal)
hún (hun-)|earth; *ground (n)
húna|accursed; cursed (adj)
húni|bitch; *female dog (n)
húta-|to curse (vb)
i (article)|the (article)
i (pron)|that; what; which; who (pron)
iasintë|hyacinth (n)
il-|every; *all (pref)
ilaurëa|*daily (adj)
ilca-|to gleam (white) (vb)
ilcaxo|ivory; (lit.) gleam bone (n)
ildomë|everywhere (pron)
ilduma; telumë|heaven (n)
ilimba|milky (adj)
ilin (ilim-)|milk (n)
illangiéla|nevertheless; (lit.) all-having-been-bypassed (adv)
illi; ilqua; ilu|all (n)
illië|public (n)
illumë; vorë|*always (adv)
illumë; íqua; í|when; whenever (conj)
illómëa|nightly (adj)
illöa(va)|annual; per annum (year as item); yearly (adj adv)
ilqua; ilu|everything (n)
ilquen|everybody; *everyone (pron)
ilquárëa|general (adj)
iltana-|to demonstrate; to prove (vb)
iluasta|omnipresence (n)
ilucara|omnificent (adj)
iluisa|omniscient (adj)
ilu|the whole; universe; world (n)
ilvan(y)a|perfect (adj)
ilya|all (of a particular group of things); each; every; the whole (adj)
ilyë|all (adj)
ilúvala|omnipotent (adj)
ilúvëa; rísima [þ]|universal (adj)
ilúvë|Heaven; allness; the all; the whole; universe; world (n)
im-|same; *self (pref)
imbacindë|harlot (n)
imbalandë|equality (n)
imbalatëa|conceited; (lit.) self-proud (adj)
imba|same; self-same (pron)
imbenatsë|internet (n)
imbilat|*deep valley (n)
imbë (adv)|in(wards) (adv)
imbë (n)|(wide) ravine; deep vale; deep valley; dell; glen; (lit.) tween-land (n)
imbë (prep adv)|among; between (prep adv)
imli|*yourself (polite) (pron)
imlë|yourself (polite) (pron)
imma|same; same thing; self-same (pron)
immenwa|automobile (n)
immolaitië|self-praise (n)
immoquanta|egotistic; full of him/herself; narcissistic (adj)
immotuntië|conscience; (lit.) self-perceiving (n)
immoturië|self-control (n)
immo|same one (person); self (pron)
immë|ourselves (dual, emphatic); ourselves (exclusive) (pron)
imnetyala|hypocritical; (lit.) self-adorning (adj)
imnetyalë|(lit.) self-adornment (n)
imnetyando|hypocrite (n)
imni; imnë|myself (pron)
imyalë|sameness (n)
imya|identical; same; self-same (adj)
imíca; mici|among (prep)
inca; intya; tenna|idea (n)
incánussë|mind mastership (n)
incánu|mind master (n)
incë|*you (dual emphatic) (pron)
indemma|mind-picture (of apparition in dream) (n)
indil|lily; other large single flower (n)
indis (indiss-)|bride (n)
indosatië|resolution (n)
indo|(inner) thought; (state of) mind; heart; mood; resolve; will (n)
indu-|to do on purpose; to will (vb)
induinen|purpose (n)
indyalmë|clamour (n)
indyarin|blazon; device; escutcheon (n)
indya|device; engine; machine (n)
indyel|small bell (n)
indyo|descendant; grandchild; grandson; *granddaughter (n)
indë|yourselves (pron)
indómë|settled character; will of Eru (n)
inga (adj)|first (adj)
inga (n)|highest point; top (n)
ingaran|high-king (n)
ingolmo|loremaster; one with very great knowledge; wizard; *scientist (n)
ingolë|deep lore; lore; magic; philosophy; science (n)
ingor|summit of a mountain (n)
ingëa|top (adj)
inimeitë|*feminine (adj)
inimë|femininity; womanliness (n)
iniva|womanly (adj)
inquë|thou-and-I (emphatic) (pron)
insa|itself (pron)
insë|herself; himself (pron)
intu|themselves (dual) (pron)
intya-|to guess; to suppose (vb)
intyaitë|fantastic; fantasy (adj)
intyalë; isima; nausë [þ]; síma|imagination (n)
intya|guess; notion; supposition (n)
intyë|yourself (familiar) (pron)
intë|themselves; they (emphatic) (pron)
inwalmë|mood of mind (n)
inwirya-|to change one’s mind; to reconsider (vb)
inwis (inwist-)|change of mind/mood (n)
inwissar (inwissarn-)|opal; (lit.) mood-change stone (n)
inwista-|to convince; to persuade (vb)
inwë|ourselves (inclusive) (pron)
inya (adj)|female (adj)
inya (pron)|*mine (pron)
inyë|I (emphatic) (pron)
ipsin; lia|fine thread (n)
iqu-|to beg; to ‘pray’ [ask earnestly] (vb)
iqui; qui; quí(ta)|if (conj)
iquindo|beggar (n)
iquirya-|to ask for; to request (vb)
iquis (iquist-)|requirement (n)
iquista|request (n)
ir-|to shudder (vb)
irta-|to peck (vb)
irtë (irti-)|peck; pinprick (n)
isilmë [þ]; silmë|moonlight (n)
isima; síma|mind (n)
issë|where (conj)
ista-|to know (vb)
istalima|ascertainable; knowable (adj)
istalë|information (n)
istanómë|academy; school (n)
istarë; istya; nolmë [ñ-]; nólë [ñ-]; sívë|knowledge (n)
istima|having knowledge; knowledgeable; learned; very well informed; wise (in sense knowing very much) (adj)
istyar|learned man; lore-master; scholar; wizard (n)
ita-; tintila-|to sparkle (vb)
ita; tai|that which; what (conj)
itan|in order to; so that (conj)
itara|gleaming (adj)
itas|in that case (adv)
itis [þ]|fly bite; *itch (n)
itisin [þ]|itching (adj)
itisya- [þ]|to irritate; to itch (vb)
itsë; pí|fly (n)
ixal|cast shadow (n)
iër; sívë; tambë|*as (prep)
la-|in-; not; un- (pref)
lacalima|not possible to be kindled (made to shine) (adj)
lacaraitë|*inactive (adj)
lacarina|incomplete; undone; *unfinished (adj)
lacarë|inaction; (lit.) not-doing (n)
lacenítë|blind; unseeing (adj)
lacárima|impossible; not feasible (adj)
lah-|to kick (vb)
lahlaraitë|deaf; (lit.) unable to hear (adj)
lahta-|to cross; to go over; to pass over; to surpass (vb)
lahtalë|passover (n)
laicalassë|green as leaves; green-leaf (adj)
laica|acute; green; keen; sharp (adj)
laicelumir (laicelumír-)|malachite (lit.) green-flowing-jewel (n)
laicë|acuteness; keenness of perception (n)
lailinquë|beryllium; (lit.) fresh-liquid light (n)
laima; olva|plant (n)
laimamatta|vegetable food; (lit.) plant food (n)
laimamatya|herbivorous; vegetarian; (lit.) plant-eating (adj)
laimaril|emerald (n)
laiquelis (laiqueliss-)|rue (plant) (n)
laiquë|herb (n)
lairelossë|species of tree in Númenor; summer-snow-white (n)
lairemo; maitar|poet (n)
lairemírë|daisy; (lit.) meadow-jewel *(or summer-jewel) (n)
lairesta|poetry (n)
lairus (lairust-)|verdigris (n)
lairë (Language and Music)|poem (n)
lairë (Time)|summer (n)
laista|ignorance; (lit.) not-knowing (n)
laistila; laistëa|ignorant (adj)
laistima|secret; unknowable (adj)
laita-|to bless; to praise; to ?live (vb)
laitalë|praise (n)
laitelë|falsehood (n)
laitima|praiseworthy (adj)
laitita-; raica-|to falsify (vb)
laitië|honour; praising (n)
laitë|false (adj)
laivelyávë|(water)melon (n)
laivë|ointment (n)
lai|very (adv)
lala-|to laugh (vb)
lala; lá|no; not (adv)
lalamma-|to babble; to chatter (vb)
lalammamo|babbler (n)
lalammië|babble (n)
lalda|laugh (n)
lalevítë|lame (adj)
lalil|chuckle (n)
lalië-malina|daffodil; (lit.) yellow laughter (n)
lalië|laughing; laughter (n)
lalta-|to make laugh (vb)
laltaula|funny; (lit.) apt to make laugh (adj)
laman (lamn-)|animal; tame beast (n)
lamanwa|beastly; stupid (adj)
lamatë|a fast; fasting (n)
lamba|(physical) tongue (n)
lambelanga-|to translate (generally, between languages) (vb)
lambelanga|translation (n)
lambengolmë|linguistics (n)
lambetengwë; náva-tengwë [ñ-]; pataca; pávatengwë; ólama|consonant (n)
lambina|of tongue; spoken with tongue (adj)
lambë|dialect; language; tongue (n)
lamma-|?to echo (vb)
lamnarë|flock; *herd (n)
lamya-|to sound (vb)
lamélima|unlovable (adj)
lanat|weft; *woof (n)
lana|no; none; not (a); not any (adj pron)
lancanta-|to transform; to turn into (trans.) (vb)
lanca|sharp edge (not of tools); sudden end (n)
lancöa|tent; (lit.) cloth shelter (n)
landa; lanna; palar|plain (n)
landa; yonwa|boundary (n)
landa|broad; wide (adj)
langandë|stringed instrument with a neck (lute, guitar, etc.) (n)
langa|bridge; crossway; ferry; ford; thing that crosses (n)
lango (Body Parts and Functions)|neck; throat (n)
lango (Warfare and Hunting)|broad sword; prow of a ship (n)
langwes- [þ]|to communicate; (lit.) to report across (vb)
langë|extremely; superlatively; surpassingly (adv)
lanna|(to a point) beyond; athwart; *across (adv prep)
lannë|cloth; tissue (n)
lanotoitë (lanotoiti-); únótima|innumerable (adj)
lanquet-|to converse; to debate; to *discuss (vb)
lanquetta|conversation; debate; interchange of words (n)
lanquinga|crossbow (n)
lanquit-|to darn a knitted garment; (lit.) to cross/over-knit (vb)
lanta-|to drop; to fall (vb)
lanta; lantë|fall (n)
lantalca|boundary post or mark (n)
lantanna|banner; standard (n)
lantanwa|*fallen (adj)
lantasírë|waterfall; (lit.) falling river (n)
lanta|fall; falling (n adj)
lanwa (adj)|(well-)defined; finite; limited; within bounds (adj)
lanwa (n)|loom (n)
lanya- (Clothing and Adornment)|to weave (vb)
lanya- (Social Relations)|to bound; to enclose; to mark the limit of; to separate from (vb)
lanya-|to cross (vb)
lanya|thread; warp (n)
lan|*while (conj)
lanéya|not long ago; recently (adv)
lanë (lani-)|hem (n)
lap-|to swathe; to wind; to wrap (vb)
lapa-|to hop (vb)
laparotsë|sleeve; trouser leg; (lit.) wrap-tube (n)
lapil|flowing cloth; swathe (n)
lappa|end of rope; hem of robe; loose-end (n)
lapsa-|to lick (frequentative) (vb)
lapselunga|pregnant; (lit.) baby-heavy (adj)
lapsë|babe (n)
laptë|gluttonous eating; †licking up (food or drink) (n)
laqui|unless (conj)
larma (Clothing and Adornment)|raiment (n)
larma (Food and Drink)|fat [as a substance] (n)
larmo|listener (spy or scout) (n)
larmëa|fatty; fleshy (adj)
larnelta|mile; *(lit.) league third (n)
laru|grease (n)
lar|fat; richness (n)
larúva|greasy (adj)
lassecanta|leaf-shaped (adj)
lasselanta|(late) autumn; October; (lit.) leaf-fall (n)
lassevinta|autumn; leaf fall; *(lit.) leaf blowing (n)
lassëa|leafy; with leaves (adj)
lassë|leaf (n)
lasta-|to listen (vb)
lasta|listening (n)
las|it is/was not so (adv)
lat (latt-)|flap; lid; small hinged door (n)
lat-|to be extended; to be situated (of an area); to extend; to lie (of lands or regions); to spread; to stretch (vb)
latanca|insecure; unsure (adj)
latil|key (n)
latina (Social Relations)|cleared (of land); free (of movement); not encumbered with obstacles; open (adj)
latina (Spatial Relations)|cleared (of land); free; open (adj)
latsë|area; room; space (n)
latta (Clothing and Adornment)|strap (n)
latta (Spatial Relations)|hole; pit (n)
lattasta|harness; (lit.) collection of straps (n)
latter-|to darn a sewn garment; (lit.) to cross/over-sew (vb)
lattinsan (lattinsam-) [þ]|shutter; (lit.) window-barrier (n)
lattin|window (n)
latucenda|of tin (adj)
latya-|to open anything (so as to allow entry) (vb)
latya; pantië|opening (n)
latúcen|tin [metal] (n)
lau(me)|no; no indeed not; on the contrary (adv)
laucata-|to heat up; to warm (vb)
lauca|warm (adj)
laucehtelë|hot spring (n)
laulema|inhabiting (adj)
laulemo|inhabitant (n)
laulesta-|to gain a living; to lead a life (vb)
laulesta|livelihood (n)
laulë|mode of life; *lifestyle (n)
laupë|shirt; tunic (n)
laurinquë|yellow-flowered tree (n)
laurië|goldenness; like gold (n adv)
laurëa|golden (of hue) (adj)
laurë|gold (light or colour) (n)
lauta-|to abound (vb)
lauya-|to flourish (green) (vb)
lav- (Body Parts and Functions)|to lick (vb)
lav- (Social Relations)|to allow; to grant; to yield (vb)
lavaralda|tree with long green leaves with golden undersides and pale flowers with a yellow flush (n)
lavar|*(golden) blossom (n)
lavéla|different; dissimilar (adj)
lehta-|to loose; to slacken (vb)
lehta|free; released (adj)
lelelya-|to go on travelling; to keep travelling (vb)
lelta-|to send; to *(lit.) cause to go (vb)
lelya- (Emotion)|to appear (of beautiful things); to attract; to enchant (with dative) (vb)
lelya- (Motion and Transportation)|to go; to proceed (in any direction); to travel (vb)
lelyalávë|ticket; (lit.) travel-permission (n)
lelya|beautiful and fine; delicate; lovely; slender (adj)
lemba|left behind (adj)
lemma|artifact; relic; residue (n)
lemmë|remainders; remains; remnant(s) (n)
lempellumë|five times (adv)
lempëa; lepenya|fifth (ordinal)
lempë|five (cardinal)
lemya-|to remain; to tarry (vb)
lenca|slow (adj)
lenda|journey; trip; *travel (n)
lendië|tourism; *traveling (n)
lenga-|to behave (vb)
lengalë|behavior (n)
lengesta|character (of a person); set of characteristic traits (n)
lengë|characteristic look; gesture; gesture or trait (n)
lenna-|to come; to depart; to go (vb)
lenweta-|to go away; to leave one’s abode; to migrate (vb)
lenwë|departure; leaving (n)
lenya|yours (plural) (pron)
lep-|to pluck; to take [with fingers]; to *pick (vb)
lepecan (lepecant-); lepentë|fourth finger (n)
lependë; lepenel|middle finger (n)
lependórë|quintillion (cardinal)
lepenquain|fifty (cardinal)
lepenquëa|fifteenth (ordinal)
lepenquë|*fifteen (cardinal)
leper; lepsë|finger (n)
lepesta|one fifth (fraction)
lepetas (lepetass-); tassa|index finger (n)
lepetta|Gondorian hardwood (n)
lepinca; lepincë (lepinci-); nícë|little finger (n)
leppa|thimble (n)
lepsa|liver (n)
lepsilë (lepsily-)|tendril (n)
lepta (adj n)|fingered (adj n)
lepta (suf)|*fingered (suf)
lepta-|to feel with the fingertips; to finger; to pick (up/out) (vb)
leptafinya|clever-fingered (adj)
leptas|*index finger (n)
leptenta-|to indicate with finger; *to point to (vb)
lerca-|to flee (vb)
lercië|flight (n)
lerina|free (of things) (adj)
lerta-|to be free to do (vb)
lerya-|to let go; to release; to set free (vb)
leryalë|release (n)
lesta-|to measure (vb)
lesta; massë|measure (n)
lesta|*girdle (n)
letinwessë|constellation (n)
leuca|snake (n)
lev-; rum-|to move (vb)
levemma|motion picture; movie (n)
levë|motion; movement (n)
li(n)-|many (pref)
lia-|to entwine (vb)
lialóra|cordless; wireless (adj)
liantassë|vine (n)
liantë|spider (n)
lia|spider filament; twine; *wire (n)
lic-|to glide; to slide; to slip (vb)
lihlicca-|to sneak about (vb)
lihta-|to seal (vb)
lihtaina|sealed (adj)
lihta|seal (n)
lillassëa|having many leaves (adj)
lillumë|many times; often (adv)
lilma|patch (n)
lilta-|to dance (vb)
liltië|dancing (n)
liltë|dance (n)
lilíva-|to (continuously) drip; to drip-drop (vb)
lilómëa|full of darkness; many-shadowed; very dark (adj)
lilótëa|having many flowers (adj)
limba|drop (n)
limil|chain (n)
limivarma|chainmail; (lit.) link-armour (n)
limpa|frail; slender and drooping (adj)
limpevorma|wine-press (n)
limpunqua|drunken (adj)
limpunquië|drunkenness (n)
limpë; miru|wine (n)
limya-|to join; to link (vb)
limë (limi-)|link; *joint (n)
lina|many (adj)
linca-|to ski (vb)
lincantilda|checkered; (lit.) many-squared (adj)
lincantëa|diverse; (lit.) many shaped (adj)
linca|ski (n)
linda-|to make music; *to sing (vb)
lindalëa|melodious; *musical (adj)
lindalë|music (n)
linda|beautiful (of sound); fair; gentle; kind; melodious; soft; sweet (adj)
lindelin|melody; tune (n)
lindelos (lindelós-) [þ]|laburnum; (lit.) singing cluster (n)
lindimaitar|composer; musician (n)
lindista|music album (n)
lindornëa|having many oaks (adj)
lindo|singer; singing bird (n)
lindë (lindi-)|air; musical sound; singing; song; tune (n)
lindëa|singing (adj)
lindë|air; tune (n)
lindóra|many millions; millions of (adv)
linga- (Language and Music)|to hum like the string of a harp; to twang; to *resonate (vb)
linga- (Motion and Transportation)|to dangle; to hang (vb)
lingil|hanger; hook (for clothes) (n)
lingwileuca|eel (n)
lingwilócë|fish-dragon; sea-serpent (n)
lingwimo|fisherman (n)
lingwiremnë|fishing (n)
lingwë (lingwi-)|fish (n)
lingwëa|fishlike (adj)
lingëa|with a musical sound (adj)
lingë|musical sound (n)
linima|manifold; of many kinds (adj)
linipsinwa|complex; complicated; convoluted; (lit.) many-threaded (adj)
linipsinwië|complexity; complicatedness; complication; (lit.) many-threadedness (n)
linitë|plural (adj)
linquemir|hyacinth [jewel] (n)
linquilëa|having many colours (adj)
linquë (linqui-)|; wet (adj)
linquë (n adj)|light-substance; liquid light; *photons (n adj)
linquë (n)|(leaf of a) hyacinth; *grass or grass-like leaf (n)
linta-|to soothe (vb)
linta; tyelca|swift (adj)
lintië|speed; swiftly; swiftness; *quickly (n adv)
lintyulussëa|having many poplars (adj)
linvainëa|onion; (lit.) many-sheathed (n)
linwa|device for making music; musical instrument (n)
linwë|short lay (n)
linya; nendë|pool (n)
linyenwa|having many years (adj)
lipsanë|lather (n)
lipsa|soap (n)
lipta-|to drip (vb)
liptasar (liptasarn-)|dripstone (n)
liquis (liquist-)|clarity; limpidity; transparence (n)
liquistëa|transparent; *clear (adj)
lir-|to chant; to sing (vb)
liralë|merry singing (n)
lirda|stanza; verse; (lit.) a product of singing (n)
liru-|to sing (gaily) (vb)
liruima|able to be sung (adj)
lirulin|lark (n)
lirulë|merry song (n)
lirusta|chant; singing (n)
lirustëa|fit for singing; to be sung (adj)
lis (liss-); nehtë|honey (n)
liscornë|any sweet fried bread; doughnut (n)
liscë|reed; sedge (n)
lisselë|sweetness (n)
lissimat (lissimatt-)|dessert; (lit.) sweet-meal (n)
lissimatta|piece of confectionary; sweet (n)
lissimbas (lissimbass-)|(sweet) cake (eaten as dessert) (n)
lissë (lissi-); melda|sweet (adj)
lissë|grace (n)
lista-|to make sweet; to sweeten (vb)
lita-|to multiply (vb)
litsëa|granular; gritty; sandy (adj)
litsëon (litsëond-)|sandstone (n)
litsë|sand (n)
littë|ash (n)
liv-|to anoint (vb)
liyúmë; rimbë|host (n)
liëarda|republic (n)
liëmelehtëa|democratic (adj)
liëndina|popular (adj)
liëraxa|a bus; coach; (lit.) people wagon (n)
liëtarwa|park; (lit.) people-garden (n)
liëtúrië|democracy (n)
lië|folk; people (n)
loc-|to curl; to loop (vb)
locin|bent; *curled (adj)
loi-|mistake in ...; mistaken (pref)
loicarë|mistaken action (n)
loica|failing; inadequate; short (adj)
loicolícuma|corpse-candle (n)
loico|corpse; dead body (n)
loima|mistake (n)
loiparë|mistake in writing (n)
loipat-|to misstep (vb)
loiquetë|mistake in speech (n)
loita-|to fail; to fall short of (transitive); to miss (vb)
lolóca-|to crawl (vb)
lomba|blind (adj)
lomentië|departure; ?away-journey (n)
londë|(land-locked) haven; entrance to harbour; fairway; gulf; road (in sea) (n)
lop-|to gallop; to run (of animals); to *lope (vb)
lopeta-|to amble (vb)
lopoldë|rabbit (n)
lopotun; lopotundo (lopotundu-)|rabbithole (n)
lor-|to sleep; to slumber (vb)
lorda|drowsy; slumbrous; *sleepy (adj)
lornata-|to put to sleep (vb)
lornatála|sleep-inducing (adj)
lorna|asleep (adj)
lorta-|to become dazed; to faint; to swoon (vb)
lortalë|dizziness; faint; swoon (n)
loru-|to fall asleep (vb)
lossë (n adj)|fallen snow; snow; snow-white; snowy (n adj)
lossë (n)|(white) blossom; (white) flower; inflorescence (of white flowers) (n)
lossëa|(snow) white; snowy (adj)
losta-|to bloom; to *blossom (vb)
lotarwa|[flower] garden (n)
lotella|floret (n)
lotsë|small (single) flower (n)
lottë|small flower (n)
loxor|bog; swamp (n)
loxo|mud (n)
loxë|hair [in general] (n)
loëndë|mid-year (Númenórean calendar); *(lit.) year-middle (n)
lu-|to be heavy; to be sad (vb)
luc-|to drag; to haul; to pull (behind) (vb)
lucando|debtor; one who trespasses (n)
lucassë; lucië; luhta; rohta|trespass; *debt (n)
lucindo; rocindë|one who trespasses; *debtor (n)
luhta- (Physical Acts and Materials)|to bow; to *curve (vb)
luhta- (Religion and Beliefs)|to enchant (vb)
luhtu|magic; spell (n)
luhtya-|to extinguish; to *quench (vb)
luicarnë|purple (adj)
luilë|blue stone; sapphire (n)
luimë|flood; flood tide; floodwater; high tide (n)
luina; malwa; marya; néca; sindë (sindi-) [þ]|pale (adj)
luinincë (luininci-)|bluish (adj)
luinion (luiniond-)|lapis lazuli; (lit.) blue-rock (n)
luinyellë|bluebell (n)
luinë (luini-)|blue (adj)
luita-|to drench; to flood (vb)
luitë|melancholic; (lit.) habitually being sad (adj)
lumba; morna; ulca|gloomy (adj)
lumba|weary (adj)
lumbo|cloud; dark; dark lowering cloud; gloom; shade (n)
lumbulë|dark shadow; deep in shadow; heavy shadow (n)
lumbë|gloom; shadow (n)
lumenyárë|*history (n)
lumna-|to be heavy; to lie heavy (vb)
lumna|burdensome; lying heavy; ominous; oppressive (adj)
lunca; luqua|heavy transport wain (n)
lungië|gravity; heaviness (n)
lungo (lungu-)|heavy (adj)
lungumaitë|heavy-handed (adj)
lungumë|heaviness; weight (n)
lunguntë|scales (n)
lungwë|pound (n)
luntë|boat; ship (n)
lunwa|fin; (lit.) swim-thing (n)
luppo (luppu-)|clumsy piece or lump (n)
lupsë (lupsi-)|(small) chunk; clump; nugget; tidbit (n)
lurwë; umbë|threat (n)
lussë|(verb) tense (n)
lustavë|emptily; in vain (adv)
lusta|void (adj)
lustindo|ennui (n)
lut-|to float; to sail; to *swim (vb)
luttalan (luttalam-)|raft; (lit.) floating platform (n)
lyenya|yours (polite) (pron)
lyéta-|to address somebody formally using lye (vb)
lyë|you (polite) (pron)
lá-; ui-|to not be (vb)
lámatyávë|*sound-taste (n)
láma|echo; ringing sound; sound (n)
lámina|echoing (adj)
láquet-|to deny (fact or accusation); (lit.) to say ‘it is not’ (vb)
lár-|to happen (vb)
lára-|to flatten; to level (vb)
lára; palwa|flat (adj)
lár|league; pause; †stop (n)
lárëa|fat; rich (adj)
látacar (látacard-)|pub; public house; (lit.) open-house (n)
láta|open (not closed) (adj)
látië|openness (n)
lávar; löar|(golden) blossom (n)
lávehentar|ticket inspector; (lit.) permission examiner (n)
lávima|permissible (adj)
lávëar|glutton (n)
lá|across; athwart; over (prep)
léramo|freeman (n)
léra|free (of persons) (adj)
lérië|freedom (n)
lé|manner; method; way (n)
lë (prep)|by; with (prep)
lë (pron)|you (plural) (pron)
líco (lícu-)|wax (n)
lícuma|candle; taper (n)
línë|cobweb; cotton (n)
lírë (líri-)|song (n)
lís (liss-)|honey; sweetener; *sugar (n)
lócë (Body Parts and Functions)|bend; bight; curl of hair (n)
lócë|serpent; snake (n)
lómaril|jade (n)
lóma|moss (n)
lómelindë|nightingale; (lit.) dusk-singer (n)
lómivehtë|night life (n)
lómë (lómi-)|gloom; night; night-time; shades of night (n)
lómëa|gloomy; shadowed; *dusk-like (adj)
lómë|darkness; dimness; dusk; night; night-time; shades of night; twilight (n)
lón(ë)|deep pool; river-feeding well (n)
lóna|(deep) pool; mere; river-feeding well (n)
lónë|island; isle; remote land difficult to reach (n)
lórelot|poppy; *(lit.) flower of sleep (n)
lórë|dream; slumber; *sleep (n)
lós [þ]; olos (olós-) [þ]|inflorescence; mass of flowers (n)
lótelas (lótelass-)|petal; (lit.) flower-leaf (n)
lótëa|flowering; full of blossom; *blooming (adj)
lótë|(large single) flower; single blossom (n)
lóya-|to leave (from something: a place, a thing) (vb)
ló|(away) from; ablative element; by agent [of] (prep)
löasta|season; (lit.) year-part (n)
löa|(seasonal) year; blooming; (lit.) (time of) growth (n)
lú(n)|*deep pool (n)
lúcëarwa|attractive; enchanting (adj)
lúcë|enchantment (n)
lúma|clock (n)
lúmequentalë; nyárë; quenta; quentalë; quentassë|history (n)
lúmequentalëa|historical (adj)
lúmequenta|chronological account; history (n)
lúmincë|minute; moment (n)
lúmë; mornië|darkness (n)
lúmëa|pertaining to time; temporal (adj)
lúmë|hour; period of time; time (n)
lúna|*dark (adj)
lúpë|plume (n)
lúrëa|dark [of weather]; overcast (adj)
lúrë|bad weather; dark weather (n)
lúta-|to have time pass (vb)
lúva|bend; bight; bow (in forming tengwar); curve (n)
lú|occasion; time (n)
ma (adv)|interrogative particle (adv)
ma (pron)|a thing; something (pron)
mac-|to hew (with a sword); to *swing (a sword) (vb)
maca-|to forge (vb)
macal|sword (n)
macar|swordsman; †forger (n)
macca|article (for exchange); thing; ware (n)
macilindil|gladiolus; (lit.) sword lily (n)
macil|broadsword; cutting sword; forged sword blade; sword (n)
mahalma; tarhanwa|throne (n)
mahar; mancaro|merchant; trader; tradesman (n)
mahta-|to control; to deal with; to feel; to fight; to handle; to make use of; to manage; to stroke; to treat; to use; to wield; to wield a weapon (vb)
mahtalë|battle; fighting (n)
mahtando|manager (n)
mahtar|soldier; warrior (n)
mahtasta; mahtië|management (n)
mahtië|*handling (n)
mahtéma|tournament; tourney; (lit.) battle-series (n)
mahtë|grip; hold; *grasp (n)
mai-|admirable; excellent; happily; *well (pref)
maica (adj)|piercing; sharp (adj)
maica (n)|blade of a cutting tool or weapon (especially sword-blade) (n)
maicahausta|truce; (lit.) blade-resting (n)
maicarindo|benefactor (n)
maicata-|to sharpen (vb)
maicatan (maicatam-)|weaponsmith (n)
mailengaitë|well-mannered (adj)
mailitya|(greedily) wealthy; avaricious (adj)
mailëa|lustful (adj)
mailë|lust (n)
maimun|ape; monkey (n)
maina|thing of excellence; treasure (n)
mainenta-|to brag; (lit.) to make seem excellent (vb)
maira|admirable; excellent; precious; splendid; sublime (adj)
mairia|beautiful (of things made by art) (adj)
mairië|excellence; splendor; sublimity; ‘perfection’ (n)
mairëa|beautiful (of things made by art); *artistic (adj)
mairë|art; process of producing an art work; work of high and beautiful art (n)
maisinwa|famous; notable; well-known (adj)
maita-|to compose; to design; to make with art (vb)
maita; saiqua|hungry (adj)
maitalë|act of doing [artistic] work (n)
maitar|artist (n)
maitilë|handicraft; legerdemain; sleight (n)
maitië; saicë|hunger (n)
maitulië|happy arrival; welcome thing (n)
maitulya|welcome (adj)
maitë (maisi-)|handy; skilled (adj)
maitë (maiti-)|(as suffix) having a hand; handed; handy; skilled; skillful; well-shaped (adj)
maiwë|gull (n)
mai|well (adv)
mal-|to crush; to hurt; to pain (cause pain to); to squeeze (vb)
malaqua|soft; tender (of meat, substances, etc.); yielding (adj)
malatsar (malatsarn-)|chrysolite (n)
malca|how great (adj)
malda-|to pound (vb)
malda|mash; mush; paste; pulp (n)
maldornë|golden/yellow tree (n)
malicon (malicond-)|amber (n)
malicondëa|of amber (adj)
malina|of golden colour; yellow (adj)
malinornë|mallorn; (lit.) golden/yellow tree (n)
mallo; yallo|whence (adv)
mallë|(made or stone) road; street (n)
malma|lemon (n)
malo (malu-) (Agriculture and Vegetation)|pollen; yellow powder (n)
malo (malu-) (Physical Acts and Materials)|rust (n)
malo|moth (n)
maltaina|of gold (adj)
maltalos [þ]|buttercup (lit.) flower of gold (n)
malta|gold (as metal); gold (metal); gold as material (n)
malumë|when (adv)
malwa|fallow; yellowish; *wan (adj)
mammata-|to devour; to gobble up; to gorge (oneself); (lit.) to go on eating (vb)
man; mana|what; who (pron)
manaitë|having grace (adj)
manan|why (adv)
manar; mandë|doom; fate; final bliss; final end; fortune (n)
manca-|to trade (vb)
mancalë|commerce; *trade [as an activity] (n)
mancanómë|market; market-place (n)
manco|wares (n)
manda-|to imprison (vb)
mandanië|struggle; wrestling; (lit.) hand-resistance (n)
mandano|prisoner; (lit.) imprisoned-one (n)
mandontur|jailer (n)
mandos|doomsman; judge (n)
mando|custody; duress; prison; safe keeping (n)
manen|how (adv)
manima|of what kind; of what sort (adj)
manna; yanna|whither (adv)
manotë|how many; (lit.) what number (adv)
manta-; manya-|to bless (vb)
mantal|glove (n)
mantelë|gauntlet (n)
manu|departed spirit (n)
manwa; yava|whose (adj)
manya|butter (n)
manë|good (moral, not evil) (adj)
mapa-|to grasp; to seize; to take (vb)
mapalin|plane tree [Platinus]; sycamore; (lit.) hand-flat (n)
maptalë|forcible seizure and carrying off; rape; ravishment; robbery by violence; seizure (n)
maquanotië|decimal system (n)
maqua|group of five (similar) things; hand (colloquial); hand-full (n)
maquet-|*to question (vb)
maquetta|question (n)
mar (mar(d)-)|dwelling; earth; habitation; home; house (n)
mar(da) (mard-)|(great) house; a thing or place dwelt in; dwelling; mansion; residence (n)
mar(dar)|homewards (adv)
mar-|to abide; to be settled or fixed; to dwell; to live (vb)
maranwë|destiny (n)
mardaitë|domestic; homely (adj)
mardo|dweller (n)
maril|crystal (n)
marindo|settler (n)
marrum-|to move = change residence (vb)
marta-; umbarta-|to decree; to define; to destine (vb)
martaman (martamn-); martan (martam-)|dwelling-house (n)
martandë; santië [þ]|decision (n)
marta|fated; fey (adj n)
marto; taras; tarminas; tirion|tower (n)
marto|fate; fortune; lot; luck (n)
marya-|to establish; to found; to settle (as dwelling) (vb)
marya|fallow; fawn [light yellowish tan colour] (adj)
maryë|at home; *indoors (adv)
massa; masta|bread (n)
massánië|Lady; breadgiver (n)
massë (adv)|where (adv)
massë (n)|a talent; capacity; handful; just portion (in distribution); measure or capacity (of a person); portion; share; the personal measure or capacity of a man; †handful (n)
masta-|to bake (vb)
mastacornë|[bread] loaf (n)
mastasan (mastasamb-) [þ]|kitchen (n)
masta|cake; *baked good (n)
mat (matt-)|meal; meal time (n)
mat-|to eat (vb)
matimar (matimard-)|restaurant; (lit.) eating hall (n)
matina|eaten (adj)
matië|eating (n)
matta; nes (nest-)|food (n)
matya-; nesta-|to feed (vb)
maura-|to need; to require (vb)
maurë|need (n)
mausta|compulsion (n)
mauya-|to compel (vb)
mavaina|maple; (lit.) hand-clad (n)
maxa-|to cook (vb)
maxarma|software (n)
maxar|cook (n)
maxata-|to knead (vb)
maxa|pliant; soft (adj)
maxon (maxond-)|mudstone (n)
maxo|mire; sticky substance (n)
maxë (Food and Drink)|dough (n)
maxë (Possession and Trade)|sale (n)
mec-|to plead (vb)
mecin|please (adv)
mehar; nehtë|gore (n)
mehta-|to aim at (vb)
mehtë|aim; mark; object (n)
mel-|to love (as friend) (vb)
melda; melin|beloved; dear (adj)
meldo|(friend); lover (n)
meldë|*friend (f.) (n)
melehta; meletya; taura; túrëa|mighty (adj)
melehtë|might; power (inherent) (n)
melesellë [þ]|love-sister (n)
meletya-|to magnify (vb)
melima|fair; loveable (adj)
melindo|lover (m.) (n)
melinólë|philosophy (n)
melissë|lover (f.) (n)
mellaman (mellamn-)|pet; (lit.) love-animal (n)
melmë|love (a particular case [between two people]) (n)
melotorno|love-brother (n)
melpo|gooseberry (n)
melta-|to enamour (vb)
melu-|to fall in love (vb)
meluquetya|flatterer; sweet-speaking person (n)
melya-|*to be in love (vb)
men (Motion and Transportation)|place; spot; way (n)
men (Spatial Relations)|place; spot (n)
men-|to arrive [+ locative]; to come [when moving to a destination]; to go; to move (in some direction); to proceed (vb)
mena-|to be making for; to be on way to (vb)
mendar (mendár-)|station; (lit.) way-stop (n)
menda|(orig.) towards the direction; about; approximately; circa (adv)
mendë|*will (n)
meneldil|astronomer; *(lit.) lover of the heavens (n)
menelluin|cornflower (colour); *(lit.) sky-blue (n)
menelwa|heavenly (adj)
menel|firmament; the heavens (n)
mennai|until (conj)
menta-|to cause to go (in a desired direction); to send (vb)
menta|message; sending (n)
mentië|direction of travel; journey; passage (n)
mentë|end; point (n)
menya|our (exclusive); ours (pron)
mer-|to desire; to want; to wish (vb)
meren(de) (merend-)|feast; festival (n)
merenya-|to be festive; to celebrate (vb)
merillë|rose (n)
mermë|wish (n)
meryalë|holiday (n)
merya|festive (adj)
mestanyatsë|suffixion (n)
meter|towards the end; *for (the purpose of) (prep)
metta|end; ending (n)
metya-|to put an end to (vb)
mica|*among (prep)
micol-|to import (vb)
milca|greedy (adj)
mildë (mildi-)|pea (n)
milla|oily (adj)
millo (millu-)|oil (n)
milmë|desire; greed (n)
milpialda|olive tree (n)
milpio|olive; (lit.) oily-berry (n)
miltë (milti-)|semen (n)
milya-|to long for (vb)
milya|gentle; soft; weak (adj)
mimírima; mimírë|very beautiful (adj)
minassëa|inherent; innate; intrinsic (adj)
minassë|city (with a citadel and central watch tower); fort (n)
minasurindo [þ]|researcher (n)
minasurië [þ]|enquiry; *research (n)
minatec-|to record; (lit.) to into-write (vb)
minatulië|introduction; (lit.) into-leading (n)
minaxanwa|bound; enchained; fettered (adj)
mina|in; into; to the inside (prep adv)
mindata-|to isolate; (lit.) to make stand out (vb)
minda|conspicuous (adj)
mindon; mindë|turret (n)
mindon|(isolated) tower; (lofty or isolated) tower (n)
mindórë|million (cardinal)
minima|special (positive) (adj)
minomë|in exchange of; in place of; instead (adv)
minquellumë|eleven times (adv)
minquesta|*one eleventh (fraction)
minquetyar-|to accentuate; (lit.) to pronounce prominently (vb)
minquetyarmë|accentuation (n)
minquë|eleven (cardinal)
minul(da)|ingot (n)
minya (ordinal adj)|eminent; first; prominent (ordinal adj)
minya (ordinal)|first (ordinal)
min|one (in a series); the first (cardinal)
miqu-|to kiss (vb)
miquelis (miqueliss-)|(soft, sweet) kiss (n)
miquelë|kissing (n)
miquë|kiss (n)
miril (mirill-)|shining jewel (n)
mirilya-; tin-; tintila-|to glitter (vb)
mirima; ráva|free (adj)
miriéla|?sparkling (adj)
mirmairë|jewelry; (lit.) jewel-art (n)
mirma|value; *price (n)
mirquet-|to persuade; (lit.) to into-talk (vb)
mirquétala|persuasive (adj)
mirröanwë|incarnate (n)
mirta-|to cherish; to esteem; to treasure; to value (vb)
mirucarnë (mirucarni-)|wine-red (adj)
mirupio|grape; (lit.) wine-berry (n)
miruvor|special wine or cordial (n)
miruvórë|drink of the Elves; mead; nectar; special wine or cordial (n)
mirwa|precious; valuable (adj)
mirya|beautiful; lovely (of works of art only) (adj)
mir|into; to the inside (prep adv)
mirúva|like wine; winy (adj)
mis (mist-)|urine (n)
mista-|to stray about (vb)
mista; sinda [þ]; sindë (sindi-) [þ]|grey (adj)
mistana|stray (adj)
mistë|drizzle; fine rain (n)
mitië|interior (n)
mitsavëo|micro-organism (n)
mitta-|to come in; to enter; to insert (vb)
mittandë|infixion; insertion; intrusion (n)
mittanya-|*to lead (into) (vb)
mittar(ë)|*entering (n)
mitta|into; inwards; (?into) (prep adv)
mitya|interior (adj)
miulë|mewing; whining (n)
miuya-|to cry; to whine (vb)
miuë (miuy-)|cat (n)
mixa|sharp-pointed; wet; *damp (adj)
mi|in; within (prep)
moia-|to be afflicted; to *be laboured (vb)
moica|gentle; soft (adj)
moina|dear; familiar (adj)
moleculë|molecule (n)
morco|bear (n)
mordo|[dark] stain; dimness; obscurity; shadow; smear (n)
morendë|midnight (n)
moricalca|obsidian; (lit.) black glass (n)
morilúpë|blackbird; (lit.) black plume (n)
morimaitë|black-handed (adj)
moritöa|ebony wood (n)
morna (Physical World)|sombre (adj)
morna (Sense Perception)|black; black of hair; dark; sombre (adj)
mornië|blackness (n)
mortavar|ebony (n)
morteccon (morteccond-)|graphite; (lit.) black writing rock (n)
morumbar|dark-fated (adj)
morë (mori-) (adj n)|black; blackness; dark; darkness; night (adj n)
morë (mori-) (adj)|black; dark (adj)
motto (Language and Music)|blot (n)
motto (Physical World)|blot; fen; marsh (n)
mo|anyone; one; somebody; someone (pron)
muhta-|to empty bowels; *to defecate (vb)
muilë|secrecy (n)
muina|hidden; secret (adj)
mul-|to grind; to *pulverize (vb)
mulda|powdery (adj)
mulessë|porridge (n)
mulmar|miller (n)
mulma|fine flour (n)
mulmin|mill (n)
mulo (mulu-)|fine powder (n)
mulondo|millstone (n)
mulë|ground grains; meal; *grist (n)
mun-|to dislike; to not like (vb)
mundo (mundu-)|cape [of land]; nose; snout (n)
mundollë|calf (n)
mundo|bull; ox (n)
munta|nothing; *zero (n)
muqua|filthy (adj)
mussë|soft (adj)
mut (muc-)|dirt; filth (n)
má; quár(e)|hand (n)
máfastië|hand-pleasure; writing for pleasure of hand and eye (n)
máhis|either sweet corn or field corn; maize (n)
málimë (málimi-)|wrist; (lit.) hand-link (n)
málo|comrade; friend (n)
mál|grit (n)
málëa|healthful; healthy (adj)
málë|good health (n)
mámalin|sheepfold (n)
máma|sheep (n)
mánacestië|intercession; (lit.) boon-seeking (n)
mána|blessing; good thing (n)
már (mar-)|dwelling; habitation; home (n)
máralë; máriën|goodness (n)
mára|excellent; fit; good (of things); proper; useful (adj)
márië|being well; good estate; goodness; happily; happiness; well (adv n)
márë|(moral) good; goodness (n)
mátengwië|language of the hands (n)
mátima|edible (adj)
mélacárië|hobby; pastime (n)
mélamar|(emotional) home (n)
méla|affectionate; loving (adj)
mélië|loving; *love (n)
mén (mem-)|beak (n)
ména; rahtë; yondë; yón (*yond-)|region (n)
métima|final; last; ultimate (adj)
më|us (exclusive); we (pron)
mína-|to desire to go in some direction; to have some end in view; to make for it; to wish to go to a place; to *intend (vb)
mínaitë|straightforward; (lit.) apt to have some end in view (adj)
mínasta|intention; *goal (n)
mína|desiring to start; eager to go (adj)
míra|beautiful; lovely (adj)
mírima|very lovely; very precious; very valuable (adj)
mírë (n adj)|gem; jewel; precious; precious thing; treasure (n adj)
mírë (n)|jewel; precious thing; treasure (n)
mírëa|jewelled; *gemmed (adj)
mísë (*mísi-) [þ]|(light) grey (adj)
míwa|frail; small; tiny (adj)
móla|enslaved (adj)
móletyeller|career; (lit.) work-steps (n)
mólië|slavery; thralldom (n)
mólomë|hard work (n)
mól|slave; thrall (n)
mólë|labour; *work (n)
móna|*womb (n)
mórilanta|nightfall (n)
móriva|nocturnal (adj)
mórolingwë|squid; (lit.) ink-fish (n)
móro|ink (n)
mórë (móri-)|blackness; dark; night (n)
móta-|to labour; to toil; to *work (vb)
mótamen|office (n)
mótaro|worker (n)
möa|to must (impersonal) (vb)
múco|dung; muck; *manure (n)
na-súrima|aspirate (n)
na-|plu- (pref)
nac- (Body Parts and Functions)|to bite; to hate; to kill; to slay (vb)
nac- (Physical Acts and Materials)|to cut; to hew [into] (vb)
nacil; turo|victor (n)
naham-; tulta-; yal-|to summon (vb)
nahamna|summoned (adj)
nahta- (Body Parts and Functions)|to slay (vb)
nahta- (Law and Judgment)|to confine; to oppress (vb)
nahta; tolquë|eighteen (cardinal)
nahtalë|slaughter (n)
nahtana|*slain (adj)
nahtar|murderer; slayer (n)
nahta|bite (n)
nahtë|wounding (n)
nahámë|summons (n)
nai-|abominably; grievously; ill (pref)
naica|bitterly painful or grievous (adj)
naicelëa|agonizing; painful (adj)
naicelë|anguish (n)
naico|goat (n)
naicëa; nwalca [ñ-]; saura [þ]|cruel (adj)
naicë|sharp pain (n)
nainaima|lamentable (adj)
nainala|lamenting (adj)
nainalindë|dirge; (lit.) lament-song (n)
nainië|lament; *lamentation (n)
naiquet-|to curse or blaspheme (vb)
naiquéto|blasphemer (n)
naira|dire; dreadful; grievous; horrible; unendurable (adj)
nairenyanna|unfortunately; (lit.) to my sadness (adv)
nairë [ñ-]|space (as a physical dimension) (n)
nairëa|sorrowful; *sad (adj)
nairë|sorrow; *sadness (n)
naita-|to cause great grief to; to oppress (vb)
naitië|indeed; truly; *really (adv)
naitya-|to abuse; to put to shame; to *rebuke (vb)
naityalë|shame (n)
naityana|ashamed; shamed (adj)
naitë; sanda [þ]|true (adj)
nai|be it that; it may be; may it be that; maybe; perhaps; there is a chance or possibility; *may it be (adv)
nalanta-|to attack; (lit.) to fall upon (vb)
nalda [ñ-]|bright; polished (of metal) (adj)
nallamya-|to echo; to reverberate; to sound back (vb)
nalláma|echo (n)
nalta [ñ-]|glittering reflection (n)
naltalma [ñ-]|heliograph (n)
nalumë|sometime(s) (adv)
nam-|to judge; to *think (have as an opinion) (vb)
namba-|to hammer (vb)
namba|hammer (n)
nambírë|jasper (n)
namma; nappa|claw; talon (n)
nammar (nammard-)|court; courthouse; (lit.) judgment-house (n)
namnasta|regulations (n)
namna|statute; *law (n)
namoia-|to earn; to work (hard) for (vb)
nampaitya-|to pay back (vb)
nampaityalë|paying back; *restitution (n)
namárië|farewell; let it be well (to you); (lit.) be well (interj)
nan (nand-)|vale; valley (n)
nan(do)|(wide) valley; vale (n)
nan-|back (again); backwards (pref)
nan; ná(n)|but; on the contrary; on the other hand (conj adv)
nananta-|to give back; to *return [something] (vb)
nancal-|to reflect; (lit.) to shine back (vb)
nancar-|to undo; to *destroy (vb)
nancarindo; nancáro|destroyer (n)
nanca|*hewn (adj)
nancárima|destructible (adj)
nanda- [ñ-]|to harp (vb)
nandaro [ñ-]|harper (n)
nanda|?back (adj)
nandellë [ñ-]|little harp; *lyre (n)
nandelë|harping; *repetition (n)
nandë [ñ-]|harp (n)
nangwa|jaw (n)
nanhanquet-|to answer back (vb)
nanhat-|to cast back; to reflect (vb)
nannem-; vanya-|to disappear (vb)
nanomë|someplace; somewhere (adv)
nanquer-|to turn around; to turn back (vb)
nanquet-|to speak against; to talk back (vb)
nantar-|to stand back (vb)
nanwa (adj)|actual (true); existing; *real (adj)
nanwa (n)|(large) bowl (n)
nanwavë|actually; truly (adv)
nanwen-|to go/come back; to return (vb)
nanwenta-|to send back (vb)
nanwera|ransom (n)
nanwië|reality (n)
nanwë|ebb; lowtide (n)
nanya-|to oppose; to resist; to struggle (vb)
nanyalë|opposition; resistance (n)
nap-|to grasp (with fingers); to pick up; to take (hold) (vb)
napan-|to add (vb)
napanna|additional letter (n)
naqui|although; even though; (lit.) if it is in fact (conj)
naraca|harsh; rending; violent of (?sounds) (adj)
narambo|bang; buffet (n)
narca-|to rend (vb)
narcarma|firearm; gun (n)
narca|ill-tempered; snappy (adj)
narcë|snap of a dog; spiteful remark; tear; *rend (n)
narda; nútë|knot (n)
narrundo|torch (n)
narta-|to inflame; to kindle; to set fire to; to *ignite (vb)
nartaima|inflammable (adj)
nartanwë|firework (n)
nas- [þ]|to welcome (vb)
nasal [þ]|guest (n)
nasarta-|to entrust (vb)
nasquë|bondage; durance (n)
nassë; tildë|spike (n)
nassëa (Emotion)|natural (adj)
nassëa (Spatial Relations)|barbed; pointed; spiked (adj)
nassë|nature; true-being; *essence (n)
nasta-|to sting (vb)
nastaro|scorpion (n)
nastyapsul (nastyapsulc-)|turnip; (lit.) prickly/stingy/sharp tasting root (n)
natsemen|website; (lit.) web-spot (n)
natsë|net[work]; web (n)
nattir-|to look back (vb)
nattira-|to despise (vb)
natto (nattu-)|affair; matter (n)
nattírima|despicable (adj)
nat|thing (n)
nauca|dwarf(ed); shortened; stunted (adj)
nauco|dwarf (n)
nauna- [ñ-]|to howl (vb)
nauro [ñ-]|werewolf; wolf (not wild wolves) (n)
nauta|bound; obliged (adj)
nauya-|to conceive [of an idea] (vb)
nav-; ric-|to try (vb)
naxa (adj)|sour (adj)
naxa (n)|bond; fetter (n)
na|to; towards (prep)
ne(re)sta|one ninth (fraction)
neccë|angle (n)
necel|thorn (n)
necermëa|immaterial; insubstantial (adj)
necestel|despair; desperation; hopelessness (n)
nef-|to breathe (air) (vb)
nefítë|air-breathing (adj)
nehta-|to deprive (vb)
nehtano|exile whose rights and goods have been confiscated; one deprived (n)
nehtar|slayer (n)
nehtelë; nehtë|honeycomb (n)
nehtë|angle; narrow prominitory; spearhead; wedge (n)
nel(d)esta|one third (fraction)
nel-|tri- (pref)
nelca|dense (adj)
neldëa; nelya|third (ordinal)
neldë|three (cardinal)
nelecco|fork; (lit.) three-thorn (n)
nelet (nelc-)|tooth (n)
nellon (nellond-)|granite; (lit.) tri-rock (n)
nellumë|three times; thrice (adv)
nellë|brook; *stream (n)
nelmasirpë [þ]|thistle; (lit.) needle-stalk (n)
nelma|needle (n)
nelquain|thirty (cardinal)
nelqua|cornered; *angled (adj)
nelquesta|one thirteenth (fraction)
nelquëa|*thirteenth (ordinal)
nelquë|*thirteen (cardinal)
neltil (neltild-)|triangle (n)
neltë|corner (n)
nelya-|to congeal; to thicken (vb)
nem-|to appear; to seem (vb)
nembalë|evidence (n)
nemba|evident; probably but not necessarily so; seeming (adj)
nemesta|appearance; seeming (n)
nemestëa|apparent; *obvious (adj)
nen (neng-)|nostril (n)
nendalaurë|golden water-flower; yellow iris (n)
nenda|wet (adj)
nendil|beast that lives in the water (n)
nendo|water mead; *watered plain (n)
nendë|lake (n)
nenemma-|to keep on (re-)appearing (vb)
nengarmo|otter; (lit.) water-wolf (n)
nengwetanwa|nasal-infixed (adj)
nengwetehta|nasal sign (n)
nengwë (nengwi-)|nose (n)
nengwëa|nasal (adj)
nenquet-|to (orig.) speak down the nose; to condescend (vb)
nenta-|to pretend; (lit.) to make seem (vb)
nenungol|octopus; (lit.) water-spider (n)
nercë|little man (n)
nerdo|large; strong man (n)
nernehta|man-spearhead (n)
nertëa|ninth (ordinal)
nertë|nine (cardinal)
nes (nest-)|feed; fodder (n)
nessa; vinya|young (adj)
nessamelda|species of tree in Númenor; (lit.) beloved of Nessa (n)
nesselë|mead[ow]; pasturage; pasture (n)
nessima|youthful (adj)
nessornë|sapling (n)
nessë; nésë [þ]; vinyarë; vén; vínë|youth (n)
nessë|past tense; (lit.) nē-ness (n)
nesta-|to give to feed; to graze; to pasture (vb)
nestië|(act of) feeding (n)
nesya [þ]|gay; girlish (adj)
net(ë)|one more beyond (the middle) (n)
net- [ñ-]|to get (vb)
neterquain|ninety (cardinal)
neterquëa|nineteenth (ordinal)
neterquë|nineteen (cardinal)
netil|small thing of personal adornment; trinket (n)
netsë (netsi-)|little sister; ‘lil sis’ (intimate) (n)
netto|big sister; ‘big sis’ (intimate) (n)
nettë|(little) girl (n)
netya-|to adorn; to trim (vb)
netya|dainty; pretty (adj)
neuma|snare; *noose (n)
neuna|next; second; *following (adj)
neuro|successor (n)
nev- (Physical Acts and Materials)|to experiment; to try; to *seek opportunity (vb)
nev- (Spatial Relations)|to face; to turn toward; to *confront (vb)
nevië|experiment (n)
nexa|angular; sharp (adj)
ngolfinë; nolfinë [ñ-]|magical skill (n)
ni; nyë|I; me (pron)
nicu-; niqu-|to be chill; to cold; to freeze (of weather) (vb)
nicë|a bit; little (adv)
nihta-|to make small; to reduce (vb)
nihtana|minor; reduced (adj)
nihta|bit (of indeterminate size); piece (n)
nil (nild-)|blue-bell; harebell (n)
nil-|to have special concern/care/interest for; to love (vb)
nilda|friendly; loving (towards) (adj)
nildo|friend [m.] (n)
nildë; sermë|friend (f.) (n)
nillë (nill-)|small [woman] (n)
nillë [ñ-]|Valinorian imagines [images of real stars]; silver glint (n)
nilmo; sermo; seron|friend (n)
nilmë|concern for things other than self for their own sakes; friendship; love (n)
nilya-|to befriend; to devote oneself to (vb)
nimpa|ailing; drooping (adj)
nimulë; níma|a seeming; phantom (n)
nindari|nymph; river-maid (n)
nindë; teren; terenë|slender (adj)
ninquelë|pallor (n)
ninqueri|*white (female thing or personification) (n)
ninqueru|white (male thing or personification); white male swan; white man; white ship (n)
ninquinta-|to grow pale (vb)
ninquissë|whiteness (n)
ninquita-|to grow white; to make white; to shine white; to whiten (vb)
ninquitárë|whitening; whitewashing (n)
ninquë (ninqui-)|chill; cold; pallid (adj)
ninteccon (ninteccond-)|chalk; (lit.) white writing rock (n)
ninya|mine; my (pron)
niquessë|frost-patterns; ice-flake; snowflake; (lit.) chill feather (n)
niquis (niquiss-)|ice-flake; petal (loose) of a white flower; snowflake (n)
niquë; ringë (ringi-)|cold (n)
niquë|snow (n)
nir-|to force (in a given direction); to press; to thrust; *to impose (with allative) (vb)
nirmunqua|willful (adj)
nirmë|act of will; exercise of will (n)
nirwa (adj)|scarred (adj)
nirwa (n)|bolster; cushion (n)
nirwë; sahtë|scar (n)
nirya-|to lean against (vb)
nis (niss-); nissë; nís (niss-)|woman (n)
nis (nix-)|minnow; ‘little fish’ (n)
nis- [þ]|*to smell sweetly (vb)
nisilë [þ]|fragrance; perfume (n)
nisilëa [þ]|perfumed (adj)
nisquë|incense; *(lit.) sweet smoke (n)
nista-|to perfume (vb)
nista|push; shove; thrust (n)
nisto|large woman (n)
niswa [þ]|censer (n)
nitya; picina; pincë; pitya; titta|little (adj)
nityahan (nityahán-)|little brother (informal/familiar) (n)
nityanet (nityanés-) [þ]|little sister (informal/familiar) (n)
nixë (Animals)|little fish; minnow (n)
nixë (Physical World)|frost (n)
niétë|dripping; exuding; oozing (n)
nië; nírë|tear (n)
niënaitë; nyenya|tearful (adj)
niëninquëa|like a snowdrop (adj)
niëninquë|snowdrop; (lit.) white tear (n)
niëres (niëress-)|hive (n)
niër|(honey) bee (n)
noirë|tomb (n)
nolmar [ñ-]|school; university; (lit.) wisdom-house (n)
nolmo [ñ-]|wise person (n)
nolmë [ñ-]|department of wisdom (science, etc.); philosophy (including science) (n)
nolpa|mole (n)
nolta- [ñ-]|to teach; to tutor; to *educate; (lit.) to make knowledgable (vb)
noltar [ñ-]; saitar|teacher (n)
nolwë [ñ-]|(secret) lore; wisdom (n)
nolya [ñ-]|dark-haired; *brown-haired (adj)
nolya- [ñ-]|to study (vb)
nonda|hand especially in (?clutching) (n)
nonwë|calculation; sum; *total (n)
nonóra-|to run on; to run smoothly and hum; to *keep on running (especially of machines) (vb)
nor-|to run (of animals or men) (vb)
noremmatan (noremmatam-)|cartographer (n)
noremma|map (n)
norima|strong/swift at running; swiftly running a course (adj)
norië|running (n)
normë|race (n)
norna|firm; hard; obdurate; resistant; stiff; thrawn; tough (adj)
nornolassëa|having oak-leaves (adj)
norno|oak (n)
nornëa|*of oak (adj)
noroitë (noroiti-)|(capable of) running (adj)
norolinda|*tripping lightly (adj)
norollë|cart (n)
norsa [þ]|giant (n)
norta [ñ-]|horrible (adj)
norta-|to make run (specially used of riding horses or other animals); to ride (vb)
nortil|cape (of land) (n)
norto [ñ-]|horror (n)
nos(së)|clan; family; kindred; ‘house’ (n)
nossetur|family head; patriarch (n)
nossë|clan; family; ‘house’ (n)
nosta-|to be begotten; to beget; to give birth to; to *be born [impersonal] (vb)
nostalë|kind; sort; species; *type (n)
nostarenca|orphaned; (lit.) parent-less (adj)
nostar|forbearer; *ancestor (n)
nostarë|birthday (n)
nosta|birth (n)
not- (Possession and Trade)|to count; to reckon (vb)
not- (Quantity and Number)|to reckon (vb)
notessëa|digital; numeral (adj)
notessë|numeral (n)
nucumna|humbled (adj)
nucupta-|to force to bow; to humble (someone); to vanquish (vb)
nucuv-|to genuflect; to humble oneself; to pay homage; to submit (vb)
nuhta-|to not allow to continue; to prevent from coming to completion; to stop short; to stunt (vb)
nuinerocco|hippopotamus; (lit.) river-horse (n)
nuinë|river (suf)
nui|lament (n)
nulda|secret (adj)
nulla|dark; dusky; hidden; obscure; secret (adj)
nulma [ñ-]|mystery (n)
numba|bent; humped (adj)
numbëa|timid (adj)
numbë|timidity (n)
nungwë|cold (in the nose or head) (n)
nunya|lower (as in quality, rank or value) (adj)
nupattal|horseshoe (n)
nuqua|obstacle (n)
nuquerna|inverted; reversed; *(lit.) under-turned (adj)
nur (nurr-)|complaint (n)
nur-|to grow/be dark (vb)
nurmëa|lesser; subordinate (adj)
nurmë|subordination (n)
nurno|dark; deep (of hue) (adj)
nurru-|to grumble; to mumble; to murmur (vb)
nurrulë|murmuring (n)
nurta-|*to hide (vb)
nurtalë|hiding (n)
nuru [ñ-]|death [abstract] (n)
nurunyel (nurunyell-) [ñ-]|foxglove; (lit.) death-bell (n)
nus (nust-)|smell (n)
nusta-|to smell [something] (vb)
nustaima|odorous; (lit.) able to be smelled (adj)
nustë|sense of smell (n)
nut-|to tie (vb)
nutanwë|infrastructure (n)
nutta|comma; (lit.) that what ties or binds (together) (n)
nuxo|Petty dwarf (n)
nu|beneath; under (prep)
nwal- [ñ-]|to feel (great) pain; to suffer (vb)
nwalma [ñ-]|pain (n)
nwalmë [ñ-]; unqualë|torment (n)
nwalya- [ñ-]|to pain; to torment (vb)
nwar- [ñ-]|to erode; to fret; to wear away; to *worry about [with reflexive + dative] (vb)
nwara- [ñ-]|to erode; to gnaw; to wear away (vb)
nwámë [ñ-]|wolvish howling (n)
nwátengwë [ñ-]|irony; (lit.) disguise-token (n)
nwë [ñ-]|*we (inclusive) (pron)
nyaira|claim (n)
nyanda-|to gnaw (vb)
nyar(a)-|to recite (in sing-song voice); to relate; to talk; to tell (vb)
nyar-|to recite; to relate; to tell (vb)
nyarda-|to preach (vb)
nyardar|preacher (n)
nyarda|list; (lit.) product of recitation (n)
nyarië|talking (n)
nyarmë|storytelling (general/abstract) (n)
nyarnamaitar|composer of long epic tales; storyteller; *author (n)
nyarna|(long epic) tale; legend; saga; story (n)
nyarrincë|mouse (n)
nyarro|rat (n)
nyarvëa|fictional (adj)
nyarvë|fiction (n)
nyas [þ]|line; mark; score; scratch (n)
nyas- [þ]|to scratch (vb)
nyasta|snack (n)
nyat-|to chat; to talk idly; to *gossip (vb)
nyatil|gossip; idle talk (n)
nyatso|magpie; (lit.) chatterer (n)
nyelecca|onyx (n)
nyelet (nyelec-)|nail (of the finger) (n)
nyello|singer (n)
nyellë|bell (n)
nyenya|plaintive; querulous (adj)
nyenyë|weeping (n)
nyárula|apt to talk (adj)
nyárë|account; saga; tale (n)
nyéni|(she) goat (n)
nyérë|grief (n)
nyé|bleat; cry of goat or sheep (n)
nyûna|second (adj)
ná-|to be (vb)
nácë|it may be seeming; *qualified yes (interj)
náha|*thin (adj)
náma|judgment or desire (n)
námima|culpable; (lit.) judgeable (adj)
námië|single judgment or desire (n)
námo (Grammar)|person; somebody (unnamed) (n)
námo (Law and Judgment)|judge (n)
námocombë|tribunal (n)
námondur|court-attendant; (lit.) judge-servants (n)
nápat|thumb and index [fingers] as a pair (n)
nápo|thumb; (lit.) picker (n)
náquet-|to agree (on fact); to assent; (lit.) to say ‘it is’ (vb)
nár(e)|flame (n)
nár|fire (as an element) (n)
nása|it is so; yes (interj)
násië|*amen; (lit.) may it be so (interj)
náto|it is that; *yes (emphatic) (interj)
náva [ñ-]|speech apparatus; *mouth (including tongue, lips and teeth) (n)
náva; sappa; unqua|hollow (adj)
návëa [ñ-]|consonant; *consonantal (n adj)
návë|being (n)
ná|it is a fact; it is so; yes (interj)
néca|dim to see; faint; vague (adj)
némë|leave; *permission (n)
nén (nen-)|water (n)
nér (ner-)|adult male; male person; man (n)
nésa [þ]; seler (sell-) [þ]|sister (n)
néya; nëa|at one time; once (adv)
né|ago; behind (earlier time); yes (it was so) (adv)
níca|little; small (adj)
nílanta-|to become devoted; to dedicated; to or strongly attached (vb)
níla|devoted (adj)
nílë (níli-)|a special concern with or love for (n)
nípa|small (usually with connotation of weakness) (adj)
níra|individual will (in potential); will (as a potential or faculty) (n)
nírë|force (n)
nírítë|driving; exerting great thrust or pressure; forceful (adj)
nísima [þ]|fragrant (adj)
níta-|to cry [tears]; to weep (vb)
nítë (*níti-)|dewy; moist; *damp (of weather) (adj)
ní|female; woman (n)
nó (n)|design (n)
nó (prep conj)|after (of place); at back (of place); before (of time); behind; yester- (prep conj)
nó (prep)|yester-; *after (prep)
nó-|to be born (vb)
nóla [ñ-]|learned; wise (adj)
nóla|knoll; round head; round hilltop (n)
nólecöa [ñ-]|school; (lit.) house of lore (n)
nólë [ñ-]|long study; lore; wisdom (n)
nólöa|yesteryear (n)
nómessë|place-name (n)
nómëa|local (adj)
nómë|place (n)
nónarë|generation (n)
nóna|born (adj)
nópata-|to precede; (lit.) to walk before (vb)
nóquista-|to assume; to make premature judgements (vb)
nór (nor-); nórë|land (n)
nórarwa|economy; (lit.) country-wealth (n)
nóretur|governer; (lit.) country-ruler (n)
nórëa|national (adj)
nórë|clan; country; folk; kindred; nation; race; region where certain people live; tribe; †people (n)
nótar|calculator; computer (n)
nótengolmë|mathematics (n)
nótima|(colloquial) moderate in amount; countable; few; limited in number (weight and measure); several; some (adj)
nótië|*counting (n)
nótë|number (n)
nöa|former; yesterday; *previous (adj n)
núla [ñ-]|dark; mysterious; occult (adj)
núla|under [beyond] (prep)
núlemo [ñ-]|(evil) sorceror; black magician (n)
núlë [ñ-]|black arts; sorcery (n)
númen|direction or region of the sunset; occident; west; (lit.) going down (n)
númë|west (n)
nún|beneath; down below; underneath (adv)
núra; tumba; tumna|deep (adj)
núrië|depth (abstract) (n)
núromolië|ministry; (lit.) servant-labour (n)
núro|servant (n)
núrula|grumpy; (lit.) likely to growl/grumble (adj)
núrë (Social Relations)|maid servant; servant-woman (n)
núrë (Time)|night (n)
núta-|to lower; to set; to sink (of Sun or Moon) (vb)
nútaitë (nútaiti-)|*(naturally) lowering; ?degrading (adj)
nútil (nútill-)|under-point (n)
nútima|*lowerable (adj)
nútë; vérë|bond (n)
núya-|to descend; to set (of the sun); to *come down (vb)
o(to)sta|one seventh (fraction)
o-; va-|together (pref)
ocar-|to cooperate; to participate; to work together (vb)
ocaraitië|a set of activities; program (n)
occa|knee (n)
ofelmenca|indelicate; tactless; (lit.) without together-feeling (adj)
ofelmë|compassion; pity; sympathy; *(lit.) together-feeling (n)
ohlon|diphthong (n)
oholima|confidential (adj)
ohtarië|martial ardour (n)
ohtar|warrior (n)
ohta|war (n)
ohtë|egg (n)
ohéressëa|political (adj)
ohéressë|politics (n)
oi(o)|an endless period; ever; everlastingly; *aeon (adv n)
oi-|to live; to pass one’s days (vb)
oi; oiavë|everlastingly (adv)
oi; voro; úlumë|ever (adv)
oia(la)|everlasting; for ever; unceasing; without end (adj)
oialë; oirë|everlasting age (n)
oialëa; oira|eternal (adj)
oialë|eternally; everlastingly; forever; in eternity (n adv)
oia|everlasting (adj adv)
oiolairë|ever-summer (a species of tree) (n)
oiwa|glossy (adj)
oiwië|gloss; glossiness (n)
ola- (Physical Acts and Materials)|to become; to grow (up) (vb)
ola- (Spatial Relations)|to grow up; to reach its prime (vb)
olanwa|adult; fully grown; mature (adj)
olass(i)ë|collection of leaves; foliage (n)
olasta; olmië|growth (n)
olba|branch (n)
olca|bad; wicked (adj)
olindë|harmony (n)
olirië|concert (n)
olië|company; people together (n)
olla|over [beyond] (prep)
ollë|*other one (adj)
olmen (olmend-)|growth-year (n)
olmos (olmoss-)|chestnut tree; *chestnut (n)
oloirë|great flood (n)
oloiya-|to flood; to inundate (vb)
olopsë|broom (n)
olorda|dreamy; drowsy; in dreams (adj)
olorië|theory (n)
olor|dream; vision (n)
olosta|dreamy; *dreamlike (adj)
olpë|bottle (n)
olva|growing things with roots in the earth (n)
olótë|bloom; the flowers collectively of a single plant (n)
ombari|company; dwellers together (n)
omen-|to meet; to move to a common point; to *(lit.) move together (vb)
omentië|meeting (of pathways); meeting or junction of the directions of two people; (lit.) coming together of journey-path (n)
omolmessë|corporation (n)
omolmë|business; company; enterprise; firm (n)
ompa; póna|forward (adv)
omya-|to resonate (of longer sounds) (vb)
omírë|jewelry (collectively) (n)
onda|creation; work (n)
ondolunca|stonewain (n)
ondolë|(stone) monument or cairn (n)
ondomaitar|sculptor in stone (n)
ondomillo (ondomillu-)|gas; gasoline; petrol; petroleum (n)
ondopelet (ondopelecc-)|pickaxe (n)
ondosercë|plant with red flowers; stonecrop; (lit.) blood of stone (n)
ondova|stony (adj)
ondo|(large mass of) rock; stone (as a material) (n)
ondórëa|hard-hearted; pitiless (adj)
ongolmo|geologist (n)
ongolmë|geology (n)
ongwemo|criminal; transgressor (n)
ongwë|crime (n)
onin|anvil (n)
onna (Animals)|creature (n)
onna (Mankind)|*offspring (n)
onot-|to count up; to *reckon (vb)
onta-|to beget; to create; to *conceive (a child) (vb)
ontalë|ancestry; descent; *derivation (n)
ontamo|mason (n)
ontaro|begetter; parent (n)
ontar|parent (gender neutral) (n)
ontarë|begetter; parent (f.) (n)
ontavalië|puberty; *(lit.) able to beget (n)
onya|my child (n)
onóna|one of a pair of twins; twin-born (adj n)
onónë|kinswoman (n)
onóro; rendo; ressë|kinsman (n)
onótimo|*reckoner (n)
onótië|*reckoning (n)
opelë|town; village; walled house; *hamlet; *manor (n)
opo; pó|before; in front (of place) (prep)
or-; ora-|to feel an urge/wish/desire; to urge; to warn (vb)
orc; orco (orcu-)|goblin (n)
orco|Orc (n)
orda-|to threaten (vb)
orda; tumna|profound (adj)
orendë|(nuclear) family (n)
orhal-|to exalt (vb)
oricon|heather (n)
orina|risen (adj)
ori|grain (n)
ormo|riser (n)
ormë|haste; rushing; violence; wrath (n)
orna; tyelca|hasty (adj)
ornemalin|[tree] bearing yellow flowers (n)
ornendur|forester; tree-keep; woodsman (n)
ornë|(high isolated) tree; (tall) tree (n)
oro-|aloft; up (pref)
orohalla|superior (adj)
orolanda|plateau; upland (n)
oroman (oromand-)|mountain dweller (n)
oromar (oromard-)|high (lofty) dwelling; high-mansion; lofty hall (n)
oron (oront-)|mountain (n)
oroparmen|high school; university (n)
ororia-|to keep on rising (and falling) (vb)
orosta|ascension (n)
orotinga; orto|mountain-top (n)
oro|mount; mountain (n)
orpano|ridgepole (n)
orro|on high; up in the air (adv)
orró-|sunrise; uprising (pref)
orróna; rómenya|eastern (adj)
orsa [þ]|above; upper (adj)
orta-|to lift (up); to raise; to rise; (lit.) to cause to rise (vb)
ortil|up-point (n)
ortima|able to be raised (adj)
ortirmo|overseer (n)
ortië|lifting up; raising (n)
ortosta|mountain range (n)
ortur-|to conquer; to overpower; to prevail (vb)
ortírië|*patronage; (lit.) watching over (from above) (n)
orvamir|chrysoprase; (lit.) apple-jewel (n)
orva|apple (n)
orwa; tára|high; lofty (adj)
orya-|to rise (vb)
oryandë|arising (n)
oryat (oryap-)|badger (n)
or|above; upon (prep)
oscaita-|to surround; (lit.) to around-lie (vb)
oscir-|to circumcise; (lit.) to around-cut (vb)
osellë [þ]|[sworn] sister; associate [f.] (n)
ospor|chaff (n)
osquetië|context (n)
ossa|surrounding (adj)
ossië|surroundings (n)
ossë|terror (n)
ostampë|siege (n)
ostap-|to besiege; (lit.) to around-block (vb)
ostar; uomë|community (n)
ostec-|to describe (vb)
ostimmir|agate; (lit.) blend-jewel (n)
ostimë|blend (n)
ostirion; osto|fort (n)
ostomo|citizen (n)
osto|city; fortress; strong place; stronghold; town with wall round (n)
oswë [þ]|hip (n)
os|about; around (prep)
osáma|common; joint; (lit.) together-having (adj)
otarmië|colonnade (n)
otolmië|keyboard (n)
otoquain|seventy (cardinal)
otoquëa|seventeenth (ordinal)
otoquë|seventeen (cardinal)
otornassë|brotherhood; *association (n)
otornië|alliance; association; company (n)
otorno|associate [m.]; sworn brother (n)
otsolametta|weekend (n)
otsola|(seven-day) week (n)
otsollumë|seven times (adv)
otso|seven (cardinal)
otsëa|seventh (ordinal)
ovesta|compact; contract; treaty (n)
ovëanta-|to imitate; to make like (vb)
ovëantainë|imitation (n)
ovëassë|likelihood; resemblance (n)
ovëa|(con)similar; alike (adj)
o|from (prep)
pahta-|to speak; to talk (intransitive) (vb)
pahta; questa|speech (n)
pahtalanga-|to interpret; to translate (speech) (vb)
pahtalanga|interpretation (n)
pahtando|orator (n)
pahta|closed; private; shut (adj)
paimenë|cruelty; vengefulness; vindictiveness (n)
paimesta|chastisement (n)
paimeta-|to exact or inflict a penalty; to punish (vb)
paimë|infliction; penalty; punishment; vengeance taken (n)
pairemo|avenger (n)
paireta-|to avenge; to take vengance (vb)
pairë|revenge; vengeance (n)
paitya-|to repay; to requite (vb)
paityalë|payment; reward (n)
palallon|telephone; (lit.) far-sound (n)
palancenta|telecommunication (n)
palancen|television; (lit.) far-sight (n)
palantilla|telescope (n)
palantir-|to watch/look afar (vb)
palantir|far-seer (n)
palantímië; palanyantië|telepathy (n)
palantír|far-gazer; far-seer; (lit.) that which looks far away (n)
palan|afar; distant; far; over a wide space; to a distance; to a great extent; wide (adj adv)
palar|flat field; ‘wang’ (n)
palca-|to beat flat (vb)
palda (adj)|broad; wide; *expansive (adj)
palda (n)|dish; plate; platter (n)
palis (palist-)|green; lawn; sward (n)
palla|far beyond (prep adv)
palma|flat plank; flat tool; oar (n)
palmë; palúrë|surface (n)
palo (palu-)|flatness; plane (surface); the flat; *level (n)
palpa-|to applaud (with palms); to batter; to beat; *to clap (vb)
palta-|to feel with the hand; to stroke (vb)
paltalda|palm tree (n)
palta|flat of the hand; shelf; *palm (n)
palu-; palya-|to expand; to extend; to open wide; to spread (vb)
paluhta|table (n)
paluhtincë|tablet (n)
palusta|bookshelf; shelf (n)
palwa|even; level (adj)
palúrë|(Old English) folde; bosom; bosom of Earth (n)
pamba|ball (n)
pampilëa|tremulous (adj)
pampilë|trembling (n)
pampinë|[minor] earthquake; tremor (n)
pan-|to set in order; *to arrange (vb)
panda; tarwa|enclosure (n)
panin|concerted; definite; deliberate; meant; planned; prepense (adj)
panna|arrangement; course; grouping; *plan (n)
pano|piece of shaped wood; plank; *board (n)
panta-|to open; to spread out; to unfold; to unfurl (vb)
panta|open; spreading; wide (adj)
pantië|unfolding (n)
panwë|(musical) theme; arrangement; ordering; plan; structure (n)
panya-|to arrange; to fix; to plan; to set (vb)
pan|because; *since (conj)
pap-|to tremble (vb)
par-|to learn (vb)
parahta-; tarqua-|to dry (vb)
parandë|(school) lesson (n)
parca|dry (adj)
parco|towel (n)
parda|bark (of a tree) (n)
parma-resta|*book-fair (n)
parmacas (parmacaps-)|bookcase (n)
parmahenta-|*to read (vb)
parmahentië|(book) reading (n)
parmahto|author (n)
parmaina|literary; of books (adj)
parmalas(së)|page; (lit.) leaf of book (n)
parmasan (parmasamb-) [þ]|library [room] (n)
parmasson (parmassond-)|librarian (n)
parmassë|literature (n)
parmatéma|p-series (n)
parma|book; composition; writing; written document of some size (n)
parmen|place of study; school (n)
parmo|student; (lit.) learner (n)
parna|bare (adj)
parnë|bald; bare (adj)
parta-|to arrange; to compose; to order (vb)
partalë|order; orderliness; organization (n)
partië|arrangement; composition (n)
pas- [þ]; pasta-|to smooth (vb)
pasta [þ]; runda|smooth (adj)
pasta-|to iron (vb)
pasta|glabrous; sleek; smooth(ed) (adj)
pat-|to step; to take a (single) step (vb)
pata-|to rap; to tap (of feet); to walk; to *stroll (vb)
patacë|clatter (n)
patahta-|to clatter; *to clap (+ instrumental of hands) (vb)
patinca|slipper (n)
pattal|hoof (n)
patta|sleek; smoothed (adj)
patu-|to start off; to start walking; to step to it (vb)
pat|step (n)
pa|about (prep)
pecco|nut (n)
peccuvo|squirrel; (lit.) nut-hider (n)
pehtë|cox-comb; *crest (of birds) (n)
pel-|to encircle; to fence in; to go round; to pen in; to return; to revolve; to surround (vb)
pelas|along; (lit.) by the boundary of (prep)
pelecco (peleccu-)|axe (n)
peler|fenced field (n)
pelin|fenced in; pent (adj)
pellauca|lukewarm (adj)
pella|beyond (boundary or limit) (prep adv)
pellopë|ass; donkey (n)
pelma|border; edge; fringe; limiting device; pen (n)
pelo|boundary (fence) (n)
pelta-|to roll (vb)
peltas (peltax-)|a ‘pale’; fence of fixed stakes (n)
pempë|lip (n)
pen-|to not to have; *to lack (vb)
penda-|to incline; to slope (vb)
penda|(steeply) inclined; sloping down (adj)
pendë|(down) slope; declivity; downslope; hillside; steep incline (n)
penga-|to pout (vb)
pengëa|labial; of the lips (adj)
penië|lack; shortage; want (n)
penna|lacking; vowel (adj n)
penno|poor man (n)
penquanta|full to the brim; with mouth full (adj)
penta-|to lose (vb)
pententa-|(lit.) to indicate by mouth (vb)
pententalë|mention (n)
pentë|front (n)
penyalë|deprivation; poverty (n)
penya|inadequate; lacking; *poor (adj)
pepella-|to circulate; to orbit (vb)
pequ-|to card wool; to comb; to tease (vb)
pequen|comb (n)
per-|half; semi (pref)
percoron|hemisphere (n)
peresta-|to disturb (vb)
peresta; perta|one half (fraction)
perestië|disturbance (n)
permë|half; side (of person or shape) (n)
perranga|cubit (n)
persa-|to affect [sounds] (vb)
persana|affected (adj)
persanië|affection (n)
pertol (pertoll-)|peninsula (n)
perwaima|skirt; (lit.) half-robe (n)
perya-|to divide in middle; to halve (vb)
perómanda|semivocalic; *semi-vowel (adj n)
pic-|to dwindle; to lessen; to wane (vb)
picara|leopard (n)
pihta-|to shrink (vb)
pil-|to steal (vb)
pilin (pilind-)|arrow (n)
pilinehtar|a reed-like plant; (lit.) ?arrow thorn (n)
pilintan|fletcher (n)
pilucca|stealthy (adj)
pilu|robber; thief (n)
pilwë|robbery; theft (n)
pimpilin|hanging tail; tassel (n)
pimpina|trailing (adj)
pimpë (pimpi-)|tail (n)
piopin|fruit of hawthorns; haws (n)
pio|berry; plum (n)
pirin (pirind-)|pin; thin rod (n)
pirina|juicy; oozy (adj)
pirindë; pirnë|flower that opened and shut quickly with any change of light (n)
pirindëa|cylindrical (adj)
pirinumbë|cylinder (hollow) (n)
pirucendëa|on the point of her toes (adj)
pirya|juice; syrup; *sap (n)
pirë; taltil (taltill-); tillë|toe (n)
pitsa|pizza (n)
pitya|petty (adj)
piuca|blackberry (n)
piuta-|to spit (vb)
piëmillo|olive oil (n)
poco(lle)nyarro|opossum; (lit.) pouch-rat (n)
pocollë|pouch (n)
poco|bag (n)
poica|clean; pure; tidy (adj)
poinessë|?cleanliness (n)
poita-|to cleanse; to *clean (vb)
poitië|(act of) cleaning; cleansing (n)
pol-|to be able to; to can (vb)
polca|pig (n)
polda (Body Parts and Functions)|burly; strong (adj)
polda (Spatial Relations)|big; burly; strong (adj)
poldavë|strongly (adv)
poldorë; tuo|physical strength (n)
poldórëa|muscular; strong; strong-bodied (adj)
polië|ability (n)
pollo|ram (n)
polondë|alder (n)
polta-|to (physically) enable (vb)
polë (poli-); porë (pori-)|flour (n)
polë (poli-)|meal (n)
polëa|able (adj)
pono; poto|in front (of place) (prep)
popólu-|to practice; (lit.) to slowly gain ability (vb)
porisalquë|corn; (lit.) flour-grass (n)
porocë|barn fowl; *chicken (n)
poroton|proton (n)
poru|kernel (n)
potai|*therefore; (lit.) before which (conj)
psar-|to fret; to rub (vb)
psára|peel (n)
pucco (puccu-)|cunnus; vagina (n)
puhta-|to copulate; to have sex (vb)
puhta|coitus; *sex (n)
puhtëa|sexual (adj)
pulco|bole of tree; trunk; *torso (n)
pulmaxë|leaven(ing); *yeast (n)
pulta-|to leaven; to make swell (vb)
puncil|male organ; penis (n)
punta|stopped consonant (n)
pupso|blow fly; large fly (n)
pusta-|to cease; to put a stop to; to stop (vb)
pusta|pause; stop; *halt (n)
putil|brake (pedal); the element of a vehicle used to activate the braking mechanism (n)
putta|stop (in punctuation) (n)
páselannë [þ]|linen-cloth (n)
páselarma [þ]|linen-raiment (n)
pásë [þ]|linen (n)
pá|about; as regards; concerning; on (above but touching); touching (prep)
pérappa|bridle; (lit.) lip-rope (n)
pé|(closed) mouth; the two lips [as dual] (n)
pëanta-|to enjoin; to give instructions to (vb)
pímótar|ant; (lit.) insect-worker (n)
píta-|to decrease; to reduce (vb)
pí|gnat; small insect; *mite (n)
púrëa|bleared; discoloured; smeared (adj)
qua(na)|all; complete; entire; full; the whole (adj pron)
quaccas (quaccar-)|tadpole; (lit.) frog head (n)
quaihúmë|myriad; ten thousand (cardinal)
quainquë|*sixteen (cardinal)
quainyë|decade (n)
quainëa|tenth (ordinal)
quaista|one tenth (fraction)
qual-|to die (vb)
qualin; vanwa|dead (adj)
qualmëa|deadly; deathly (adj)
qualmë|(death) agony; (process of) death (n)
qualta-|to kill; to murder (vb)
qualussë|perfect tense; (lit.) full tense (n)
qualöa(va)|annual; perennial (year as whole); yearly (adj adv)
quam-|to be ill; to vomit (vb)
quamna|vomit (n)
quampa-|to hawk goods (vb)
quampalë|bargaining; chaffering; *haggling (n)
quampa|peddlar-goods (n)
quampo|huckster; pedlar (n)
quanta-tencelë|full writing (n)
quanta-|to complete; to fill [something]; to *fulfill; to *(lit.) make full (vb)
quantassë|fullness (n)
quanta|filled; full (adj)
quantemma|facsimile; *(lit.) full-picture (n)
quantiën|century; (lit.) full year (n)
quantolië|maturity (n)
quap-|to bargain; to barter; to chaffer; to swap (vb)
quapta-|to exchange (vb)
quaptalë|exchange (n)
quaptando|money-changer; (lit.) exchanger (n)
quapta|bargain; deal (n)
quaqua-|to cackle; to quack; to squawk; to *croak (vb)
quaran (quarán-)|full-moon (n)
quas- [þ]|to flap; to nod; to shake (vb)
quat-|to fill; to *be filled (vb)
quel-; sinta- [þ]|to fade (vb)
quel-|†to fail (vb)
quelehtima|corrupt; rotten (adj)
quelehtië|rot (n)
quelehtë|carcass (n)
quelet (quelett-)|corpse (n)
queletya-|to perish (vb)
quelië|*fading (n)
quellë|Autumn; late autumn and early winter; (lit.) fading (n)
quelmë|perdition; ruin; utter end (n)
quendi|female Elf (n)
quendu|male Elf (n)
quenelya|of the Elves (adj)
quennasta|syntax (n)
quenna|proverb; saying (n)
quenso|minstrel; reciter (n)
quentalë|account; narration (n)
quentaro|minstrel; narrator; reciter; speaker (n)
quentasta|historical account (n)
quenta|account; narrative; story; tale (n)
quequer-|to wag (vb)
quequetta-|to keep on saying; to repeat (vb)
quer-|to turn; to *revolve (vb)
querda|turn (e.g. in a game) (n)
queren (querend-)|pivot; revolving centre (n)
querma|spinning wheel; turn-table; *wheel (n)
quermen|a turning; corner (of a street); turn (n)
quernamo|convert; proselyte (n)
querna|*turned (adj)
querë|revolution (around a point) (n)
quessamin (quessamind-)|velvet; (lit.) downy silk (n)
quessehonda|frivolous; (lit.) feather-hearted (adj)
quesset (*quessec-)|pillow (n)
quessetéma|kw-series; q-series (n)
quessë|feather (n)
questa|language (n)
quet-|to say; to speak; to tell (vb)
quetil|language; talk; tongue (n)
quetië|words; *(lit.) saying (n)
quettacarmë|(art of) word-making (n)
quettalcar|renown; (lit.) word-glory (n)
quettalë|expression; phrase; sentence; wording (n)
quettapano|morpheme; (lit.) word-element (n)
quettaparma|wordbook; wordlist (n)
quetta|word (n)
quetyar-|to pronounce; (lit.) to cause vocal speech (vb)
quetyarmë|pronunciation (n)
quetítë|able to talk; glib; good at expression; having speech (adj)
quihta-|to shoot (vb)
quihta|projectile (from a bow or a crossbow); shot (n)
quilda-|to be quiet; to stay quiet (vb)
quildarë|bat (n)
quilda|hushed; quiet; still (adj)
quildë|hush; quiet; rest (n)
quilinoitë|[em]broidered (adj)
quilin|(orig.) bright-coloured; adorned; *embellished (adj)
quilma|paint (n)
quilta-|to encircle; to gird (vb)
quiltaina|girdled; girt (adj)
quiltalannë|apron (n)
quiltassë|(em)broidery (n)
quilta|belt (n)
quilya-|to color; to colour; to embellish; to *paint (vb)
quilëa|-hued; colored; coloured (adj)
quilë|color; colour; hue (n)
quima|whether (conj)
quin-|to speak high; to squeak (vb)
quinga-|to thrum (of strings, harps, etc.); to twang (vb)
quingatelco|*bow-legged (adj)
quinga|bow (for shooting) (n)
quinna|crested (adj)
quinqua|languid; relaxed; *lazy (adj)
quinquelëa|languorous; *relaxing (adj)
quinquelë|languor; *relaxation (n)
quinquenna|Solomon’s-seal (n)
quint|loop; stitch (in knitting) (n)
quiquië; quië|whenever (adv)
quir-|to make spin; to stir (vb)
quirilda|pirouetting; twirling (adj)
quiril|[spinning] top; spindle; *whirligig (n)
quirmë|cream (n)
quista-|to suppose (vb)
quit-|to knit (vb)
quitima|(for) knitting (adj)
quitin|joined tight; knitted (adj)
quitulma|scenario (n)
quol-|to ail; to *be sick (vb)
quolimo|invalid (n)
quolina|ailing; ill (adj)
quolu|disease (n)
quolúva|pestilent; pestilential (adj)
quolúvië|pestilence (n)
quonda|choking smog; smoke (n)
quor-|to (esp.) drown; to choke; to suffocate (vb)
quorin|choked; drowned; speechless (adj)
quosta-|to choke; to drown (trans.) (vb)
quácë|frog (n)
quámëa|sick; *nauseous (adj)
quámë|nausea; sickness (n)
quár(e)|fist (n)
quár(ë)|closed hand; fist (n)
quá|duck (n)
quén (quen-)|individual; man or woman; one; person; somebody (n pron)
quénë|petrel (n)
quétima|pronounceable; speakable; utterable; *able to be said (adj)
quëallumë|ten times (adv)
quëatarwa|vegetable or kitchen garden (n)
quëa|vegetable (n)
quín(ë)|crest; ridge (n)
quínëa|squeaking (adj)
quínë|squeaking; *squeak (n)
rac-|to break (vb)
raccalepta|*claw-fingered (adj)
racca|*claw (n)
racina|deprived; stripped (adj)
racon (racond-)|cobblestone; (lit.) broken stone (n)
raf-|to seize; to snatch (vb)
rahta-|to reach; to stretch out (vb)
rahtë|district; extent; reach; scope; sphere (n)
raica|bent; wrong (adj)
raima|net (n)
raina (Emotion)|gracious; smiling; sweet-faced (adj)
raina (Motion and Transportation)|caught in a net; enlaced; netted (adj)
rainë|good will; *peace (n)
raiqua|angry (adj)
raita- (Emotion)|to smile (vb)
raita- (Motion and Transportation)|to catch in a net; to make network or lace (vb)
raiwë|lace (n)
ral-|*to return (intransitive) (vb)
ralya-|to return (transitive) (vb)
rama|cause; legal case; (lit.) a matter on someone's behalf (n)
ramba; ran (ramb-)|beam of wood (n)
ramba|wall (n)
ramma|lever (n)
ranco (rancu-)|arm (n)
randa|age (100 Valian Years); cycle (n)
ranga|full pace; yard (n)
rangwië|fathom(ing); spatial reckoning/consideration (n)
rangwë|fathom (n)
ranqua|armful (n)
ranta; tië|course (n)
rantala|ladder (n)
rantarwa|partner (n)
rantië (Emotion)|party (n)
rantië (Warfare and Hunting)|tribute (n)
ranya-|to stray; to *wander (vb)
ranyaila|wandering (adj)
ranyar|wanderer (n)
ranya|erratic wandering (n)
rappa|rope (n)
ras-|to stick out (vb)
rasillo [þ]|squirrel (n)
rassemunda|rhinoceros; (lit.) horn-snout (n)
rassulca|carrot (n)
rassëa|horned (adj)
rassë|horn [of both animals and mountains] (n)
rattaraxa|tram; (lit.) track-wagon (n)
ratta|track (n)
rauco|demon; powerful hostile and terrible creature (n)
raucëa|demonic (adj)
raumo|(noise of a) storm (n)
rauro; rá (ráv-)|lion (n)
rav-|to roar (vb)
ravennë|she-lion; *lioness (n)
raxa|wain; *wagon (n)
raxëa|dangerous (adj)
raxë|*danger (n)
recca|spittle; *saliva (n)
rehta-|to rescue; to save (vb)
rehtië|rescue; saving (n)
rehto|savior (n)
relyávalda|fig-tree (n)
relyávë|fig (n)
rem-|to snare (vb)
remba-|to entrap; to net (vb)
rembina|entangled; meshed; netted; woven (adj)
rembë|hunter’s or fisher’s net; mesh; net (for catching) (n)
remma|snare (n)
rempamba(lë)|basketball (n)
rempa|hooked (adj)
ren-|to remember (vb)
renda|of the same kin or clan; related (adj)
rendolë|cousinship (n)
rendo|male cousin; *relative (n)
rendë|clan; kin; kindred; kinship (n)
renta-|to remind (vb)
rer-|to sow (vb)
rerestë|diaspora; scattering (n)
rerindo|sower (n)
res- [þ]|to remain in same place (vb)
ressë|female cousin; *relative (n)
restandië|furlong (n)
restassë|countryside; the country (n)
resta|acre; sown field; tilled ground; ‘sown’; *fair (n)
restë; voronwië|endurance (n)
ret-|to climb (vb)
retto|*climber (n)
ric- (Motion and Transportation)|to twist (vb)
ric- (Physical Acts and Materials)|to endeavour; to put forth effort; to strive (vb)
ricítë|diligent (adj)
rihta- (Physical Acts and Materials)|to give quick twist or move; to jerk; to twitch; to *wrench (vb)
rihta-|to strive (vb)
rihta|effort (n)
rillë|brilliance (n)
rilma|glittering light (n)
rilya|glittering (adj)
rimba|frequent; numerous (adj)
rimbë|crowd; great number (n)
rimpa|flying; rushing (adj)
rimpeccuvo|chipmunk (n)
rimperocco|zebra; (lit.) stripe-horse (n)
rimpina|striped (adj)
rimpion (rimpiond-)|gneiss; (lit.) stripe-rock (n)
rimpira (rimpiráv-)|tiger; (lit.) stripe-lion (n)
rimpë (rimpi-)|strip; stripe (n)
rinca|jerk; sudden move; twitch (n)
rincuma|charge; mission; task (n)
rincë (rinci-)|flourish; hook; quick stroke (n)
rinda|circular (adj)
ringa|chilly; cold (adj)
ringincë|coldish; cool (adj)
ringwë|cold pool or lake (in mountains) (n)
ringë (ringi-)|*chill (n)
rinqua|recurrent; returning; revolving (adj)
ripta-|to cut in strips; to flay; to mark in parallel lines; to stripe; to tear up (vb)
rista-|to cut (vb)
rista|cut (n)
rië; ríë|crown (n)
riël(lë)|garlanded maiden; maiden crowned with a festive garland (n)
riëndë|garland (n)
rië|only (adv)
ro-|east; sunrise; uprising (pref)
roccotsë|cavalry (n)
rocco|(swift) horse (n)
roccë|mare (n)
rocollë|colt (n)
rohtalië|*those who trespass; (lit.) trespass-people (n)
roimë|hunt (n)
roina|ruddy (adj)
roita-|to pursue; to *chase (vb)
romba|horn; trumpet (n)
romya|loud (adj)
ron(go)|soon (adv)
ronda|firm; solid (adj)
rondo (Physical Acts and Materials)|staff (of hardwood) (n)
rondo (Physical World)|cave; cavern; roof; vaulted hall; vaulted or arched roof (n)
rondova|cavernous (adj)
ronga-|to hasten; to hurry (vb)
ronwa|block; solid piece (n)
ronyo|hound of chase; ‘chaser’; *hunting dog (n)
roquen|horseman; knight; rider (n)
rossë|(fine) rain; dew; shower; *spray (n)
rostaurë|rainforest (n)
rot-|to delve; to dig; to excavate (vb)
rotsenca|vest; waistcoat (n)
rotsë|pipe; tube (n)
rotta-|to bore (a hole or tunnel) (vb)
rotto|cave; small grot; tunnel (n)
rua|steady; still; tranquil (adj)
ruc-|to feel fear or horror; *to flee (to) (vb)
ruhta-; sosta- [þ-]|to terrify (vb)
ruical(a)|firelight (n)
ruihandë|blazing intellect; genius (n)
ruimenya|by the fire; fireside (adj)
ruimen|fireplace; hearth (n)
ruina|blazing; fiery (adj)
ruinë|blaze; fire (n)
ruivë|wild fire (n)
rum-|to heave (of large and heavy things); to shift (vb)
runando|*redeemer (n)
runda (adj)|polished; *polite (adj)
runda (n)|rough piece of wood (n)
rundië|politeness; smoothness (n)
runya (adj)|fiery red (adj)
runya (n)|footprint; slot (n)
runyaril (runyarill-)|garnet; (lit.) fiery red radiance (n)
rusca; ruxa|wroth (adj)
rusca|red-brown (adj)
rusco (ruscu-)|fox (n)
ruscuitë|foxy (adj)
russa|red-haired (adj)
russë|head or pelt of red hair (n)
ruv-|to burst; to rupture (vb)
ruxa-|to crumble (vb)
ruxöalë|Great Bear-dance (n)
ruë|stillness; tranquility; *steadiness (n)
rácina|broken (adj)
rácumbar|aconitum; wolfsbane; (lit.) wolf-doom (n)
rámaitë (rámaiti-)|having wings; winged (adj)
rámalócë|winged dragon (n)
ráma|wing (n)
ránasta|lunar month (n)
ránen|errant (adj)
ránë|straying; wandering (n)
ráquen|ambassador; representative (n)
ráta-|to surpass (vb)
ráva (adj)|lawless; uncontrolled; unfettered (adj)
ráva (n)|bank (especially of a river) (n)
rávëa|roaring (adj)
rávë|roaring noise (n)
ráya-|dedicate; to devote; (lit.) to make something be on somebody’s behalf (n)
réna|border; edge; margin (n)
rénë|memory (n)
ré|day (period from sunset to sunset) (n)
rëa-|to make network or lace (vb)
rëa|single (adj)
rëo|smile (n)
ría|garland; wreath (n)
ríma (Agriculture and Vegetation)|furrow; line of seeds planted; row; series (n)
ríma (Clothing and Adornment)|fillet; hairnet; snood; *headband (n)
rína (adj suf)|scattered (adj suf)
rína (adj)|crowned; garlanded (adj)
rínata-|to coronate; to crown (vb)
rísima [þ]|scattered; ubiquitous (adj)
rísimandë [þ]|at random; here and there; passim [Latin]; *scatteredly (adv)
rí|grass-stem; reed (n)
róma|horn; loud sound; trumpet-sound; *blare (n)
rómen|east; uprising (n)
róminya|*eastern (adj)
rómë|east (n)
róna|east (adj)
ró|the[?] [?next] (adv)
rúcima|terrible (adj)
rúcina|confused; disordered; ruined; shattered (adj)
rúcinon (rúcinond-)|breccia; (lit.) ruined stone (n)
rúna-; sen-|to free (vb)
rúnya|red flame (n)
rúsë [þ]|wrath (n)
rúsëa [þ]|wrathful (adj)
rúvina|burst; ruptured (adj)
sa-rincë (sa-rinci-)|hooked stroke in tengwa; s-hook (n)
sa; ta; tai|them (inanimate) (pron)
sa; ta|that (pron)
sac- [þ]|to close (vb)
sac-|to hurt (vb)
sahta- [þ] (Physical Acts and Materials)|to split (vb)
sahta- [þ] (Social Relations)|to induce (vb)
sahtië [þ]|pressure or force (to do something against one’s will or conscience) (n)
saicelëa|famished (adj)
saicelë|famine (n)
saila|wise (adj)
sailiëndil|philosopher (n)
saipo|boot (n)
sairina|magic; *magical (adj)
sairon|wizard (n)
saita-|to teach; to *train; (lit.) to make wise (vb)
saitalë|education (n)
saitya-|to starve (vb)
salca-|mow down; to mow (n)
salca; salca-|scythe (n)
salcessë|harvest [product]; *produce (n)
salcima|ready for cutting; *harvestable (adj)
salpa-|to lick up; to sample; to sip; to sup; to take a sup of (vb)
salpa|broth (n)
salpë|sip (n)
salquecolca|manger; (lit.) grass-box (n)
salquecápo|grasshopper (n)
salquenor|grassland; meadow (n)
salquë|grass (n)
sam-|to have (vb)
sama-|to bar; to exclude (vb)
sambesta [þ]|apartment; flat (n)
sambë [þ]|chamber; room (n)
samin (samind-)|silk (n)
saminda|silken (adj)
samna [þ]|wooden post (n)
samno [þ]|builder; carpenter; wright (n)
sampan-|to combine (vb)
sampanë|combination (n)
sampa|spade; *shovel (n)
sampo|vault; *cellar (n)
san (sam-) [þ]|bar; barrier (n)
sana-|to reflect; *to think (vb)
sanar|mind; reflector; thinker (n)
sanasta|pondering; reflection; thinking (n)
sanastëa|aware of; cognizant; conscious of; mindful (adj)
sana|that; that very thing (already referred to) (adj)
sanca [þ]|cleft; split (adj)
sancon (sancond-) [þ]|schist; (lit.) split-rock (n)
sanda [þ]; turma|shield (n)
sanda [þ]|abiding; firm (adj)
sandanasto [þ]|turtle; (lit.) shield-being (n)
sandastan (sandastam-) [þ]|shield-barrier (n)
sanga [þ] (n adj)|crowd; crowded; pack; packed; press; throng (n adj)
sanga [þ] (n)|crowd; crowded; pack; packed; press; pressure; throng; tight mass (n)
sanga- [þ]|to compress; to pack tight; to press (vb)
sangarëa|oppressive; tyrannical (adj)
sangarë|oppression (n)
sangië|necessity; *pressing need or concern (n)
sanguma [þ]|press; *thing that presses (n)
sanomë; tassë; tás|there (adv)
santa- [þ]|to decide (vb)
santenta-|to concentrate; to focus (the mind) (vb)
sanwecenda|thought-inspection; thought-reading (n)
sanwelunga|serious; (lit.) thought-heavy (adj)
sanwelungië|seriousness (n)
sanwementa|mental message; thought-sending (n)
sanwë-latya|thought-opening (n)
sanwë|an act of thinking; thought (n)
sanya [þ]|law-abiding; normal; regular (adj)
sanyelórië [þ]|lawlessness (n)
sanyengolmo [þ]|lawyer (n)
sanyesta [þ-]|law [as a scholarly discipline] (n)
sanyë [þ]|law; rule (n)
san|so; thus; *then (conj adv)
sap-|to dig (vb)
sappa|dug-out; excavated (adj)
sapsarra-|to fray away; to keep on rubbing (vb)
sapsarrima|boring; tedious (adj)
sapta-|to convince; (lit.) to make believe (vb)
sapta|(delved) hole; grave; pit (n)
sar (sard-); sar (sarn-)|stone (small) (n)
sar-|to mark (i.e. by incision); to notch; to score; to (by later extension) †to write [on] (vb)
sara [þ]|bent [as a type of grass]; stiff dry grass (n)
sara- [þ]|to saw [wood] (vb)
saramor (saramór-)|*writing-ink (n)
sarassë [þ]|footstool; hassock (n)
sarat|letter (of the Rúmilian alphabet) (n)
sardanar (sardanár-)|corundum; (lit.) hard sun (n)
sarda|hard (*as stone) (adj)
sarma [þ]|saw (n)
sarmë; tengwa; tengwë|writing (n)
sarna|of stone (adj)
sarnincë|pebble (n)
sarnië|pebble bank; shingle (n)
sarnomo|banker (n)
sarnunta [þ]|diadem (n)
sarnë|stony place (n)
sarta|loyal; steadfast; trusty (adj)
sarto; satar|loyal companion; trusty follower (n)
sartë (sarti-)|jot; note; scribbling; (lit.) a little writing (n)
sarya-|to stone (vb)
sat-|to appropriate to a special purpose or owner; to set aside (vb)
satarya-|to rely on (a person); to trust (vb)
satta|part (of something) (n)
satya|excluded; not common; private; separate (adj)
sau-|very badly (pref)
saucarya|evil-doing (adj)
saucarë|doing or making a thing very badly (n)
saulengaitë|ill-mannered (adj)
sauluppo (sauluppu-)|cancer (disease) (n)
saura [þ]|evil; evil-smelling; foul; putrid; stinking; vile (adj)
sauricumba [þ]|*foul-bellied (adj)
sauroryat [þ]|skunk; (lit.) stink-badger (n)
sauta- [þ-]|to stink (vb)
sav-|to believe (vb)
savindo|believer (n)
saviëlóra|belief-less; unbelieving (adj)
sa|it (inanimate); that (pron conj)
sel- [þ]|to intend; to mean; to plan (vb)
seldo|child [m.]; *boy (n)
seldë|child [f.]; daughter; *girl (n)
selma [þ]|fixed idea; will (n)
selmandur|fanatic; (lit.) servant of a fixed idea (n)
selyë|daughter (diminutive) (n)
sen-|to let go; to let loose (vb)
sen; të|them (pron)
senda [þ]|bracket; confines; (lit.) that what cramps (n)
sendarë|day of rest; sabbath (n)
sendassë|guest-house; inn (n)
senda|at peace; resting (adj)
senna [þ]|short (adj)
sennacénëa [þ]|short-sighted (adj)
senta- [þ]|to shorten (vb)
sentimeter|centimeter (n)
senwa [þ]|instant; moment (n)
senya (adj)|typical; usual; *common (adj)
senya (n)|*my child (n)
senyavë|usually (adv)
ser- [þ]|*to sew (vb)
ser-|to at the moment; to be for a while; to repose; to rest; to stay; to stop; to tarry (vb)
serca-|to bleed (vb)
sercilixa|blood-thirsty (adj)
serciril (sercirill-)|ruby; (lit.) blood-glitter (n)
sercë (serci-)|blood (n)
serindë [þ]|broideress; needlewoman; *seamstress (n)
serma [þ]|string (n)
seru-|to come to rest on; to settle on; to sit or lie down (vb)
seruinon (seruinond-)|sedimentary rock; (lit.) settled-rock (n)
sesta-|to set; (lit.) to make rest (on) (vb)
si; sissë; símanë; símen; sís|here (adv)
sicil|dagger (n)
sil-|to shine (white) (vb)
silima|crystal substance devised by Fëanor (n)
sillë|like this (adv)
silma (adj)|shining white; silver (adj)
silma (n adj)|crystal (white); shining white; silver (n adj)
silmë nuquerna|s-reversed (n)
silmë|light of Silpion; silver [light]; starlight; †silver (n)
silo; sio|hence (adv)
silomë|tonight (n adv)
silta-|to sift; to sort out; to winnow (vb)
silta|sieve (n)
siltina|winnowed (adj)
silumë; sin; sí; sír|now (adv)
silumë|at this time; *present (adv)
silussë|present tense; (lit.) here-and-now-tense (n)
silúmëa|contemporary; current; modern (adj)
simen; sir(a)|hither (adv)
simpa [þ]|flageolet; flute; pipe (n)
simpetar [þ]|piper; *fluter (n)
simpisë [þ]|piping; whistling (n)
sinanwa|existing or occurring now; in a particular place; present (adj)
sinanwië|presence (n)
sinan|at present (adv)
sinapio|mustard (n)
sinar|this morning; today (n)
sina|this (adj)
sincahonda|flint-hearted (adj)
sinca|flint; *flinty (n adj)
sincë (sinci-)|mineral [as in any solid inorganic substance] (n)
sindië [þ]|greyness (n)
sindë (sindi-) [þ]|pale or silvery grey (adj)
sinen|by this means; so (adv)
singwa|salt; *salty (adj)
singë (singi-)|salt (n)
sinilë|topaz (n)
sinomë|here; (lit.) in this place (adv)
sinta- [þ]|to *(lit.) become grey (vb)
sintamo; tamo|smith (n)
sintë (sinti-)|computation; esteem; estimate (n)
sinwa|ascertained; certain; known (adj)
sinyarna|novel (n)
sinyar|news (n)
sinya|new; *current (adj)
sinyemat [þ]|dinner; evening meal (n)
sinyë [þ]|evening (n)
sin|*thus (adv)
sip- [þ]|to pipe (vb)
siqu-|to sigh (vb)
siquilissë|weeping willow (n)
siquilë|sighing (n)
sir-; ulya-|to flow (vb)
sirpë [þ]|slender tube; stalk (n)
sirya-|to flow [smoothly] (vb)
sirëa|flowing; liquid (adj)
sis- [þiþ-]|to fry; to scorch; to singe (vb)
sisin [þ-]|parched; scorched (adj)
sistina|sore; ulcerated (adj)
sistë (sisti-)|boil; sore; ulcer (n)
sisíla-|to shine (frequentative) (vb)
sitina|accustomed; common; customary; ordinary; usual (adj)
sito (situ-)|custom (n)
sitta-|to I am used to; to I do habitually (vb)
situ-|to be accustomed [to] (vb)
sitwa [þ]|fryer; pan (n)
siulë|incitement (n)
si|this (adj pron)
sië|thus (adv)
sohta-|to drench; to give to drink (vb)
soicië|thirst (n)
solma|[main or entry] hall; chamber (n)
solor|surf; surge (n)
solta-|to surge (up and down); to wave (vb)
songa|mouth (interior cavity behind the teeth containing the tongue) (n)
sono [þ]|pine (n)
sononel (sononelm-) [þ]|pine-needle (n)
sor-|to equip; to furnish; to provide (vb)
sorastarwa|equipped; furnished (adj)
sorasta|equipment (n)
sorna [þ]; tulca|steadfast (adj)
sornion [þ]|eyrie (n)
sorno [þ]; soron (sorn-) [þ]|eagle (n)
soroncë [þ]|kite; (lit.) little eagle (n)
sortöa [þ]|aloe; (lit.) eaglewood (n)
sorya- [þ-]|to feel fear (vb)
sossë [þ-]; umbë|fear (n)
sossëa [þ-]|afraid; fearful (adj)
sosta- [þ-]|to put to fright (vb)
sov-|to wash; to *bathe (vb)
sovalda-|to cleanse; to purify (vb)
sovallë|bathing; purification; washing (n)
sovalwa|cleansing; *purifying (adj)
sovamorco|raccoon; (lit.) wash-bear (n)
suc-|to drink [rapidly]; to quaff; to *gulp (vb)
sucul [þ]|slime; sticky matter (n)
suhta-|to drain (vb)
suhtina|resinous (adj)
suhto|draught; *a single act of drinking (n)
suhtë (suhti-)|gum; resin (n)
suila-|to greet (vb)
suilanta-|to give greeting (vb)
suilië|greeting (n)
suiva|moaning [of wind]; soughing (adj)
sulca|root (especially as edible) (n)
sulpa-|to drink greedily; to lap up (vb)
sulpa|soup (n)
sumba-|to submerge (vb)
sumbanwa|sink (for washing) (n)
sunca (s) [þ]|cone (of a tree, as in pine cone) (n)
sundo [þ]|base; root; root-word (n)
sundoharmar|capital [funds]; (lit.) base treasures (n)
sundon (sundond-)|bedrock; (lit.) base-rock (n)
sundóma [þ]|determinant vowel; root-vowel; vocalic determinant (n)
sur- [þ]|*to seek (vb)
surië [þ]|*(an act of) seeking (n)
surya- [þ]|to blow (intr.) (vb)
surya-|to hiss (vb)
surya|spirant consonant (n)
sussë [þ-]|puff (of air) (n)
susta- [þ]|to blow (tr.) (vb)
suv-|to sink (esp. in water) (vb)
sá [þ]|I agree of course; I will; all right; of course I do; very good (interj adv)
sála|bile; gall (n)
sámo [þ]|helper (n)
sámë [þ]|help; salvation; saving (n)
sányelóra [þ]|lawless (adj)
sáquet- [þ] (Language and Music)|(lit.) to say ‘yes’ (vb)
sáquet- [þ]|to I will; to agree (to do); to say ‘yes’ (vb)
sáquetië|agreement (n)
sár (sar-)|(generalized) score (of game or contest); (incised) mark; notch; tally (n)
sáralë|bitterness (n)
sára|bitter (adj)
sáro [þ]|saviour (n)
sáva|juice (n)
sávula|credulous; gullible (adj)
sávë [þ]|foul odor; reek; stench; stink (n)
sérenca|uneasy; unpeaceful (adj)
sérinqua|full of peace; peaceful (adj)
sérë|peace; repose; rest (n)
së (prep)|at; in (prep)
së (pron)|he; it (animate); she (pron)
sír(ë) (síri-); sírë (síri-)|river (n)
síra|this day; *today (n)
sítë|of this sort (adj)
sívë|knowing (n)
sóla|tide (n)
sónanwa|water basin (n)
sótë|refuge (n)
söa|filth (n)
súcë [þ]|pine or fir; resinous tree (n)
súlendil|kite; (lit.) friend of the wind (n)
súlo (*súlu-)|goblet (n)
súlë (súli-) [þ]|spirit (n)
súlë [þ]|(movement of) spirit; breath; emission of power (of will or desire) (n)
súma|bosom; hollow cavity (n)
súna- [þ]|to be spiritually affected; to inspired (vb)
súnalë [þ]|inspiration (n)
súnë|bath; small pool (n)
súriquessë|species of grass; (lit.) wind feather (n)
súriëllë|anemone; windflower (n)
súrë (súri-)|breeze; wind (n)
súsa [súþa]|bath water; hot water (n)
súya- [þ]|to breathe (vb)
súyel|niece (n)
súyon|nephew (n)
sú|noise of wind; sound of wind (n)
ta (adv conj)|also; and also; etcetera; like that; so; then (adv conj)
ta (pron, Grammar)|it; there (pron)
tac-|to fasten; to fix (vb)
tailë|extension; lengthening (n)
taima; taina|extension (n)
taina|elongated; extended; lengthened; prolonged; stretched (adj)
taita-|to prolong; to *lengthen (vb)
taitë|of that sort (adj)
tal(da)|to the bottom (adv)
talaitë (talaiti-)|footed (adj)
talan (talam-)|flat space; floor; ground; platform (n)
talatya-|to refute; (lit.) to make (it) collapse (vb)
talat|sheet (n)
talca|mark (n)
taldëa|bottom (adj)
talhotsë|infantry; (lit.) foot-troop (n)
tallimë (tallimi-)|ankle; (lit.) foot-link (n)
tallunë|sole of foot (n)
tallë|like that (adv)
talma (Mind and Thought)|base; basis; foundation (n)
talma (Spatial Relations)|base; foundation; root (n)
talmacasta|head over foot; upside down; *topsy-turvy (adj)
talmata-|to base (on); to found (vb)
talmondo|foundation stone (n)
talo; tó|thence (adv)
talquen|foot-soldier; (lit.) foot-person (n)
talta (adj, Motion and Transportation)|leaning; shaky; slanting; sloping; tilted; tottering; unsteady; wobbling (adj)
talta (adj, Spatial Relations)|leaning; sloping; tilted (adj)
talta (n)|incline (n)
talta-|to collapse; to fall; to slide down; to slip (down); to slope (vb)
taltil (taltill-)|*(lit.) foot-tip (n)
taltol|big toe (n)
taltë|at the bottom; down (adv)
talumë|at that time (adv)
tal|downwards (adv)
tam-; ton-|to tap (vb)
taman|thing made by handicraft (n)
tama|that matter (pron)
tamba-|to keep on knocking; to knock (vb)
tambaro|woodpecker; (lit.) knocker (n)
tambin (tambind-)|cauldron (n)
tambina|of bronze (adj)
tambë (tambi-) (Food and Drink)|pot (n)
tambë (tambi-) (Physical Acts and Materials)|bronze (n)
tambë|so (prep)
tamen; tanna; tar(a)|thither (adv)
tamin|forge (n)
tamma|tool (n)
tamna|artifact; artificial (adj n)
tamo|artificer; builder; wright (n)
tampa|stopper (n)
tampo|well (n)
tamuril|yew (n)
tana (adj pron)|that (adj pron)
tana (pron)|that (anaphoric) (pron)
tana-|to indicate; to show (vb)
tanar|[linguistics] demonstrative; indicator (n)
tanastë|presentation (n)
tanca (adj)|firm; fixed; sure (adj)
tanca (n)|fastening; rivet (n)
tancal(a)|brooch (n)
tancarya-|*to become firm (vb)
tancata-|to confirm; to fix; to make firm; to make fixed or firm (vb)
tancavë|certainly (adv)
tanen|in that way (adv)
tanga-; tinga-|to twang (vb)
tango; tingë|twang (n)
tangwa|clasp; hasp; *fastener (n)
taniquelassë|*high-white-leaf (n)
tanna|sign; token (n)
tanomë|there; (lit.) in the place (referred to) (adv)
tanta-|to bounce; to bound; to rebound (vb)
tantal|shuttle (n)
tantara|bouncing; resilient (adj)
tanwë|construction; craft; device; thing made (n)
tap-|to block; to stop (vb)
tapta|impeded (adj)
tar (adv)|beyond (adv)
tar (n)|honorific; madam; sir (n)
tar-; termar-|to stand (vb)
tar-|high; king or queen (in compounds) (affix)
taranna|county; shire (n)
tararan|emperor; (lit.) high-king (n)
taras; tarminas|great towering building (fort/city/castle) (n)
tarasta-|to harass; to trouble (vb)
tarastar|highlands (n)
tarastië|trouble (n)
tarca|horn [of animals] (n)
tarci-|to trouble (vb)
tarhanwa|(lit.) high seat (n)
tarma|pillar (n)
tarmenya|vertical (adj)
tarmen|vertical direction (n)
tarmon (tarmond-)|basalt; (lit.) pillar-rock (n)
tarmë|condition; state; status (n)
tarolwen|sceptre; (lit.) royal branch (n)
tarqua-|to pickle; to preserve (vb)
tarquin(a)|dried; salt meat; salted; *(orig.) preserved (n adj)
tarwandur|gardener (n)
tarwa|garden (n)
tarwesta-|to crucify (vb)
tarwë|cross; crucifix (n)
taryalangova; taryalangwa|obstinate; stiff-necked (adj)
taryassë|difficulty; stiffness; toughness (n)
tarya|stiff; tough (adj)
tasar(e) [þ]|willow-tree (n)
tasar(ë) (tasari-) [þ]|willow (n)
tastë|fringe (n)
tatya-|to double; to repeat (vb)
tauca|stiff; wooden (adj)
taucolca|(wooden) chest (n)
taura|(very) mighty; masterful; of unmeasured might or size; vast (adj)
taurëa|forested (adj)
taurë|(great) wood; forest (n)
tautamo|[wood] carver; carpenter (n)
tav-|*to endure (vb)
tavaril|dryad; spirit of woods (f.) (n)
tavaron|dryad; spirit of woods (m.) (n)
tavas (tavast-)|woodland (n)
taxë|nail (n)
tec-|to write (vb)
teccelma|parchment; scroll; (lit.) writing-skin (n)
tecco|accent [´]; stroke (of pen or brush) (n)
tecemma|drawing; drawn image; painting (n)
tecil|pen (n)
tecindo|writer (n)
tehtalë|art of writing; documents; papers; script; scriptures; writings (n)
tehta|(written) mark; diacritic; mark (in writing); sign; symbol; †written letter (n)
tel (teld-)|end (n)
tel-|to end; to finish (intr.) (vb)
telco (?telcu-)|leg; stem (n)
telcohan (telcohamp-)|pants; trousers; (lit.) leg-clothing (n)
telconta-|to stride; to *(lit.) to leg it (vb)
teldavë|finally (adv)
telda|final; last (adj)
telemna|*of silver (adj)
telepta|silver; *silver-coloured (adj)
telima|final (adj)
tella|hindmost; last (adj)
telluma|cupola; dome; vault (n)
tellë|rear (n)
tellúmë|deadline; (lit.) finish-time (n)
telma|anything used to finish off a work or affair; conclusion; ending (n)
telmëa|conclusive (adj)
telmë|covering; hood (n)
telperin|like silver (in hue or worth) (adj)
telpetan|silversmith (n)
telpevistando|money-changer (n)
telpilin|silver piece; *silver coin (n)
telpina|like silver (in hue or worth); of silver (adj)
telpingwë|silverfish (n)
telpë (telep-)|money; silver (n)
telpë; tyelpë (tyelep-)|silver (n)
telta-|to canopy; to overshadow; to screen (vb)
telumbë|mushroom (n)
telumet (telumett-)|canopy (n)
telumë|canopy; dome (of heaven); firmament; roof; vault (n)
telusta|extreme; outer; ultimate (adj)
telustë|extremity (n)
telu|last (adj)
telwa|late (adj)
telya-|to conclude (trans.); to finish; to wind up (vb)
telyanta-|to allure; to *attract (vb)
telyantalya|alluring; attractive (adj)
telyantassë|allurement; attraction (n)
tenca|letter (epistola) (n)
tencelë; tengwacilmë|spelling (n)
tencelë|writing (system) (n)
tengessë|address; (lit.) indication-name (n)
tengwa-|to read written matter (vb)
tengwalóra|unlettered (adj)
tengwassë|alphabet (n)
tengwa|(written) letter; grammar; indicator; sign; token (n)
tengwelanga-|to transcribe (vb)
tengwelanga|transcription (n)
tengwelë|language (general term) (n)
tengwesta|collection of matter concerning writing; collection of writing; grammar; morphology; system or code of signs; *language structure (n)
tengwestië|language [as a concept] (n)
tengwië|language (*signing) (n)
tengwë|indication; sign; token (n)
tenna (n, Language and Music)|a letter (n)
tenna (n, Mind and Thought)|notion; thought (n)
tenna (prep)|as far as; to reach; to the point; until; up to (prep)
tennoio|forever[more] (adv)
tensi|already; up to now/here; yet [from present] (adv)
tenta-; tëa-|to indicate (vb)
tenta-|to be directed toward; to direct toward; to go forth towards (with object); to point (to/out) (vb)
tentaparma|instruction book; recipe book (n)
tenta|yet [past]; *up until then (adv)
ten|for (conj)
ter-|to pierce (vb)
ter; terë|through (prep)
tercara|comprehensive; elaborate; thorough (adj)
tercenya|of insight; *perceptive (adj)
tercen|insight; *(lit.) through-sight (n)
tercáno|herald (n)
terendel|lathe (n)
teren|lissom; lithe (adj)
teret (tereht-)|auger; borer; gimlet (n)
tereva|acute (pain); fine; piercing; sharp; shrill [of sound]; *keen (adj)
terhat-|to break apart (vb)
termar-|to last; to *endure; (lit.) to through-abide (vb)
terra|fine pierced hole (n)
tervanta-|to traverse (vb)
tesar|brick; tile (n)
tev-|to dislike; to hate (vb)
tevinqua|hateful (adj)
tevin|hated (adj)
tevië|dislike; hatred (n)
thë|it (pron)
ticuta-|to (orig.) make melt; to smelt (vb)
tihta-|to blink; to peer (vb)
tihtë|glimpse (n)
tildë|(mountain) horn; fine sharp point; tip (n)
tillë|[within compounds] finger; eyelash; point; tip (n)
tilma|point (n)
timbarë|forehead (n)
tin-|to gleam; to glint; to shine as a star; to spark (vb)
tincoina|metallic (adj)
tincotéma|t-series (n)
tinco|metal (n)
tinda|glinting (silver) (adj)
tindë|glint (n)
tindómë|(starry) twilight; starlit dusk; time near dawn (n)
tingilindë; tingilya|twinkling star (n)
tinta-|to cause to spark; to kindle; to make to spark (vb)
tintila-|to give tremulous light; to twinkle; *to sparkle; to †tremble (vb)
tintilië|sparkling; twinkling (n)
tinwerúmë|starling; (lit.) abundance of stars (n)
tinwë|[apparent] star; spark (star) (n)
tinwírë|diamond; (lit.) sparkling gem (n)
tiqu-|to melt; to thaw (vb)
tiquilindëa|slushy; thawing (adj)
tiquilin|melting snow; slush; thaw (n)
tiquilë|melting; thaw; thawing (n)
tir-|to gaze; to guard; to heed; to look (at); to observe; to watch (over) (vb)
tirila|watching (something) (adj)
tirion|(great or mighty) tower; watch-tower (n)
tiris (tiriss-)|vigil; ward; watch (n)
tirista|guard; *watch (n)
tirma|spyglass (n)
tirmen|theater (n)
tirmo|watcher (n)
tirmë|stare; steadfast regard; *gaze (n)
tirítë (tiríti-)|vigilant; watchful (adj)
tis; titsë (tits-)|kitten (n)
titinwë|small star; sparkle of dew; *small sparkling thing (n)
titta|tiny (adj)
tittë|breast [of a woman] (n)
tiucata-|to fatten; to feed up (vb)
tiuca|fat; thick (adj)
tiura|compact (adj)
tiuta-|to comfort; to confirm; to console; to corroborate; to *(orig.) to make firm (vb)
tiutaila|comforting; consoling; easing (adj)
tiutalë|comfort; confirmation; consolation; easement (n)
tiuya-|to grow fat; to swell (vb)
tixipi|ladybug; (lit.) insect of [many] dots (n)
tixë|dot; point; tiny mark (n)
tiër; tér|*so (prep)
tië|direction; line; path; road; route; way (n)
to(lo)sta; tolsat|one eighth (fraction)
toc-|to appraise; to assay; to assess; to tax (vb)
tocot|cock; *rooster (n)
toina|made of wood; wood; *wooden (adj)
tol (toll-); tollë|(steep) isle; island (n)
tolbo|big toe; stub; stump (n)
toldo; tolto|eight (cardinal)
toldëa; toltëa|eighth (ordinal)
tolipincë|little doll (n)
toli|doll; puppet (n)
tollesta|archipelago (n)
tollo; tolyo|sticker-up (n)
tolloquen|islander (n)
tolma|(short rounded) handle; knob; protuberance contrived to serve a purpose (n)
tolmen (tolment-)|boss (of shield); isolated round hill (n)
tolpo|bowl (n)
tolquain|eighty (cardinal)
tolu-|to get up; to leave one’s seat; to stand up (vb)
tombo|gong (n)
tompa-|to bang; to *drum (vb)
tompa|(small) drum (n)
tompo-tompo|noise of drums (or guns) (n)
tomya-|to resonate (of shorter sounds) (vb)
ton-|to knock (vb)
tontilla|cymbal; *tambourine (n)
torna; urda|hard (adj)
tornanga|hard-iron; iron hard; *steel (adj n)
totonna-|to type (on computer/phone) (vb)
to|above; in; on (prep)
tuc-|to draw; to *pull (toward) (vb)
tucië|drawing; pulling (n)
tuia-|to spring; to sprout (vb)
tuilindo|swallow; (lit.) spring-singer (n)
tuilu-|to bud; to open (of flowers and leaves) (vb)
tuilérë|*spring-day (n)
tuilë|spring; spring-time (n)
tuima|bud; sprout (n)
tuista|shoot; twig (n)
tul-|to come (vb)
tulca-|to establish; to set up; to *found (vb)
tulca|firm; immovable; strong (adj)
tulco (*tulcu-)|prop; support (n)
tulla|rudder (n)
tullu-|to happen (i.e. come in time); to occur (vb)
tulma|event (n)
tulta-|to fetch; to send (from point of view of receiver); to send for; to send hither; (lit.) to cause to come (vb)
tultaima|summonable; *fetchable (adj)
tuluhta-|to prop (up); to support; to uphold (vb)
tulumaitië|probably (adv)
tulumaitë|likely to come; probable (of future events) (adj)
tulurya; évëa|future (adj)
tulurya|coming (adj)
tulussë|future tense; (lit.) coming tense (n)
tulusta|advent; arrival (n)
tulya-|to bring; *to lead (vb)
tulyaitë|able to bring (adj)
tulyando|leader (n)
tulyandë|fetching (n)
tumba-|to (orig.) to go or cause to go deep; to cast down (into depths); to endeepen; *to dive; to cast down (into a pit[?]) (vb)
tumba; tumna|lowlying (adj)
tumbalë|deep valley; depth (n)
tumbo (tumbu-)|dale; deep vale; deep valley (under or among hills, with high sides); valley (n)
tumna|low (adj)
tumpo (Agriculture and Vegetation)|barn; shed (n)
tumpo (Physical World)|hump; lump (n)
tumya-|to baptize; to dip (vb)
tumyando|baptizer (n)
tundo (tundu-)|hill; mound [isolated] (n)
tundo|firewood; fuel (n)
tunga|resonant (of strings); taut; tight (adj)
tungwemen|tax-office (n)
tungwemo|tax-collector (n)
tungwë|tax (n)
tunta-|to notice; to perceive (vb)
tuntaitë|bright; smart; witty; *perceptive (adj)
tunto|notice; perception; quickness of perception; regard; wit (n)
tuntë|sense (one of the five) (n)
tuorva|peach; (lit.) wool-apple (n)
tuo|muscle; sinew; vigour (n)
tup-|to cover; to put a lid on; to put hat on (vb)
tupattal|horse-boot (n)
tupina|covered (adj)
tupin|having a lid; having hat on; roofed (adj)
tupsë|thatch (n)
tur- (Social Relations)|to control; to govern; to wield (vb)
tur- (Warfare and Hunting)|to conquer; to control; to dominate; to govern; to master; to win; to *rule (vb)
turca|powerful (in body); strong (adj)
turco|*stronghold (n)
turindo|purposeful mind; strong will (n)
turindura|done necessarily (adj)
turmen|realm (n)
turmë|governing power; strength (n)
turo|master (n)
turu-|to defeat; to have victory over; to master (vb)
turut (turuc-)|tree-stem; *tree-trunk (n)
turutyalmë|competition; contest (n)
turwa|powerful [in a general sense] (adj)
turya-|to strengthen (vb)
turyandë|fortification (n)
turyanwa|fortified; *strengthened (adj)
turúna|mastered (adj)
tussa|bush (n)
tusturin (tusturind-)|match (n)
tusturë|chips; tinder (n)
tutulla-|to keep on coming (and going) (vb)
tuv-|to discover (vb)
tuxainen|thousand (cardinal)
tuxainenëa|thousandth (ordinal)
tuxantur|centurion (n)
tuxasta|one hundredth; *one percent (fraction)
tuxa|hundred (cardinal)
tu|them (dual) (pron)
tuë|fleece (n)
tyal-|to play (vb)
tyalangan (*tyalangand-)|harp-player (n)
tyalindo|player (n)
tyalië|game; mirth; play; sport (n)
tyallas (tyalass-)|(playing) card (n)
tyalma|plaything; toy (n)
tyalmë|game (n)
tyar-|to cause (vb)
tyaraitë (tyaraiti-)|effective; effectual; efficacious; productive (adj)
tyarda|result; *effect (n)
tyaro|actor; agent; doer (n)
tyarwë|reason (n)
tyas- [þ]|to choose; to pick; to test; to try [out] (vb)
tyasta-|to (put to the) test; to *verify (vb)
tyastaima|testable (adj)
tyatyamba-|*to keep on tasting (vb)
tyausta|flavour; savour (n)
tyav-|to (impersonal) to taste of; to reminds one of; to taste (vb)
tyavasta|sense of taste (n)
tyaz-|to like (vb)
tyelca|agile (adj)
tyellë|grade; step (in a stairway or ladder) (n)
tyelpetéma|palatal series (n)
tyenya|yours (familiar) (n)
tyet-|to nurse; to suckle (vb)
tyetsë|teat; *nipple (n)
tyocolat|chocolate (n)
tyos (tyoss-)|cough (n)
tyosta-|to cough (vb)
tyuc-|to chew (vb)
tyulma|mast (n)
tyulta-|to rear up; to stick up (vb)
tyulussë|poplar-tree (n)
tyur-|to curdle (blood, milk, etc.); to *congeal (vb)
tyurda|curdled (adj)
tyurmë|cheese (n)
tyustyuhta-|to chew the cud; to reflect; to reminisce (vb)
tyuxë|cud (n)
tyávelassë|spice; (lit.) taste-leaf (n)
tyávë|*taste (n)
tyéta-|to address somebody informally using tye (vb)
tyë|thee; you (familiar) (pron)
tál (tal-)|bottom; foot; lowest part (n)
táris(së)|queenship (n)
tári|queen (n)
tárië|height (n)
tárë|*that day (adv)
táva|great tree (n)
tá|then (adv)
téma|line; row; series (n)
térata-|to straighten (vb)
tératië|correction; (lit.) straightening (n)
téra|right; straight; *correct (adj)
tëalë|meaning (n)
tëangolmë|semantics (n)
tëa|road; straight line (n)
të|him; it (pron)
tírelëa|anxious (adj)
tírelë|anxiety; watchfulness (n)
tírima|able to be watched; observable (adj)
tópa-|to roof (vb)
tópa|roof (n)
tótal|sock; (lit.) wool-foot (n)
tó|wool (n)
töa (adj)|of wool; woollen (adj)
töa (n)|wood (as material) (n)
töallë|blanket (n)
töasta|grove (n)
túlima|able to be brought; bringable; worth bringing (adj)
túpelë|roofing; tiles (n)
túpo|cover; lid (n)
túra|great (adj)
túrion (túriond-)|palace (n)
túrëa|masterful; *having political power (adj)
túrë|mastery; might; power; strength; victory (n)
tútyalië|sport; (lit.) strength play (n)
túvima|discoverable (adj)
ufárëa|not enough (adj)
uhta-|to avoid as painful or nasty; to dislike; to feel disgust with (vb)
ui-|to not do (vb)
uilë|long trailing plant (n)
uito|it is not that (interj)
ui|it is n[ot]; no (interj)
ul-|to rain (vb)
ulcarindo|evil-doer (n)
ulca|bad; dark; evil; sinister; wicked; wrong (adj)
ulco (ulcu-)|evil (n)
ulculóra|without evil (adj)
ulma|flagon; *pitcher (n)
ulo (*ulu-)|rain (n)
ulquet-|to accuse (vb)
ulquetië|accusation (n)
ulquéto|accuser (n)
ululla-|to keep on pouring (vb)
ulumpembë|caterpillar; (lit.) camel worm (n)
ulumpë|camel (n)
ulunda|monstrous (adj)
ulundië|monstrosity (n)
ulundo|deformed and hideous creature; monster (n)
ulundë|flood; *downpour (n)
ulutelmë|rainshade; umbrella (n)
ulva|darkening; eclipse (n)
ulya-|to pour (vb)
uman|at one time (adv)
umbar (umbart-)|curse; doom; fate (n)
umbarwa|fateful (adj)
umba|swarm (n)
umberóma|alarm; siren; (lit.) threat-trumpeting (n)
umbo(n)|clump; lump; mass (n)
umbë|imminence; premonition; unwelcome expectation (n)
umpano|build[ing] (n)
un-/um-|intensive prefix with evil sense (pref)
unca-|to hollow out (vb)
undalasar (undalasarn-)|stalactite; (lit.) down-growing stone (n)
unda|beneath; lower (adj)
undo|less (adj pron)
undulav-|to *engulf; (lit.) to lick down (vb)
undumë|abyss (n)
undu|beneath; down; under (prep adv)
undómë|time near evening; twilight (n)
ungol|(monstrous) spider (n)
ungwalë|torture (n)
ungwë|spider’s web (n)
unqualë|agony; death agony (n)
unquë|cavity; hole; hollow (n)
unta-|to descend [below a surface]; to stoop; to *sink (vb)
untup-|to cover (over or up); (lit.) to cover down (vb)
unutixë|dot or point placed below the line of writing (n)
uo|together (adv)
uphto|pit (n)
ur(u)-|difficult; hard (pref)
ur(u)ma|charcoal; coal (n)
urcarnë; urucárima|hard to make / do (adj)
urco (urcu-)|bogey; orc (n)
urda|arduous; difficult (adj)
urna|oven (n)
urpalda|stove plate (n)
urra|bad (adj)
urruxa|enraged; furious; incensed; livid; (lit.) hot-wroth (adj)
ursa- [þ]|to rage (vb)
urta-|to burn (vb)
urucarin|made with difficulty (adj)
uruhanyaima|complicated; cryptic; enigmatic; hard to understand (adj)
uruhta-|to (cause to) smoke; to belch smoke (vb)
urulanya|wick; (lit.) fire-thread (n)
urulócë|fire-dragon; fire-drake; fire-serpent (n)
urus (urust-)|copper (n)
urustamitta|copper-piece (n)
urustan (urustam-)|copper-smith (n)
urusta|of copper (adj)
urwa|afire; on fire (adj)
urya- (Physical World)|to blaze (vb)
urya- (Sense Perception)|to be hot (vb)
us- [þ] (pref)|[wrong] with a bad sense; bad; improper; unsuitable; useless; wrong (pref)
us- [þ] (vb)|to escape; to get out (vb)
uscil(lë)|cigarette (n)
usquë|dusk; reek; twilight; *smoke (n)
ussar (ussard-)|sulphur; (lit.) fire-stone (n)
ustat-|to misappropriate; to supplant; to usurp (vb)
ustya-|to smoke (intr.) (vb)
uswë [þ]|escape; issue; outlet (n)
uv-|*to be going to (vb)
uvana|wicked (adj)
uvassë|future tense; (lit.) uva-ness (n)
uxarë|doing wrong; *misdeed (n)
vacco|coat; jacket (n)
vahai(y)a; vaháya|far away (adv)
vahta-|to soil; to stain (vb)
vai(y)a|envelope (n)
vailima|windy (adj)
vailë|[strong] wind; *gale (n)
vaimata-|to [en]robe; to get dressed; to put on clothing; to *clothe (vb)
vaima|robe; wrap (n)
vaina (Body Parts and Functions)|blonde; fair of hair (adj)
vaina (Clothing and Adornment)|clad (adj)
vainolë|quiver (n)
vainë|pod; sheath (n)
vaita-|to enfold; to wrap (vb)
vala-|to have [divine] power (vb)
valaina|of or belonging to the Valar (adj)
valassë|divinity (n)
valasta-|to deserve; (lit.) to be worthy (vb)
valatëa|proud (adj)
valatë|pride (n)
valca|ferocious; fierce (adj)
valda (adj)|dear; worth; worthy (adj)
valda (adj, Emotion)|excited; wild (adj)
valda (n adj)|dear; worth; worthy (n adj)
valda-|to be of significance; to matter; to moment; to worth; *to cost (vb)
valdima|essential; imperative (adj)
valdëa|important; of moment (adj)
valma|[divinely or righteously] powerful (adj)
valmë (Social Relations)|authority (n)
valmë|emotion; excitement (n)
valta-|to excite; to rouse; to stir up (vb)
valwistë|change of mind (n)
valya-|to be excited (moved) (vb)
valya|having (divine) authority or power; official; *authorized (adj)
vana|fair-haired (yellow to golden) (adj)
vanda|oath; pledge; solemn promise (n)
vanessë; vanië|beauty (n)
vanga|staff (n)
vangwë|storm; *gale (n)
vanima (adj)|beautiful; fair; *handsome (adj)
vanima (n)|beautiful one; fair one (n)
vanimelda|beautiful and beloved; elven-fair (adj)
vanita-|to beautify; to grow/become fair; to make fair/beautiful (vb)
vanta-|to trek; to walk; to *trudge (vb)
vanta|march; walk; *hike (n)
vanwalussë|past tense (n)
vanwa|departed; gone (for good); lost; no longer to be had; over; passed away; past; vanished (adj)
vanwiémar (vanwiëmard-)|museum; (lit.) hall of the past (n)
vanwië|past time; the past (n)
vanwë|loss (abstract/general) (n)
vanwírë|nostalgia; (lit.) past-longing (n)
vanya-|to depart; to go; to pass [away]; to *be lost (vb)
vanya|beautiful; fair (adj)
vanë (vani-)|fair; lovely (adj)
var- (Warfare and Hunting)|to give way; to surrender; to yield (vb)
var-|to err (vb)
varanda|sublime (adj)
varasta-|to loom; to tower up (vb)
vardarianna|fragrant evergreen tree (n)
varma|armor; armour (n)
varnassë|security (n)
varna|protected; safe; secure (adj)
varno|guard; protector (n)
varnë (varni-)|brown; dark brown; russet; swart (adj)
varta-|to betray (vb)
vartië|betrayal (n)
varto|betrayer (n)
varya-|to protect (vb)
varyalë|defense (n)
varyando|protector (n)
var|away to; *from (adv)
vasar [þ]|veil (n)
vasarya- [þ]|to veil (vb)
vata|beaten track; pathway (n)
vatta-|to trample (vb)
vaxë|stain (n)
va|(away) from; away; gone forth (prep)
vehtequentalë|biography (n)
vehtë|[a span of] life; habitat; haunt (n)
vel-|to boil; to bubble (vb)
velet|boil; tumor (n)
velu-|to unfurl; to unroll (vb)
veluntë|sail (n)
velupantië|revelation (n)
velva|boiling; bubbling (adj)
velvë|bubble (n)
velyávë|Cucurbitaceae; gourd; the gourd family (n)
vembë|worm (n)
vendelis (vendeliss-)|nun (n)
vendelë|maidenhood (n)
vendesta|convent (n)
vendë|maid; maiden (n)
venessë|virginity (n)
venta|chin (n)
venwa|lime (fruit) (n)
venya (adj)|fresh; yellow-green (adj)
venya (pron)|ours (inclusive) (pron)
venë|[eating] vessel; dish (n)
vequi|as if; as though (conj)
verca|wild (adj)
vercála|sudden; violent (adj)
verinu|married pair (collective-noun)
verin|married (adj)
veri|wife (n)
verië|boldness; *daring (n)
verrendo|brother in law; kinsman by marriage (n)
verressë|kinswoman by marriage; sister in law (n)
verulóra|widow; widowed (adj n)
veru|husband (n)
verya-|to dare (vb)
veryandë|adventure; undertaking (n)
veryanwë; vestalë|wedding (n)
verya|bold; *brave (adj)
vesquen|spouse (gender neutral) (n)
vesta- (Law and Judgment)|to contract; to make a compact; to swear (to do something) (vb)
vesta- (Mankind)|to wed; to *marry (vb)
vestalë|oath (n)
vestaracië|adultery; (lit.) marriage-breaking (n)
vesta|matrimony; state of marriage (n)
vetta-|to witness (vb)
vetto|witness (n)
vettëa|witnessing (adj)
vettë|(act of) witnessing (n)
veuma|server (n)
veuya-|to serve (vb)
veuyalë|service (n)
vi; vë|us (inclusive) (pron)
vil-|to fly (vb)
vilina|airy; breezy; light [weight?] (adj)
vilva; vilwa|fluttering to and fro (adj)
vilvarin (vilvarind-); vilwarin (wilwarind-)|butterfly (n)
vilvarindëa; vilwarindëa|like a butterfly (adj)
vilwis(të)|weather; (lit.) turn of air (n)
vilya|air (n)
vin(i)-|neo- (pref)
ving(a)|spray (n)
vingil (vingild-)|foam-maid; mermaid; nymph (n)
vingil (wingild-) (Religion and Beliefs)|nymph (n)
vingil (wingild-)|foam-maid; mermaid; *nymph (n)
vingë|crest; crest of wave; froth; scud; spindrift; spray; wave crest (n)
vinima|childish (adj)
vinimetta|end of youth; *reaching middle age (n)
vinimo; vinë (wini-)|baby; little-one (n)
vinquetta|neologism (n)
vinta-|to blow about; to scatter (vb)
vinyahan (vinyahán-)|younger brother (n)
vinyamo|youngster (n)
vinyanet (vinyanés-) [þ]|younger sister (n)
vinyanóna|new-born (adj)
vinyarë|*young adulthood (n)
vinya|new (adj)
vin|already; just; just now; only just (adv)
vircolca|basket; (lit.) woven-box (n)
virda|outcome; result (n)
virittë|gravel (n)
virya-|to alternate (vb)
virya|fresh (adj)
virítë|variable; various (adj)
vista-|to change (transitive) (vb)
vista|air as substance (n)
vistë|change (n)
vië; vëassë|vigour (n)
viëlóra|eunuch (n)
vië|manhood; teors; *penis (n)
volta|volt (n)
voltië|voltage (n)
vor(o)-|continual repetition (pref)
vor-|to endure; to survive (vb)
vorimyalë|monotony (n)
voronda|faithful; steadfast (in allegiance, in keeping oath or promise) (adj)
vorongandelë|continual repetition; (lit.) harping on one tune (n)
voronwa|enduring; long-lasting (adj)
voronwië|lasting quality (n)
voronwë|faith(fulness); loyalty; steadfastness (n)
vorosanya [þ]|*ever-law-abiding (adj)
vorotailë|procrastination; (lit.) ever-extension (n)
vorotaita-|to procrastinate; (lit.) to ever-prolong (vb)
voro|always; continually (adv)
vorta-|to make lasting; to preserve (vb)
vortalë|maintenance; preservation (n)
voruhta-|to shun; (lit.) to ever-avoid (vb)
voruva|age long (adj)
válë|divine power/authority (n)
ván|goose (n)
váquet-|to forbid; to prohibit; to refuse; to say ‘I will not or do not’; (lit.) to say no (vb)
váravalmë|scandal (n)
vára|dirty; soiled (adj)
váya-|to blow (vb)
váya|[stormy] sea (n)
vá|do not; shall not; will not (interj adv)
vélamë|similarity (n)
véla|having a likeness or similarity; *alike (adj)
vén|freshness; greenness (n)
vénëa|*virginal (adj)
vénë|girl; *virgin (n)
vératanna|signature; (lit.) personal token (n)
véra|own; personal; private (adj)
vérë|compact; oath; troth (n)
véta-|to compare; to liken (vb)
vétaima|comparable (adj)
vë; ó|with (prep)
vëa (Mind and Thought)|apparent; seeming (adj)
vëa (Time)|adult; vigorous (adj)
vëalta-|to resemble (vb)
vëaner|(adult) man (n)
vëasta|comparison (n)
vëo (Animals)|living creature; *living being (n)
vëo (Mankind)|man (n)
vë|after the manner [of]; as; like; similar (prep)
vílë|gentle breeze (n)
vínë|*childhood (n)
vírina|woven (adj)
vórima (Emotion)|continuous; enduring; faithful; repeated; *(lit.) able to endure (adj)
vórima (Time)|continuous; enduring; repeated (adj)
vórëa|continuant; continuous; enduring; lasting (adj n)
vórë|lasting (n)
xara-|to long for; to yearn (vb)
xiétë (xiéti-)|impermanent; passing (adj)
yac-|to offer; to sacrifice (vb)
yacië|[act of] sacrificing; offering (n)
yaimëa|wailing (adj)
yaimë|wailing (n)
yaita-|to mock; to scorn (vb)
yaiwë|mocking; scorn (n)
yaiya-|to cry grievously; to cry in pain; to wail (vb)
yal-|to *call (out to) (vb)
yallumë|at last (adv)
yallë|as; in the same way as; like (adv)
yalta|yoke (n)
yalúmëa; yárëa|olden (adj)
yalúmë|former times (n)
yana|that (the former) (pron)
yanca|sacrifice (n)
yanen|whereby (adv)
yangwa|altar (n)
yanna|whereto (adv)
yanta- (Quantity and Number)|to add to; to augment; to enlarge; to increase (vb)
yanta- (Spatial Relations)|to join (vb)
yanta; yanwë|bridge (n)
yantaina|joined (adj)
yanwë|isthmus; joining (n)
yarië|antiquity (n)
yarra-|to growl; to snarl (vb)
yarra|growl; snarl (n)
yassë|there [relative] (adv)
yatta|(narrow) neck; isthmus; *(lit.) joining (n)
yausta|crop (n)
yav-|to bear (fruit); to bring forth; to produce; to *yield (vb)
yavannamírë|Jewel of Yavanna (n)
yava|of which (adj)
yaxë|cow (n)
ya|relative pronoun; that (relative pronoun); which (pron)
yeldë|daughter (n)
yello|call; cry of triumph (n)
yelmë|loathing (n)
yelta-|to abhor; to loathe (vb)
yelwa|loathsome (adj)
yenya|last year (n)
yermë|sexual desire (for marriage and procreation) (n)
yerna|worn (adj)
yerya-|to get old; to wear (out) (vb)
yesta- (Emotion)|to desire (vb)
yesta- (Time)|to begin; to *start (vb)
yestanyatsë|prefixion (n)
yesta|beginning; *start (n)
yestië|beginning (n)
yo-|together (used in words describing the union of three or more things) (pref)
yol-|to smoulder (vb)
yola|neither; nor (adv)
yomencöa|synagogue; (lit.) meeting-house (n)
yomenië|gathering; meeting; *congress (n)
yonda; yonna|enclosed (adj)
yondo; yonyo|son (n)
yondë|any fairly extensive region with well-marked natural bounds (n)
yonwa|border; fence (n)
yonyo|(big) boy (n)
yonávë|camaraderie; company; *companionship (n)
yor-|to contain; to enclose; to set bounds to/about; *to include (vb)
yosanwë|(pl.) congruence (n)
yo|both ... and (conj)
yu-|both; twice (pref)
yuhta-|to employ; to use (vb)
yuhtaimalë|usefulness (n)
yuhtaina|used (adj)
yuitë|dual (adj)
yul-|to drink (vb)
yulda (adj)|drunk (adj)
yulda (n)|draught; drink; thing drunk (n)
yullas (yullass-)|tea (n)
yullumë|twice; two times (adv)
yulma|cup; drinking implement; drinking vessel (n)
yulmon|chalice (n)
yulmo|drinker (n)
yulmë|carousal; drinking (n)
yuluitë (yuluiti-)|drinking (as a habit); *aquatic (adj)
yulunefítë|amphibious; *(lit.) drinking-breathing (adj)
yungwa|appliance (n)
yunquenta; yunquentë|thirteen (cardinal)
yunquesta|*one twelfth (fraction)
yunquëa|twelfth (ordinal)
yunquë|twelve (cardinal)
yuquain tuxa|one hundred twenty (cardinal)
yuquain|twenty (cardinal)
yurasta|twenty four (cardinal)
yutya-|to lend; to loan (vb)
yácina|sacrificed (adj)
yána|huge; vast; wide (adj)
yárahan (yárahán-)|older brother (n)
yáranet (yáranés-) [þ]|older sister (n)
yáraquetta|archaic word; archaism (n)
yára|ancient; belonging to or descending from former times (adj)
yárë|former days (n)
yáva|*fruit (n)
yávelóra|fruitless (adj)
yávinqua|fruitful (adj)
yáviérë|*autumn-day (n)
yávië|autumn; harvest [time or act] (n)
yávë|fruit (n)
yáwë|cleft; gully; ravine (n)
yá|when (conj)
yénië|annals (n)
yén|Elvish long year (144 solar years); year (n)
yé|what a ...; what is more; lo! (interj)
yëa|what is more (interj)
yë|who (pron)
yó(m)|[together] with (prep)
yú-|both (pref)
yúla|ember; smouldering wood (n)
yúlima|drinkable (adj)
yúyal|twilight (n)
yúyo|both (adj)
yú|too; *also (adv)
Ëarenya|Sea-day; *Thursday (n)
Ëa|Cosmos; Creation; all that is; it is; let it be; the (Material) Universe; the World; †World (n)
Úrimë|August; *Hot-one (n)
á (interj)|Oh! (interj)
á (particle)|imperative particle (particle)
ála|do not (particle)
árë (ári-)|sunlight; warmth (especially of the sun); *noontide (n)
árë nuquerna|árë-reversed (n)
ásë [þ]|aid; benefit (n)
áva|don’t; negative imperative (particle)
áya|awe (n)
élicombë|collection of stars; galaxy (n)
élë|beam; star-ray; flashing of [?starry] light (n)
érë|existence; existing (n)
é|indeed (interj)
ëa-|to be; to be found extant in the real world; to exist; to have being (vb)
ëarel|starfish; (lit.) sea-star (n)
ëaren; ëaron|great sea (n)
ëarendur|(professional) mariner; *(lit.) servant of the sea (n)
ëarina|of the sea (adj)
ëarra (ëarráv-)|sea lion; seal (n)
ëarsil|pearl; (lit.) sea-sheen (n)
ëaruilë|seaweed (n)
ëar|(open) sea; great sea; water (n)
ëasta|being; existence (n)
ëo|person; somebody (unnamed) (pron)
ë|he; it; she (pron)
í-|a prefix for electronic things like e-book; e- (pref)
íquallumë|when; whenever (adv)
írima|desirable; lovely (adj)
írë|desire; longing (n)
ítacelmëa|electrical (n)
ítacelmë|electricity (n)
ítacelmítë|electronic (n)
íta|flash (n)
ócama-; órava-|*to have mercy (vb)
ócom-|to assemble; to gather (vb)
óla-|to dream (impersonal) (vb)
ólamaitë|consonantal (adj)
ólav-|to compromise (vb)
ólavië|compromise (n)
ólemë|elbow (n)
ólië|society; (lit.) together-people (n)
óma-tengwë; ómatehta|vowel-sign (n)
ómaitë|voiced [stop] (n)
óman (omand-)|vowel (n)
ómanda|vocalic (adj)
ómatailë|vowel lengthening; vowel-lengthening (n)
ómataima; ómataina|vocalic extension (n)
óma|resonance of the vocal chords; voice; vowel (n)
ómen|crossroads (n)
ómëa (adj)|voiced (adj)
ómëa (n adj)|voiced; vowel (n adj)
ópa|mouth (opening of which the lips are the edges) (n)
óricuva|traitor (n)
óricuvoitë|keeping one’s own counsel (not necessarily sinister); uncommunicative (adj)
óripanta|honest; open; sincere; (lit.) open-hearted (adj)
órë (Mind and Thought)|(pre)monition; caution; heart (inner mind); warning; *conscience (n)
órë (Motion and Transportation)|rising; *rise (n)
ósana-|to counsel; to think together (vb)
ósanwë|communication of thought; interchange of thought; (lit.) thinking together (dual) (n)
ósat-|to share (vb)
öamo|owner (n)
öapsar-|to wipe away (vb)
öar|away from (adv)
öatarië|apostasy; (lit.) away-standing (n)
öa|away (of movement) (adv)
ú (particle)|not (particle)
ú (prep adv)|destitute of; without (prep adv)
ú pusto|at once; immediately; (lit.) without pause (adv)
ú-|bad; difficult; hard; hardly; in-; no; not; un-; uneasy; with difficulty; ‘badly’ (pref)
úcalima|dim; murky; *not bright (adj)
úcar-|to do wrong; to sin; *to trespass (vb)
úcarindo|*sinner (n)
úcarindë|sinner (f.) (n)
úcarnë|not red (adj)
úcarunqua|sinful (adj)
úcarë|debt; trespass; *sin (n)
úcim-|to disregard (vb)
úcárima|unmakeable; *undoable (adj)
úfailië|unrighteousness (n)
úfantima; úfantuma|not concealable (adj)
úfanwëa|not veiled; unveiled (adj)
úhandë|incomprehension; unreason (n)
úlaita-|to dishonour (vb)
úlaitima|disgraceful; dishonourable (adj)
úlanwa|infinite; infinity (n adj)
úlumë|at all times (in a series or period) (adv)
úlévima|paralyzed (adj)
úlëa|flooding; flowing; pouring (adj)
úma-|to teem (vb)
úmahta(le)|nuisance (n)
úmaitë|clumsy(-handed); unskilled (adj)
úmara|bad; evil; ill-used; sinister (adj)
úmárë|not good = evil (n)
úmëa|abundant; swarming; teeming (adj)
úmë|abundance; great collection or crowd of things of the same sort (n)
únat|thing impossible to be or to be done (n)
úna|deprived of; destitute; forlorn (adj)
únehta|*atom (n)
únut-|to untie (vb)
únyárima|impossible to recount (adj)
únótima|countless; difficult/impossible to count; numberless (adj)
úpahtëa|speechless (adj)
úpartalë|unorder; *disorder (n)
úpa|dumb [unable to speak] (adj)
úperima|indivisible (adj)
úpoica|unclean (adj)
úquétima|impossible to say or put into words; unpronounceable; unspeakable (adj)
úr; úrë|heat (n)
úra (Emotion)|nasty (adj)
úra (Sense Perception)|sultry; torrid; unpleasantly hot (adj)
úrin|(blazing) hot (adj)
úro|nastiness; *evil (n)
úruva|fiery; like fire (adj)
úr|fire (n)
úsahtando [þ]|tempter (n)
úsahtië [þ]|inducement to do wrong; *temptation (n)
úsië|on the contrary (conj)
útancië|uncertainty (n)
útulma|accident; (lit.) bad-event (n)
útulya-|to mislead (vb)
útulyando|deceiver; (lit.) mis-leader (n)
útúrima|unruly (adj)
úva-|to be imminent; to draw near; to impend (vb)
úvanima|hard to call beautiful; hideous; not fair; ugly (adj)
úvanimo; úvano|corrupt or evil creature; monster (n)
úvanë(a)|without beauty (adj)
úvië|consideration; considering a matter (with a view to decision); pondering (n)
