(a)moth|fen, marsh (n)
(be)bilfir|conscience (n)
(m)bara-|to dwell (vb)
(n)adi|father, daddy (n)
-(i)ol; -iel; -in; -r(i)ol; -ra; -ren; -thol; -ui; -wed|adjective suffix (suf)
-(i)ol|active participle; adjective suffix (suf)
-(i)on; -eg; -i|adjectival suffix (suf)
-(r)il; -dis|feminine agent (suf)
-(r)on; -ir; -or|agental suffix (suf)
-(u)m|?indefinite suffix (suf)
-ad (Grammar)|dual; noun-suffix (suf)
-ad|gerund (suf)
-ant|3rd person past tense; regular past tense (suf)
-as; -eth; -ith; -os; -ri; -th|abstract noun (suf)
-ath; -rim|collective or group plural (suf)
-a|[old] genitive suffix; genitive suffix (suf)
-bar|dweller; home, -ham (suf)
-carn|*-made (suf)
-c|noun or adjective suffix (suf)
-dil; -nil|friend, lover (suf)
-dor|*king, lord (suf)
-drin; -grin|suffix in the name of languages (suf)
-eb|adjectival suffix; adjective suffix (suf)
-ed|3rd person singular possessive suffix; gerund (suf)
-eg (Grammar)|2nd person singular familiar possessive suffix; diminutive/singular ending (suf)
-egir|2nd person plural familiar possessive suffix (suf)
-elir|2nd person plural polite possessive suffix (suf)
-el|2nd person singular polite possessive suffix (suf)
-emir|1st person plural exclusive possessive (suf)
-enc; -engir|our (inclusive), 1st pl. incl. poss. suffix (suf)
-ent|their, 3rd pl. poss. suffix (suf)
-en|adjective suffix; my, 1st sg. poss. suffix (suf)
-eth; -ien|feminine ending (suf)
-garn|-made (suf)
-gen|*earth (suf)
-gon (Emotion)|valour (suf)
-gon (Social Relations)|lord, prince; valour (suf)
-i; -r|dative suffix (suf)
-iad|comparative ending (suf)
-ian(d)|-land; -land, country (suf)
-iant(ha); -iont(ha)|*superlative (suf)
-iant|superlative ending (suf)
-iel (Grammar)|perfective-participle (suf)
-iel (Mankind)|daughter; feminine suffix; name suffix (suf)
-ig|diminutive/singular ending (suf)
-il|feminine suffix (suf)
-in (Grammar)|adjective ending; plural suffix (suf)
-iof|-bearing (suf)
-ion (Grammar)|*agental suffix (suf)
-ion (Mankind)|-son; son (suf)
-ion; -on(d) (Social Relations)|-region, -land (suf)
-ir (Grammar)|past of intransitive verbs (suf)
-la|noun suffix; verbal suffix (suf)
-li; -st; -thi; -wen; -weth; -wi|noun suffix (suf)
-lim|many (suf)
-liont|*tendril (suf)
-loth|-grown (suf)
-nt|past of transitive verbs (suf)
-n|genitive suffix (suf)
-oglo(n)|augmentative (suf)
-og|singular suffix (suf)
-ol|continuative [active] participle; adjective suffix (suf)
-on; -os; -oth (Grammar)|augmentative suffix (suf)
-on; -we (Mankind)|masculine suffix (suf)
-onta|superlative (suf)
-o|imperative (suf)
-ra; -sta|verb suffix (suf)
-ra|many Sindarin adverbs end in [this] (suf)
-riel|crowned maiden (suf)
-rim (Grammar)|group plural (suf)
-rim|*many (suf)
-rod|abstract nom[inals] (suf)
-r|plural in verbs (suf)
-tha|causative suffix; noun or adjective suffix; verb suffix (suf)
-thi|*diminutive suffix (suf)
-thlib|-ly or -like (suf)
-thlim|race, folk (suf)
-tt; -ui; -wi|dual (suf)
-uin|*noun suffix (suf)
-ui|-ful, having quality, adjective suffix; [as verbal suffix] possibility, suitability, *-able (suf)
-u|a person or being (suf)
-vron|dwelling (suf)
-weg|active in doing (suf)
-wein; -wig|*female suffix (suf)
-wen|maiden, *female suffix (suf)
-we|person, being, individual; masculine suffix (suf)
Adan|Man (as a species) (n)
Aeni|(female) angel (n)
Aenu|(male) angel (n)
Anaur; Anor|Sun (n)
Balan|Power, God; Vala, Power (n)
Cerfeth; Cerveth|July (n)
Cwedhrin; Cweneglin|*Elvish (Qenya) (n)
Dantilais; lasbelin|autumn (n)
Dân [nd-]|Green-elf (n)
Edhel; Eledh; Elen; Ell; penedh; penn|Elf (n)
Egol; Idhel; Ileth; Uidhol; Uigol|elf (n)
Eledhes|*Elf-maid (n)
Eledhon|*Elf-man (n)
Eledh|Star-folk, Elf (n)
Elleth|Elf-maid (n)
Ellon|Elf-man (n)
Eru|God (n)
Feir|Mortal, mortal man (n)
Firieth|(Female) Mortal (n)
Firion|(Male) Mortal (n)
Forchalad|aurora, (lit.) northern radiance (n)
Fíreb|Mortal (n)
Girithron|December, *Shuddering-one (n)
Gold [ng-]; Goltha [ng-]; Gul [ng-]|Gnome (n)
Goldogrin|Language of the Gnomes (n)
Goldrin|Gnome (adj)
Golodh [ng-]|Gnome, Deep-elf; one of the wise folk, Gnome; one of the wise folk, Noldo (n)
Golt|gnome (n)
Gwaeron|March, *Windy-one (n)
Gwalion; Gwalon|male god (n)
Gwalir; Gwalthir|female god (n)
Gwirith|April, *Freshness (n)
Hadhod; naug|Dwarf (n)
Harchalad|aurora, (lit.) southern radiance (n)
Hithui|November, *Misty-one (n)
Ithil; Raun; Rân|Moon (n)
Ivanneth|September, *Yavanna-ness (n)
Lothron|May, *Flower-ness (n)
Mithres; Thenneth|*Grey-Elf (f.) (n)
Mithron; Thennor|*Grey-Elf (m.) (n)
Mîth; Thend|*Sinda, Grey-Elf (n)
Narbeleth|October; October, Sun-fading, Sun-waning (n)
Narwain|January, *(lit.) New Fire (n)
Noegin|Petty Dwarf (n)
Nogotheg|Dwarflet (n)
Nogoth|[Greater] Dwarf (n)
Noll [ng-]|Noldo (n)
Nínui|February, *Watery (n)
Nórui|June, *Fiery (n)
Ogol|?Elf (n)
Onod|Ent (n)
Oraeron|Sea-day, *Thursday (n)
Oranor|*(lit.) Sun-day, Sunday (n)
Orbelain|*Day of the Valar, Friday (n)
Orgaladhad|Day of the Two Trees, *Tuesday (n)
Orgaladh|Day of the Tree, *Tuesday (n)
Orgilion|*Star-day, Saturday (n)
Orithil|*Moon-day, Monday (n)
Ormenel|*Heavens-day, Wednesday (n)
Perian|Halfling; Halfling, Hobbit (n)
Rodon|Vala (n)
Rodyn|alternate name of the last day of the Eldarin six-day week (n)
Thilim|*Moon (n)
Torog|Troll (n)
a (conj)|and; and; †by, near, beside (conj)
a(n); na|of (the) (prep)
a- (pref)|?; intensive prefix (pref)
a- (pron)|it, they; 3rd-person pronoun (pron)
a; ae (interj)|O! (interj)
a; na; nan (prep)|of (prep)
abgen-|to foresee, expect (vb)
ablad|prohibition, refusal (n)
abont|back; backwards (adv)
abor|tomorrow, (lit.) after-day (n)
ab|after (prep)
ach (adv)|too, *excessively (adv)
ach (conj)|*but (conj)
ach (n)|neck, *(upper) spine (n)
achad|rock ridge, neck (geographically) (n)
achar-|to avenge, do back, react, requite (vb)
achared|vengeance (n)
acharn|vengeance, (an act of) revenge (n)
ad-|back, again, re- (pref)
ada (Mankind)|father (hypocoristic), daddy (n)
ada; adi|daddy (n)
adaba-|to build, erect, establish (vb)
adab|building (n)
adaneth|(mortal) woman (n)
adar; bâb; nathon|father (n)
adbannad(a)-|to refill (vb)
adbed-|to rephrase (vb)
adel|behind, in rear (of) (prep)
adengion|builder (n)
adertha-|to reunite (vb)
aderthad|reuniting (n)
adh; ah|and (conj)
adhin; dîn (adv)|once (up a time), long ago, formerly (adv)
adhwen|approach, avenue (n)
adlanna-|to slope, slant (vb)
adlannas|downfall, ruin (n)
adlant|oblique, slanted (adj)
adlod|sloping, tilted (adj)
adrum; dam [nd-]; dring|hammer (n)
adu; edaid|double (adj)
aduial|(evening) twilight, *evening (n)
advir|heirloom (n)
aebin; aibios|cherry (tree) (n)
aeda-|to revere, worship (vb)
aedaith|reverence, worship, religion (n)
aedh|nest (n)
aegas|mountain peak (n)
aeglir|line of peaks, range of mountain peaks (n)
aeglos|icicle, (lit.) snow-point; snowthorn (a plant) (n)
aeg|sharp, pointed, piercing (adj)
ael|lake, pool (n)
aemar; aivin|rookery, colony of birds (n)
aen; ain|*should, could (adv)
aenor|god (n)
aer (adj)|*hallowed, holy (adj)
aer; gaear; oear; saroth|sea (n)
aerem|icon (n)
aerlinn|*hymn, (lit.) holy song (n)
aeron|saint (n)
aes|cooked food, meat (n)
aewen|of birds (adj)
aew|(small) bird (n)
agla-|to shine out, flash (vb)
aglad|lightning (n)
aglann|ray of light (n)
aglareb (adj)|glorious; glorious, brilliant, *radiant (adj)
aglareb (n)|glorious (n)
aglar|glory; glory, brilliance, splendour, radiance; glory, splendour (n)
aglath|glory (n)
aglen; agol|flash (n)
agor|narrow (adj)
agos; dae; odra|very (adv)
agra|extreme, vehement, excessive (adj)
agrech|contempt (n)
agreitha-|to despise, contemn (vb)
agreithannen|despised (adj)
agreitharol|despicable, contemptible (adj)
agros|excessively, too; excess (adv)
ai (interj)|cry of pain or woe; hail; oh! (interj)
ai (pron)|*those who (pron)
aidlan; aina; ainan|today (n)
aidra-|to expiate (vb)
aidros|expiation (n)
aigos; thôn|pine-tree (n)
aina; ineg; lhigin; ligen (adj)|small (adj)
ainog|*(male) god (n)
ainuil|*(female) god (n)
ain|same, identical (adj)
air|lonely (adj)
aithi; aithwen; maethon; megil; segeth|sword (n)
aithl; ethuil; tuil|spring (n)
aithr|thorn, †sword (n)
aith|spear-point, spear (n)
al-|no, not (pref)
alae|?behold (interj)
alaf (Agriculture and Vegetation)|elm (n)
alaf|broad of the back (n)
alagon; gwaew|storm (n)
alagos|storm (of wind) (n)
alag|rushing, impetuous (adj)
alaith|shielding, warding off, protect(ion) (n)
alanc|*shielded, protected (adj)
albeth|(word of) good omen (n)
alch(ar)|shrine, temple (n)
alcharn|of wood, wooden (adj)
alf; alfuil(in); alph|swan (n)
alfeg|cygnet, young swan (n)
alfirin|immortal, (lit.) not dying; a species of flower (adj n)
alfuil|large white sea-bird, albatross (n)
alhad|nowhere (pron)
aliavren|barren (adj)
allu|never (adv)
alm|back (from shoulder to shoulder), shoulders (n)
alnad|nothing (pron)
alphen|no one, nobody (pron)
altha-|to shoot up, grow (high) (vb)
alu|wholesome, *healthy (adj)
alvar|(good) luck, fortune (n)
alwed|prosperous, fortunate (adj)
am (adv adj)|more (adv adj)
am (adv)|up; up, upwards; up, upwards, towards head of, above (adv)
am(m)arth; umrod|fate (n)
am-|snake (pref)
amaith; emel; mabir; naneth; nanwin|mother (n)
amarth; ammarth|fate, doom (n)
amartha-|to define, decree, destine (vb)
amarthannen|decreed, destined, ordained (adj)
amar|Earth; world, the Earth, (lit.) settlement, the great habitation (n)
ambend; ambenn|uphill (adv)
amben|uphill; arduous, difficult, tiresome (adj)
amdir|hope [based on reason], *expectation, (lit.) looking up (n)
ami|mummy (n)
amloth|helm crest, (orig.) uprising flower (n)
amlug; cunn; lhûg|dragon (n)
ammal|(death) agony (n)
amman|why, (lit.) for what (adv)
ammatha-|to maul (vb)
ammos (Body Parts and Functions)|*breast, chest (n)
ammos (Warfare and Hunting)|byrne, hauberk, cuirass (n)
ammuia-|to work (hard) for, to earn (vb)
amon|hill; hill, (isolated) mountain; lump, clump, mass; hill, mount, steep slope (n)
amorvad|breakfast (n)
amor|morning, early day (n)
amosgarn|robin; robin, (lit.) red-breast (n)
amoth; rôma (Body Parts and Functions)|shoulder (n)
amoth|breast (n)
amra-|to go up and down, live in the mountains, wander (vb)
amrad|nomand, wanderer (f.) (n)
amrent; amrint|lark (n)
amrod|wandering, living in wilds (adj)
amrog-dorn|brown wanderer, gipsy (n)
amrost; aurost; galad|dawn (n)
amrosta-|*to rise (vb)
amrûn (Spatial Relations)|uprising, sunrise, Orient, east (n)
amrûn (Time)|sunrise, east, (lit.) of the uprising (n)
an-|intensive prefix; with, by (pref)
anann|(for) long; long (adv)
anc|jaw, row of teeth (n)
and; ann|long (adj)
andaith|long-mark (n)
andrann|cycle, age, (lit.) long cycle (n)
andrethui|patient, long suffering (adj)
andreth|long-suffering, patience (n)
angeb|like iron (adj)
angerthas|runic alphabetic, (lit.) long rune-rows (n)
anglenna-|to approach (vb)
anglennol|approaching, coming (adj)
angol (Religion and Beliefs)|deep lore, magic (n)
angol; golu; ongol; thû|stench (n)
angos; dael [nd-]; del; gorog; goroth [ng-]|horror (n)
angren|of iron (adj)
angwedh|chain, fetter, (lit.) iron-bond (n)
ang|iron (n)
ann (Possession and Trade)|gift (n)
ann; fen(n)|door (n)
anna- (Emotion)|to thank (vb)
anna- (Possession and Trade)|to give; to give, †add to (vb)
annabon|elephant (n)
annad|thanks (n)
annas|length (n)
anneth|(act of) giving (n)
annon|(great) gate, door (n)
annuir|lofty (adj)
annui|west[ern] (adj)
annûn|sunset, west; (lit.) going down; west (n)
anos|man (fullgrown), warrior (n)
anthum|upwards, cg. onto (prep)
ant|cheek; face (n)
anuir|forever, everlastingly, eternally, in eternity (adv)
anu|male (person or animal) (n adj)
anwar|awe (n)
anwas|manhood, *manliness, masculinity (n)
anwathren|manly, masculine (adj)
an|of; to, for (prep)
aníra-|to desire, *long for (vb)
anóren|sunny (adj)
apha-|to touch (vb)
aphad-|to follow (vb)
aphadol|following (adj)
aphadon; echil|follower (n)
apharch|arid, very dry (adj)
aphas|(sence of) touch (n)
ar (conj)|*and (conj)
ar (conj, Spatial Relations)|and; and, too, besides (conj)
ar (prep)|at; to, towards (prep)
ar(a)-|noble, royal; noble, royal, high (pref)
ar(an)eg|kinglet (n)
ar-|beside, along with, compared with; outside, beside; without; outside; without (pref)
aranas|kingship (n)
aran|king, lord (of a specific region); king, lord, chief, (lit.) high or noble person; lord (of a specific region) (n)
aras|deer, hart, *stag (n)
arben; rohir|knight (n)
archadhu; archaf|throne, (lit.) high seat (n)
archos|savagery, evil temper (n)
archuis|evil temper (n)
arch|fierce, harsh; awkward, difficult (adj)
ardhon; gardhon|province (n)
arf|barren, dry, desert (adj)
argen-|?to search over (vb)
arin(g)|kiln (n)
arn; ionn|son (n)
arnad|*kingdom (n)
arnediad|unnumbered, without reckoning, numberless, innumerable, countless, endless; without reckoning, numberless, innumerable, countless, endless (adj)
arnen|?royal (n)
arnoediad|unnumbered, without reckoning (adj)
arnœdiad|innumerable, countless, endless (adj)
arod|noble (adj)
arog|swift, rushing, torrential (adj)
arphen|noble, knight (n)
arthor|realm (n)
arwad|apple tree (n)
ascar; asgar|violent, rushing, impetuous (adj)
asc|bone; stone of fruit (n)
asgath|skeleton (n)
asgeb|bony (adj)
asgolui|equivalent, (lit.) beside-bear-able (adj)
asg|bone; bone; stone of fruit (n)
ast (Physical World)|dust (n)
ast (Sense Perception)|light or heat of the sun, *warmth (n)
astor; astorad|loyalty (n)
ast|light or heat of the sun (n)
ath-|easy, easily (pref)
ath; atha; ent; est; idi(r); ith|they, 3rd pl. pronoun (pron)
atha-|will (future) (vb)
athae|*healing herb, healing (n adj)
athan|beyond (prep)
atheg|[little] father; thumb (n)
athelas|a healing herb; a healing plant; kingsfoil, a healing herb (n)
athgar|easy (easy to do) (adj)
athgen|easily seen (adj)
athla|twice (adv)
athor|doctor (n)
athra- (Body Parts and Functions)|to treat medically (vb)
athra- (Spatial Relations)|to cross (to and fro) (vb)
athrabed-|to discuss, exchange words (vb)
athrabeth|conversation, debate, (lit.) interchange of words (n)
athrada-|to cross, traverse (vb)
athrad|ford, crossing (n)
athragared|interaction (n)
athren|dusty (adj)
athron|second, other (adj)
athru|secondly, once more, again (adj)
athwi; uith|both (adj)
auba|shout (n)
auglos|bright sunshine (n)
aul|ill, badly (adv)
aur|(whole) day, sunlight, morning; day, morning (n)
aus(s)aith|avarice (n)
aust; laer; safwen (Time)|summer (n)
auth (Religion and Beliefs)|dim shape, spectral or vague apparition (n)
auth (Warfare and Hunting)|war, battle (n)
ava-|will not, do not (vb)
avad|refusal, reluctance (n)
avasaith|avarice, greed of gold (n)
avas|wealth; luck (n)
avautha-|to ravish, seize (forcibly) (vb)
avauthron|seizer, ravisher (n)
avauth|ravishment; seizure (n)
avnedhor|afternoon (n)
avosaith|gloomy places (n)
avras; rhass|precipice (n)
awartha-|to forsake (vb)
awarth|abandonment (n)
awl|*lofty (adj)
baba|mummy, mamma (n)
bach [mb-]|article (for exchange), ware, thing (n)
bachor [mb-]|pedlar, *trader, merchant (n)
bach|jacket, coat (n)
bad (Motion and Transportation)|way (n)
bad-|*to tread; to travel (vb)
bad; fû; lonn|path (n)
badh- [mb-]|to judge (vb)
badhor [mb-]; badhron [mb-]; pridwir|judge (n)
bag-|to sell, trade (vb)
bail; gwael|sheath, case, cover; pod (n)
bain|beautiful; good, wholesome, favorable (adj)
baith; hamp|garment (n)
bal-|*to have power (vb)
baladh|worth, importance (n)
balaen|divine (adj)
balas|divinity, divine power (n)
bala|round hump, hump, hillock (n)
balch [mb-]; faig|cruel (adj)
balch|fierce, ferocious; cruel (adj)
bald|*worthy (adj)
balf|excitement, emotion (n)
balhant|illfated stroke (n)
balla-|to matter; to be of significance, worth, moment (vb)
ballam|with evil malicious tongue (adj)
ball|worthy, important (adj)
baltha-|to excite, rouse, stir up, agitate (vb)
balthanc|obstinate (adj)
balthannen|excited, agitated (adj)
balthir|evil king (n)
balthol|exciting; excitable (vb)
balt|a plain (n)
balvlaud|overweening pride (n)
banath; beinas; gwanwen; gwanweth|beauty (n)
band [mb-] (Law and Judgment)|prison, custody, duress (n)
band; band [mb-] (Religion and Beliefs)|hell (n)
banga- [mb-]|to trade, *sell (vb)
bangad|trade, trading (n)
bangath|market (n)
bang|staff (n)
bann [mb-]|duress, prison (n)
banna- [mb-]|to imprison (vb)
bannan [mb-]|prisoner, (lit.) imprisoned-one (n)
bar [mb-] (Dwelling and Furniture)|home, dwelling (n)
bar [mb-]|house, dwelling, home (n)
bar(n)a- [mb-]|to dwell in (a land), till (land) (vb)
bar- [mb-]|to live, dwell, stay (vb)
barad [mb-]|doomed, *fated (adj)
baradh|steep (adj)
barad|fort, tower, fortress; tower, great towering building, fort, fortress (n)
barai [mb-]|at home, home (adv)
barant [mb-]; barod [mb-]|homewards, home (adv)
baran|brown, golden-brown; swart, dark brown; brown, swart, dark brown (adj)
baravlid [mb-]|homeless (adj)
bara|fiery, eager (adj)
bardh [mb-]|home (n)
bardha-|to rule, reign (vb)
bardhon [mb-]|inhabitant, native (n)
bardhor [mb-]|habitable (adj)
bardor [mb-]|home land, native land (n)
barf|armour, armor (n)
barn [mb-]; baron [mb-]|tilled, inhabited (adj)
barna- [mb-]|to till (land), *cultivate; (orig.) to dwell in (a land) (vb)
barn|safe, protected, secure (adj)
barog [mb-]|from home, out, away, abroad (adv)
baros [mb-]|hamlet (n)
bartha- [mb-]|to doom (vb)
barthan [mb-]|dwelling-house, large building of masonry used as a dwelling (n)
bart|*fate (n)
barwen [mb-]|homestead (n)
bas(t) [mb-]|bread (n)
basca-|to flap (vb)
basgorn [mb-]|loaf (of bread); loaf, loaf of bread, round loaf, cake; round loaf, cake (n)
basoneth [mb-]|breadgiver (n)
basta- [mb-]|to bake (vb)
batha-|to trample (vb)
bauch [mb-]|price, cost (n)
bauda-|to ban, prohibit, refuse (vb)
baudh [mb-]|judgement (n)
baug [mb-]|tyrannous, cruel, oppressive (adj)
baugla- [mb-]|to oppress (vb)
bauglir [mb-]|constrainer; tyrant, oppressor; tyrant, oppressor (n)
baul [mb-]|torment (n)
baur [mb-]|need (n)
baura- [mb-]|to need, require (vb)
baw [mb-]|howling (n)
baw|no, do not! (interj)
bedhril|judge (f.) (n)
belaith [mb-]|mighty (adj)
beleg|great, large; great, large, huge; great, mighty; large, big, huge; mighty, great (adj)
beleitha- [mb-]|to extol, magnify (vb)
belen|expanded, unrolled, unfurled, set (of sails) (adj)
bellas|bodily strength (n)
belon|sail (n)
beltha-|to open out (transitive), expand, unroll, set sail (vb)
belt|strong in body (adj)
belwa-|to unroll, unfurl (intransitively), belly (of sails), swell (vb)
benc|small boat (n)
bened|chin (n)
benli|a pretty (n)
bennas|angle (n)
benn|husband; man, male, †husband (n)
benwed|shapely, pretty (adj)
beren|bold (adj)
bereth (n adj)|queen, spouse; supreme, sublime (n adj)
bereth (n)|queen (n)
beria-|to protect (vb)
bertha-|to dare (vb)
berthas|adventure, bold undertaking (n)
berthian|challenge; daring, audacity (n)
besain [mb-]|the Lady, breadgiver (n)
besgad|wedlock (n)
bess|wife; woman; †wife (n)
besta-|to wed, marry (vb)
bestad|wedding, (lit.) a marrying (n)
bestannen|wedded, married (adj)
best|marriage, matrimony, wedlock (n)
bethren|brother in law, kinsman by marriage (n)
bethres|sister in law, *kinswoman by marriage (n)
bethril|spouse (f.) (n)
bethron|spouse (m.) (n)
be|as, like (prep)
bilebra-; felcha-|to equal (vb)
bilebren|equable (adj)
bileutha-|to make equal, equalize (vb)
biltha-|to resemble, seem like; to seem likely, be probable (vb)
bilthadren|probable (adj)
bir|in, within, inside (prep)
blab-|to flap, beat (wings etc.) (vb)
blabed|flapping, beating (especially of wings) (n)
blaud|pride (n)
blencha-|to flash (vb)
blid-|to free, rid (vb)
blith|air, breeze, zephyr (n)
bliw; blîw|oil (n)
blodren|arrogant; arrogant, *proud (adj)
bloss [mb-]|wheat (n)
blé|fat of meat (n adj)
blê|fat of meat; *fatty, oily, greasy (n adj)
bod-|back, again; un- (= backwards) (pref)
boda-|to ban, prohibit, refuse, forbid (vb)
bodamrost|resurrection (n)
bodra-|to hinder, delay, tarry (vb)
bodra|back(ward), hinder, rear (adj)
bodron|behind, further back (adv)
bodruithog|thirsting for vengeance (for a particular act) (adj)
bodruithol|vengeful (by nature) (adj)
bodruith|revenge (n)
boe [mb-]|must (impersonal), (lit.) *[it] needs (vb)
boer|hot, raging; heat, rage (adj n)
bogligen|cheap (adj)
bogodog|dear, *expensive (adj)
bon-; gon-|son of (pref)
bond [mb-]|snouted (adj)
bont|back(wards) (adv)
bordh [mb-]|heat, rage; hot, raging, wroth (n adj)
born (adj)|[stead]fast (adj)
born (n)|age, great period (n)
born [mb-]|hot, red (adj)
both [mb-]|puddle, small pool (n)
bothol [mb-]|oven (n)
both|fen, marsh; puddle, small pool (n)
bo|*on (prep)
brach|shawl, plaid, wrap; shawl, wrap (n)
braetha-|to wrap, swathe (vb)
branc; branta; peng|bow (for shooting) (n)
brand (n, Warfare and Hunting)|steeple (n)
brand; brann (adj)|towering, tall and massive, high; lofty, noble, fine (adj)
brand; tham (n)|hall (n)
branna-; tortha-|to scorch (vb)
brannon; hîr|lord (n)
brann|lofty, noble, fine; high (adj)
brant; brant [mb-]|cooked, done; overdone (adj)
brass (Physical World)|great cliff (n)
brass (Sense Perception)|white heat, *extreme heat (n)
brassen|white-hot, *very hot (adj)
brasta-|to tower up, loom (vb)
brath-|to cook (vb)
bregedur|wild fire (n)
breged|violence, suddenness (n)
bregolas|fierceness, *ferocity (n)
bregol|quick, sudden, violent, *fierce; violent, sudden, *fierce (adj)
breitha-|to break out suddenly (vb)
brenia-|to endure (vb)
brennil; heruin; heryn; hiril; híril|lady (n)
brethil (Agriculture and Vegetation)|beech; silver-birch (n)
brethil (Social Relations)|princess, (lit.) queen-daughter (n)
breth|mast, *fallen nuts or acorns (n)
bril|glass, crystal (n)
brin(in)|glassy substance (n)
brinc|clear, transparent (adj)
bringlast|alabaster (n)
brin|dwarf-glass (n)
brith-|to chance (vb)
brithon|pebbly (adj)
brith|gravel (n)
broch; brois; regil|mare (n)
brog|horse (n)
bron(n)|steadfast, firm (adj)
brona-|to last, survive (vb)
bronadui|enduring, lasting (adj)
bronad|survival (n)
brond|firm; firm, steadfast, *faithful, constant (adj)
bronnas|steadfastness, constancy (n)
bronwe; reth|endurance (n)
bronwedieth|constancy (n)
brui|loud; loud, *noisy (adj)
brumla-|to make a noise (vb)
brum|noise (n)
brêg|lively, sudden, quick (adj)
brôg|bear (n)
brûn|old (has long endured) (adj)
budhulug|dragonfly (n)
budhu|large fly (n)
buia-|to serve, hold allegiance to (vb)
buin|desire, wish (n)
buir; ûr|fire (n)
bund [mb-]|snout, nose; cape [of land] (n)
bár|home; earth (n)
bâd|beaten track, pathway, way, path (n)
bân|fair, good, wholesome, favorable (adj)
bâr [mb-]|house; house, dwelling, home (n)
bâ|away, off (adv)
bída-|to compare, liken (vb)
bíleb|equal (adj)
bîl|likeness, similarity (n)
bôn|back (n)
bôr (adj n)|steadfast; trusty man, faithful vassal (adj n)
bôr (n)|descendant (n)
bŷl|(single) service or favour (n)
bŷr|follower, vassal (n)
cab-|to jump, leap; to leap, jump (vb)
cabed|leap (n)
cabor|frog (n)
cadudew|allomorph, (lit.) shaped sign (n)
cadu|shaped, formed (adj)
cadwor|shapely (adj)
cad|*after (adv)
caeda-|to lie; to lay (down) (vb)
caeleb|bedridden, sick (adj)
cael|lying in bed, sickness (adj)
caer|flat isle on a river (n)
caetha-|to make to do or be, cause, compel, induce, bring about (vb)
caethas|causation (n)
caetheb|original (n)
caeth|cause, reason, motive (n)
caew|lair, resting-place (n)
cafol|bald (adj)
cafor|flea (n)
cagli; glaudh|joke, jest (n)
caileg; heledh; talp|glass (n)
cail|fence, palisade of spikes or sharp stakes (n)
caineglad|fortnight (n)
cair; cîr|ship (n)
caiw|lively, quick (adj)
cai|hedge (n)
cal-|to shine (vb)
calad|light; light, brightness, shining (n)
calan|day(light) (n)
calardan|lampwright (n)
calar|(portable) lamp (n)
calen|green, (orig.) bright-coloured; green; †bright, bright-coloured (adj)
calf|water-vessel (n)
callon|hero (n)
calph|bucket; water-vessel, bucket (n)
camba-|to stoop, cower (vb)
camlann; dalv|palm of hand (n)
camm; mab; maw; mâb|hand (n)
camma-|to make fit, suit, accommodate, adapt (vb)
cammui|suitable, fitting, convenient (adj)
cam|(cupped) hand, holding hand; handful; hand (n)
can-|to cry out, shout, call (vb)
canad|four (cardinal)
canath|quarter (n)
cancha-; lala-|to laugh (vb)
canga-|to tangle; to tangle; *to go wrong (vb)
cangi-|to go wrong, get tangled (vb)
cang|tangled, confused, mixed up, awry; tangle, confusion, mêllay (adj n)
cannas|[abstract] shape (n)
cantharol|glaring, flaming (adj)
canthil|square (n)
canthor|blaze, flare, glare (n)
canthui|fourth (ordinal)
cant|outline; shape; outline (n)
caphaen|forty (cardinal)
car(dh)|house, *construction, structure (n)
car-|*to make; to do, make (vb)
carab|hat (n)
carach|jaws; jaws, rows of teeth (n)
caraed|effective, productive, effectual, efficacious (adj)
caraes|*jagged hedge of spikes (n)
carag|spike, tooth of rock (n)
caralluin|*red-blue (adj)
caran|red (adj)
caras|a city (built above ground); city, city (built above ground); (orig.) fort or dwelling surrounded by bulwarks, circular earthwall with dike (n)
carch (Body Parts and Functions)|fang (n)
carch (Sense Perception)|tooth, fang (n)
cared|action, *doing, making (n)
carf|tool, implement, weapon (n)
carnen|done, made, finished (adj)
caron|actor, agent, doer, maker (n)
carpa|together, in a bunch, bunched-up (adv)
carp|bundle, bunch (n)
carthas|activity (n)
carth|deed (n)
carweg|active; busy (adj)
castol|helmet (n)
cas|head, skull (n)
cathrae|tressure, *headdress (n)
cauda-|to get flavour of, perceive, notice (vb)
caudol|tasteful, endowed with good taste; discreet, circumspect (adj)
caug|humpback (n)
caul|(great) burden; affliction (n)
caun (Language and Music)|outcry, clamour (n)
caun (Social Relations)|prince, chief, head (n)
caur|action, doing, making; verb (n)
caust|savour, flavour (n)
cauth|deception, lie (n)
cav-|to receive, *accept (vb)
cavren; tuvriol|acceptable (adj)
caw-|to taste (vb)
caweth|sense of taste, taste, judgement (n)
caw|top (n)
ceber (Physical World)|?limestone, -rock (n)
ceber (Spatial Relations)|stake, spike (n)
cectha-|to spout out (vb)
cef|soil (n)
ceiria-|to cause, bring about (vb)
celair|brilliant, *shining (adj)
celebren|of silver (adj)
celebrin|like silver (in hue or worth); of silver (adj)
celeb|silver (n)
celef|deer, hind (n)
celeg|hasty; agile, swift; lambent; swift, agile (adj)
celeth|stream, *brook, rill, runlet; (lit.) a flowing (n)
celevon|*of silver (adj)
celf|channel (n)
celia-|to illuminate, light up; to illustrate (vb)
celias|(artificial) light, illumination (n)
cell|flowing (adj)
celu-|to trickle (vb)
celu|spring, source (n)
celwa-|to trickle (n)
cen-|to see, perceive, look (vb)
cenedril|mirror, looking-glass, (lit.) looking-crystal (n)
cened|looking, *seeing (n)
cennan; cevnor|potter (n)
cerch|sickle (n)
ceredir|doer, maker, *crafter (m.) (n)
ceredis|crafter (f.) (n)
cerf|knife (n)
cerin (Physical World)|circular mound, artificial hill; round enclosure (n)
cerin (Spatial Relations)|round enclosure (n)
certhas|runes-rows, runic alphabet (n)
certh|rune (n)
cesta-|to seek, search for, look for (vb)
cestaedas|curiosity (n)
cestaed|curious, seeking, inquisitive (adj)
ceth-|to examine, search, interrogate (vb)
cethaeg|horizon (n)
cethia-|to cause interest, to interest (oneself) (vb)
cethiol|interesting (adj)
cevemphast|earth quake (n)
ceven|*earth; Earth (n)
cevnas|earthenware (n)
cevn|of earth, earthen (adj)
cevorf|potato, (lit.) earth-apple (n)
ce|*might, maybe; may(be), might (adv)
cil-|to choose, select (vb)
cilith|choice, choosing, *selection (n)
ciloba-; ciloptha-|to twitter, chirp, chirrup (vb)
cim|blade (n)
cingra-|to plait (vb)
cingra|plaited (adj)
cin|you (sg. fam.) (pron)
cirbann; lorn|haven (n)
cirdan|shipbuilder (n)
cirias|fleet (of ships) (n)
cirion|sailor, shipman (n)
cirith|cleft, pass; cleft, ravine, defile, pass (n)
ci|thou (pron)
clamfa-|to grab, claw at (vb)
claur|splendid; †splendour, glory (adj n)
clib-|to uphold, support; to lean (vb)
cli|?attractive (adj)
clochrin|stony, stone-like (adj)
clochwed|stony, stone-covered (adj)
clog|stone (small) (n)
closs|shingle (n)
cluimri|pleasant warmth, cosiness (n)
cobar|knob, head, tip (n)
cod; pech|nut (n)
codhon|idol (n)
codiavol; codiof; codwed|nutbearing (adj)
codomla|*chestnut (n)
codorn; codron|*nut tree (n)
codrin|nutty (adj)
codwalion|walnut, chestnut (n)
cog|claw, fist (n)
col-|to bear, carry, wear (vb)
colch|box, chest (n)
coleb|burdensome (adj)
coll (adj, Sense Perception)|red, scarlet (adj)
coll (n)|cloak, mantle (n)
coll; naw (adj, Spatial Relations)|hollow (adj)
collorn|laburnum, *(lit.) orange-tree (n)
colof|orange [fruit] (n)
colron|bearer (n)
coltha-|to bear up; to weigh, balance it on scales; to be worth, value or be equivalent to (vb)
colui|light (to carry), not heavy, (lit.) carryable (adj)
com|bellied (adj)
condir|mayor, *(lit.) chief-man (n)
conui|commanding (adj)
cor-|to turn sour, curdle, congeal; to make cheese (vb)
coranor|solar year, (lit.) sun-round (n)
corch; crunc|crow (n)
cordh|sour (of milk), curdled (n)
cordof|pippin, *a type of yellow and red apple (n)
corf|ring (for fingers) (n)
corin|round, circular; rolling (adj)
corn|round, globed (adj)
corob|skull (n)
corod; rind; ringorn|circle (n)
coron|globe, ball (n)
corth|curd (n)
coru|cunning, wily (adj)
cor|ring, circle (n)
cost|quarrel, *dispute (n)
coth (Food and Drink)|nutshell, husk (n)
coth (Social Relations)|enemy, foe; enmity; enmity, enemy (n)
cotha-|to startle (vb)
cothren; cuid|hostile (adj)
cov-|to bow (vb)
cova-|to come together, meet; to gather, assemble (vb)
covad(a)-|to bring together, make meet (vb)
covas|community (n)
covn|empty, void (n)
covra-|to empty (vb)
craban|bird of crow-kind, *raven (n)
craitho-; puia-|to spit (vb)
craith|foam, froth, spume (n)
crann-|to finish, complete, accomplish (vb)
cranna-|to accomplish, finish, complete, achieve (vb)
crannen|perfect (adj)
crann|ruddy (of face); blush, the cheeks (adj n)
crech|spittle (n)
crig|elbow (n)
crintha|rosy, pink (adj)
criptha|together, in a bunch, bunched-up (adj adv)
cris(s)|cleft, gash, gully, ravine (n)
crisg|sharp [edged] (adj)
criss (Physical Acts and Materials)|cleft, cut, slash, gash (n)
criss (Physical World)|cleft, cut, slash; pass (n)
crist (Physical Acts and Materials)|knife; slash, slice (n)
crist (Warfare and Hunting)|cleaver; cleaver, sword (n)
crista-|to slash, cut, slice (vb)
critha-|to reap (vb)
crithiol; rend|circular (adj)
crithla-|to encircle; to circle, go round (vb)
crithos|circle, ring (n)
crogin|hooked (adj)
crug|beak (espec. of a ship) (n)
cruin|coloured (adj)
cruith (Physical World)|spume (n)
cruith (Sense Perception)|colour, complexion, appearance (n)
crui|colour (n)
crumguru|wiley, sinister, guilty (n)
cuctha|consideration (n)
cucthol; cunghol|painstaking (adj)
cuen|small gull, petrel, sea-bird (n)
cug-|to ponder, resolve, think, consider (vb)
cugu|dove (n)
cui(w)|awake, alert (adj)
cuia-|to live (vb)
cuida-|to bring to life, enliven, energize (vb)
cuileb|lively (adj)
cuilin; gloriel; glóriel; glórin; mallen|golden (adj)
cuilogwi|liveliness (n)
cuilvorn|lifetime (n)
cuil|life; life, lifetime (n)
cuina-|to be alive (vb)
cuinas|vitality, liveliness (n)
cuin|alive (adj)
cuithas|life (period of life); living, livelihood (n)
cuith|[biological process of] life, the vital principle; life, the vital principle; living body (n)
culon|*gold (n)
culuin|golden-red, orange (in colour) (adj)
cum(b)|mound (n)
cumli|couch (n)
cum|belly (n)
cund|*prince (n)
cungan(d)|viol(in), (lit.) bow-harp (n)
cunnas; gonnas|dragon’s lair (n)
cuno|care, thought, ‘pains’ (n)
curdhuig|sinner [m.] (n)
curdhuin|sinner [f.] (n)
curin; thairiniol; thairinwed|magical (adj)
curu (Mind and Thought)|cunning (n)
curu (Physical Acts and Materials)|skill (of the hand), craft, magic; cunning (n)
curu; curw; gûl [ng-]|magic (n)
curunir|a man of craft, wizard (n)
curunis|witch (n)
curunír|wizard, man of craft (n)
cusc; susc|hushed, quiet; abashed (adj)
cwathil|plume (n)
cwedri|telling (of tales) (n)
cwent|tale, saying (n)
cwidhra-|to rustle (vb)
cwileg|alder (n)
cwilon|bright-hued (adj)
cwingfimli|skill at archery (n)
cwingfim|skilled at archery (adj)
cwithra-|to murmur, whisper (vb)
cílobi|robin (n)
círdan|shipbuilder, shipwright (n)
cî; sî|here (adv)
cîn|your (sg. fam.) (pron)
cîr; cîw|fresh, new (adj)
cîrin|present (place or time), modern (adj)
cîr|sour (of milk) (adj)
côl|herb, vegetable, edible plant; wort (n)
cúron|crescent moon (n)
cútha-|to deceive, lie (vb)
cû (Spatial Relations)|arch, crescent; bow, crescent; the waxing or waning moon (n)
cû (Warfare and Hunting)|bow; arch, crescent (n)
cûd|foe (n)
cûl|load (n)
cûm|mound (especially grave), burial mound (n)
cûn|bowed, bent, bow-shaped, concave; bowed, bent, concave (adj)
cûr|cheese (n)
cýra-|to renew (vb)
cýron|new-moon (n)
cŷl|*renewal (n)
cŷr|renewed (adj)
dadbenn|downhill (adj)
dadben|downhill, inclined, prone; (figuratively) easy-going, easy, not arduous (adj adv)
dadhra- [nd-]|to face, oppose, stand in way; to resist, thwart (vb)
dadhren [nd-]|opposing, facing, opposite (adj)
dad|down (adv)
dae- [nd-]|dreadful, abominable, detestable (pref)
daebeth [nd-]|blasphemy (n)
daedelos [nd-]|horrible fear (n)
daen [nd-]|corpse (n)
daer [nd-]|bridegroom (n)
daer|great, large (adj)
dae|shadow (cast by an object or form), shade (n)
dag- [nd-]|to slay; to slay, kill (vb)
dagnir [nd-]|slayer, bane (n)
dagnis [nd-]|slayer, bane (f.) (n)
dagor [nd-]|battle (n)
dagra- [nd-]|to battle (vb)
dagras [nd-]|slaughter (n)
dagrassaeb|bloodthirsty, (lit.) slaughter-hungry (adj)
dagrassaeg|bloodthirstiness, (lit.) slaughter-hunger (n)
dai; ell|sky (n)
dail; deil|beautiful, fine, delicate, lovely (adj)
daira-; telia-|to play (vb)
dairion; de(i)rion (n)|lord, chief (n)
dairion; gelir|merry (adj)
dairwen|mirth (n)
dair|play, merriment (n)
dalath|flat surface, plane, plain; vale (n)
dalech; daleg|(upright) stone (n)
dalhung|not heavy (adj)
daltha-|to erect, set up (vb)
dambed- [nd-]|to answer (vb)
damma- [nd-]|to hammer (vb)
dammen- [nd-]|to return, go back (vb)
dammog|valueless (adj)
damor|no good (adj)
dan [nd-]|back to, (back in return) against, down upon, back on, back again (prep)
dan-|negative prefix attached to adjectives (pref)
dananna- [nd-]|to give back, return [something] (vb)
dandol- [nd-]|to return, come back (vb)
daneitheb|thornless (adj)
dangair|mirthless (adj)
dangar- [nd-]|to undo (vb)
dangen; dangen [nd-]|slain (adj)
danglarweb|without light (adj)
dangweth [nd-]|answer, *(lit.) back-report (n)
danna-|to fall (vb)
dannad|falling (n)
dannen [nd-]|ebb, lowtide (n)
dannen|fallen (adj)
dannod-|to untie, undo, unloose (vb)
dant|*fall (n)
danwedh [nd-]|ransom (n)
dar-|to stop, halt (vb)
darhod|not free (adj)
daroth|summit, peak (n)
dartha-|to wait, stay, remain, last, endure (vb)
dathanc; iltanc|unsteady (adj)
dath|hole, pit; steep fall, abyss (n)
daug [nd-]|warrior, soldier [with evil connotations] (n)
daur|league; †stop, pause (n)
dav-|to allow, yield, permit (vb)
daw|hush, be silent (interj)
degil [nd]|victor, winner (n)
deil(i)an; delwen|beech tree (n)
dein|height, summit; height, loftiness, sublimity (n)
delch; delch [nd-]|dense (adj)
deldrin grontholas [nd-]; deldron grondolas [nd-]; gronthos deldrinwed|oakleaved beech (n)
deldrinwed [nd-]|beechen (adj)
deldrogod [nd-]|beech nut (n)
deleb|horrible, abominable, loathsome (adj)
delia-; doltha-|to conceal (vb)
deloth|abhorrence, detestation, loathing (n)
delu|hateful, deadly, fell (adj)
dem|sad, gloomy (adj)
dev- [nd-]|to try, *seek opportunity, experiment (vb)
dew-|to fail, miss (vb)
de|you (pron)
di [nd-]|beneath, under; in (prep)
diant|most (adv)
difedhin|*outlaw (adj n)
dilia-|to stop (up) (vb)
dilith [nd-]|friendship (n)
dim (adj)|past, over, former (adj)
dim (n, Dwelling and Furniture)|stair (n)
dim (n, Emotion)|gloom, sadness (n)
dimborn; gwanwas|the past, past days, olden times (n)
dineth [nd-]; dîs [nd-]|bride (n)
diradhim; diradhin|once upon a time (adv)
dirbedui|hard to utter, difficult to pronounce (adj)
diriol|tedious (adj)
dir|through, over (prep)
dod-|to drop; to fall down, drop (vb)
dod|berry (n)
dol(l)|head, hill (n)
dolen|hidden, secret (adj)
doll [nd-]|obscure, dark, dusky, hidden, secret (adj)
dollon [nd-]|phoneme, underlying sound, (lit.) hidden-sound (n)
dolph [nd-]|mole (n)
dolt [nd-] (adj)|obscure (adj)
dolt [nd-] (n)|round knob, boss (n)
dom|blind (adj)
dond; donn; paur|fist (n)
donn|swart, swarthy; shady, shadowy (adj)
dorgannas [nd-]|shapes of the lands, *geography (n)
dorgant [nd-]|landscape, scene, *(lit.) land-shape (n)
dorn|tough, stiff, thrawn, obdurate (adj)
doron; gorw|oak (n)
dortha- [nd-]|to dwell, stay, settle (vb)
dortha-|to settle (vb)
dov-|to lie heavy (vb)
dovn; dufui|gloomy (adj)
drab-|to labour, work; (impersonal) to irk, annoy (vb)
drabol|labouring (adj)
drab|labour, toil, irksome work (n)
dram(b)|heavy blow (n)
drambor (Body Parts and Functions)|clenched fist; blow with a fist (n)
drambor (Physical Acts and Materials)|thudder (n)
dram|heavy stroke, heavy blow (n)
draug; garaf [ng-]; harw; ulug|wolf (n)
drauth (adj)|weary, toilworn, tired (adj)
drauth (n)|labour (n)
drautha-|to weary, tire out (vb)
drauthas|[wearisome] toil, weariness from labour (n)
drauthiel|arduous, labourious (adj)
drava-|to hew (vb)
dravn|hewn log (n)
drega-|to flee (vb)
dre|wearisome, irksome (adj)
drib- [nd-]|to rot, decay, wear out (vb)
dringa-|to beat (vb)
dring|hammer, *beater (n)
drinna-|to turn, twist (vb)
drint|twist, wrench, turn (n)
driothweg [nd-]|hero, warrior (n)
driothwen [nd-]|heroism, valour (n)
drith [nd-]|savour, smell, flavour; suggestion, inkling (n)
drith-|it smells, smacks of, savours of (vb)
drogod|slavery, bondage, thraldom (n)
drogol; drogwed|servile, slavish; base, mean (adj)
drogwin|slave woman (n)
drog|slave, thrall, servant (n)
drû|wood, forest (n)
duia- [nd-]|to descend, sink, set [of sun] (vb)
duidhrad|canal (n)
duila-; gwil-|to fly (vb)
duileg|having power of flight, fledged (adj)
duilin(g)|swallow (n)
duilin; dúlin(n)|nightingale (n)
duil|flight, power of flight; having power of flight, fledged (n)
duinen|flood, high tide (n)
duiniant|aqueduct (n)
duin|(large) river; water, river (n)
duirro|*river-bank (n)
dumgort; dungort|(evil) idol (n)
dum|secret, not to be spoken (adj)
duruin|wooden (adj)
duwath; dúath|night shadow, dark/black shadow, night-shade (n)
dwindi|a swift (bird) (n)
dâd; nâd|grandfather (n)
dâf (Social Relations)|permission (n)
dâf; gwath; rîf|bark (n)
dân|day (n)
dâ|high (adj)
dêl|disgust (n)
díhena-; gohena-|*to forgive (vb)
dínen|silent (adj)
dírnaith [nd-]|wedge-shaped battle-formation, (lit.) man-spearhead (n)
dî [nd-]|woman; woman, bride, lady (n)
dîl|stopper, stopping, stuffing (n)
dîn (n adj)|silence; silent, quiet (n adj)
dîn (n)|opening, gap, pass in mountains (n)
dîr (adj, Physical Acts and Materials)|hard, difficult (adj)
dîr (adj, Spatial Relations)|long (of time) (adj)
dîr; dîr [nd-]|man, adult male; agental suffix (n)
dôr [nd-]|land, country; land, country (inhabited), people of the land; land, dwelling-place, region where certain people live; land, region where certain people live, country (n)
dú(w)ath|night-shade (n)
dúda- [nd-]|to lower [something] (vb)
dúnad|descent (n)
dúnen|western (adj)
dúvad|supper, dinner (n)
dûn [nd-]|west (n)
dûr [nd-]|dark (with evil implications), gloomy, hellish (adj)
dûr|dark (adj)
dû|night, dimness; night-fall, late evening; night, night-fall, late evening (n)
dýgar|mistaken act; doing a wrong thing (n adj)
dŷl|mistake (n)
dŷr|mistaken, off point, not right (adj)
e; ho; hon(o); on|he (pron)
eb (Grammar)|save, except (prep)
eb (Time)|?before (prep)
ech (n)|spine, *spiny quill or bristle (n)
ech (pron)|?you, yourself (singular) (pron)
echad- (Physical Acts and Materials)|to fashion, shape; make (vb)
echad- (Spatial Relations)|to form, make, shape, cut out, fashion; (lit.) to shape out (vb)
echad|camp (n)
echain|new, built again (adj)
echor|outer circle; encircling (n adj)
echui(w)|awakening (n)
echuia-|to awaken, wake up (intr.) (vb)
echuida-|to wake up (trans.), waken, rouse (vb)
echuiru-|to come to life (vb)
echuir|early Spring, (lit.) stirring (n)
ectha-|to spout, jet (vb)
ecthelorn|spruce, fir-tree (n)
ed (prep pref)|out, out of, forth (prep pref)
ed (pron)|*it (pron)
ed-|forth, out (pref)
edanna-|to publish, (lit.) out-give (vb)
eden|new, begun again (adj)
edhellen|elvish (adj)
edhelvein; vanedhel|elven fair (adj)
edinor|anniversary day (n)
edledhia-|to go into exile (vb)
edledhron|exile (n)
edlen(n)|exiled (adj)
edlonui|foreign (adj)
edlon|outsider, stranger, *foreigner (n)
edol|ivy (n)
edonna-|to beget (vb)
edra-|to open; to open (out) (vb)
edraenui|?outside, bordering, outer (adj)
edrain|*(outer) border (n)
edraith|rescue, saving (n)
edregol|in especial, *especially (adv)
edren|outer (adj)
egelmion|broadshouldered (adj)
egelren|different, strange (adj)
egel|other (adj)
egiont|further, farther (adj)
eglan|forsaken (adj)
egleria-|to glorify (vb)
egli(n)|needle (n)
egnas|sharp point, peak (n)
egol|else, something else (adv n)
egor|or (conj)
ego|be off! (interj)
egriol|excessive (adj)
eg|far away, wide, distant, far off (adv)
eiben|cherry (n)
eilin; loeg|pool (n)
ein-|excellent, admirable (pref)
einior|elder (adj)
eirien|daisy (n)
eirin|holy (adj)
eitha-|to prick with a sharp point, stab; to treat with scorn, insult (vb)
eithad|*insult (n)
eitheb|thorny, *(orig.) full of points (adj)
eithela-|to spring, well forth, *issue forth (vb)
eithel|issue of water, spring, well, fountain; source, spring, well, issue of water, fountain (n)
eithlios; ethlios|fountain (n)
eithlod|springing, welling forth (n)
eithog; eithweg|ancestor, †father, sire (n)
eithos|thorn bush (n)
eithron|*spearman; warrior (n)
eithro|*also (adv)
el; elen; gail; êl|star (n)
elaig-|to shield, ward off, protect (vb)
elanor|pimpernel, small golden star-shaped flower, (lit.) sun-star; sun-star (n)
elchith|nebula, star cloud (n)
eleg|other, else (adj)
elia-|to cause to prosper, bless (a work), help one (vb)
eliad|blessing (n)
elianw|rainbow, (lit.) sky-bridge (n)
elias|blessedness (n)
elirdhi; faigri|cruelty (n)
elloth|single flower (n)
elo|behold! (interj)
elt|dig, poke (probe), tug, lug (n)
elui|starry (adj)
elu|(pale) blue (adj)
elva-|to marvel at, admire (vb)
elvain(n)|wondrous, marvelous, wonderful; wonder(ful thing), marvel (adj n)
elvain|wondrous, marvelous, wonderful (adj)
elven|wonder, wonderment (n)
emig|[little] mother, *mommy (n)
emlin|yellow bird, yellow hammer (n)
emma-|to paint, draw (something) (vb)
emmas|painting, drawing (vb)
em|picture, image (n)
en (adv)|then, that past (adv)
en (conj)|*then (conj)
en (prep)|of the (prep)
en (pron)|1st sg pronoun; that by you, that already mentioned (by you), that past (pron)
en-|*to name (vb)
enaidh|central, middle (adj)
enas; enuith|title (n)
enchui|sixth (ordinal)
enedhren|central, essential (adj)
enedh|centre, middle, core; centre, middle; core (n)
ened|moreover (adv)
eneg|six (cardinal)
enephaen|sixty (cardinal)
eneth|*name (n)
enfeg|infamous, of evil name (adj)
engluid|Stonefaces (collective-noun)
enia-|to be born, be generated, result (vb)
ennais|signature, (lit.) name sign (n)
ennas|there (adv)
enne(i)rion|adversary, rival (n)
ennen|named (adj)
ennin|Valian year (n)
ennion|porter, doorkeeper (n)
eno|*still (adv)
entha|there by you, thither (adv)
enwa-|to be called, be named (vb)
enweria-|to revere (vb)
enwiol|nominal (adj)
ephed-|to say out (vb)
ephel|outer fence; outer fence, surrounding ring (n)
ephola-|?to remember (vb)
ercha-; tigla-|to prick (vb)
erchion|orchish (adj)
erch|prickle (n)
ereb|isolated; single, alone, lonely, isolated (adj)
eredh|seed, germ (n)
eregdos|holly, holly-tree (n)
ereg|holly, holly-tree; holly-tree (n)
erethog|isolated, solitary, lonely (adj)
ereth|solitude, oneness, loneliness (n)
eria-|to rise (vb)
eriab|badger (n)
eriad|rising (n)
eriol|single, alone (adj)
erlu|once, one time (adv)
ermin|desert, waste (n)
ernil|prince (n)
ero|*only, alone (adv)
ertha-|to unite (vb)
erthad|union, uniting (n)
erthi|also, as well, besides, too (adv)
eru|waste, desert (n)
eryn|wood, forest (of trees) (n)
er|one; one, alone (adj)
esbin|thin thread (n)
escar|weapon (n)
esc|sharp point, sharp edge (n)
esgal|cast shadow, shade; screen, hiding (n)
esgia-|to smoke (intr.) (vb)
esk|sharp upstanding rock in water (n)
est; eth; is|he, she, it, 3rd sg. pronoun (pron)
esta-|to call, *name (vb)
estannen|named, called (adj)
estel|hope, trust, *faith [in] (n)
esten(t); thenn; thent|short (adj)
estirion|pinnacle, tower (n)
estola-|to encamp, *erect tents (vb)
estolad|encampment (n)
ethia-|to ease, assist (vb)
ethir (Physical World)|mouth of a river; mouth of a river, (lit.) outflow (n)
ethir (Sense Perception)|spy (n)
ethiria-|to flow out (vb)
ethog-|to lead out, *bring out (vb)
etholtha-|to extract, make come out (vb)
ethuil|spring [the season] (n)
eth|outside (adj adv)
fadhw; paglos|parchment (n)
fadriol|sufficient (adj)
fadro(n)|too much (adj)
faefelf|soul-feeling, *emotion (n)
faeg|mean, poor, bad (adj)
fael (adj)|fair-minded, just, generous (adj)
fael (n adj)|gleam of the sun; *gleaming (n adj)
faelas|fairness, equity (n)
faen|vapour (n)
faergol|depression, grief, (lit.) spirit-burden (n)
faer|spirit (in general) (n)
fae|incarnate spirit, *soul (n)
fagin|cut (adj)
failtha-|go pale (vb)
fain|white, shimmering, shining, radiant; white and shining [thing] (adj n)
fair|quick, ready, prompt (adj)
falas (Physical World)|beach, shore; beach, shore, strand, surf(line) (n)
falas|beach (n)
falch; riss|cleft, ravine (n)
falchon|great two-handed sword, twibill (n)
falchor|cliffs (n)
falf|foam, breaker, wave (n)
falin; lanc; umaith (adj)|naked (adj)
faloth|large foamy wave (n)
faltha-|to foam (vb)
fang|(long) beard; beard (n)
fanha-; fanna-|to veil, cloak (vb)
fanui|cloudy; cloudy, (lit.) having much cloud (adj)
fanu|vapour, steam (n)
fanwos|mind-picture (of apparition in dream) (n)
far (adj adv)|sufficient, enough, quite (adj adv)
far (adv)|yet, however (adv)
far(o)n|separate, different, strange (adj)
far-|to separate, sever, divide; to depart, leave (vb)
fara-|to hunt (vb)
faran|rowan, *ash (n)
farf|?carpet (n)
farn|enough (adj)
faron; feredir|hunter (n)
faroth|*hunting (n)
fartha- (Quantity and Number)|to sate, satisfy (vb)
fartha- (Spatial Relations)|to divide (tr.) (vb)
farthannen|sated, satisfied (adj)
farthas|satiety, satisfaction (n)
fass|tassle (n)
fast (Body Parts and Functions)|shaggy hair (n)
fast (Spatial Relations)|holder, stand (n)
fastui|shaggy, hairy, hirsute (n)
fathol|(tasselled) fringe (n)
fathren|tasselled (adj)
fauglas; fuglos|tobacco (n)
faug|thirsty (adj)
faul|bladder, (orig.) inflated thing (n)
faus(t); luibri|thirst (n)
fautha-; fôtha-; glosta-|to snow (vb)
faw-|to puff, blow, pant (vb)
faw|*breath, puff of breath (n)
fech; olch; ulch|bad (adj)
fecthi|less bad; baddish, naughty (adj)
fegla; feigien|worse (adj)
feira-|to suffice (vb)
feir|mortal man, mortal (n)
fel-|to feel (a sensation or emotion) (vb)
felaich|splash (n)
fela|cave; mine, boring, tunnel, underground dwelling (n)
felechia-|to splash (vb)
feleg; gorod; grûda; rond|cave (n)
felf|feeling, sensation (n)
felweg; gofelweg|one’s fellow or equal, rival (n)
fend|threshold (n)
fennas|great door, doorway, gateway (n)
fenn|threshold, door (n)
fenwed|venomous (adj)
feredis|hunter (f.) (n)
fergar|soon done (adj)
fergenol|quick to see or perceive, sharp-sighted or witted (adj)
feria-|to make ready (promptly) (vb)
fern|dead (of mortals); dead person; dead (of mortals) (n adj)
ferui|ready to hand, (quickly) available (adj)
fesga-|to itch, irritate (vb)
fesg|itching, irritating (adj)
fess|itch, itching (n)
fi-|you, 2nd-person singular (pron)
fidhras|collective hair, *all hair on the body (n)
fidhren|having hair, -haired (adj)
fien; fuin|worse (adv)
filc; fileb|fern (n)
fileg|small bird, *sparrow (n)
filigod|small bird (n)
fimlios|skilfulness (n)
fim|slender, slim (adj)
finc|trick (n)
findel; finnel (n adj)|head of hair, fax, mass of long hair; having fine or beautiful hair (n adj)
findel; finnil|tress (n)
find|hair; tress, [ON.] lock of hair; hair (in general) (n)
fineg|*lock of hair (n)
fing; finn (Body Parts and Functions)|lock of hair (n)
fini(o)s|larch (n)
finna-|to trick, deceive, cheat, take in (vb)
finnel (n)|(braided) hair (n)
finn|hair; tress; single hair; hair; lock of hair (n)
fintha|thine (pron)
finwi|skill (n)
fion(n)iel|(fem.) mortal man (n)
fiont(ha)|later (adj)
fiont|least (adj)
fir-|to fade, *die (vb)
firin|dying (adj)
firith|autumn; fading; [late] autumn (n)
fir|less (adj)
fladweth|meadow, grassland (n)
flant|expression of scorn, leer, sneer (n)
flathnir|foam fay (n)
flathrin|foamy, tasseled (adj)
flathwing|scud, spray, spindrift (n)
flidhra|‘willowy’, graceful (adj)
flinc|finch (n)
flind; flinn|fleet-footed, swift (adj)
flâd|skin (n)
foen (adj)|radiant, white (adj)
foen (n)|long sight (n)
fofrin; fovren|foolish (adj)
fofru; fovas|folly (n)
for; fuir|north (adj)
fordúnen|northwestern (adj)
fordûn|northwest (n)
forn|north, right; right or north (adj)
forodren|northern (adj)
forod|north (n)
forrúnen|northeast (adj)
forrûn|northeast (n)
forvo|right hand, right side (n)
fo|a clan (n)
fring|necklace, carcanet (n)
fufuin|hoard (n)
fuia-|to feel disgust at, abhor (vb)
fuin|night; night, dead of night; night, gloom, darkness, dead of night (n)
fuiol|disgusting (adj)
fuior|deadly nightshade (n)
fuir|right (hand) (adj)
fuitha-|to fall (of night); to grow dark (vb)
fuithlog|dragon (who guards treasure) (n)
furn|secret, concealed (adj)
fyvril|moth (n)
fân|(white) cloud; veil, curtain; form or vision of a spiritual being (n)
fêg|bad, poor, wretched (adj)
fêr|beech-tree (n)
fíreb|mortal (adj)
fîn|(single) hair, filament (n)
fîr|late (adj)
fôf|fool (n)
gach|cow; milch cow (n)
gad-|to catch (vb)
gadas|trap (n)
gador|prison, dungeon (n)
gadros|union, association, fellowship (n)
gaduin|bond, obstacle, hindrance (n)
gae; goe|dread (n)
gaearon|ocean, (lit.) great sea (n)
gaeda-|to astound, make aghast (& surprise, shock) (vb)
gael|pale, glimmering (adj)
gaeruil; uil|seaweed (n)
gaer|awful, fearful, dreadful; dreadful (adj)
gaesen|of steel (adj)
gaessarn|pearl, (lit.) sea-pebble (n)
gaes|steel (n)
gaethren|like steel (adj)
gaew|pregnant (adj)
gaib|*pregnant (adj)
gaigin|arms (n)
gail (adj)|bright, light (adj)
gail (n)|star; sign, token, heavenly body (n)
gair-|there is room (for) (vb)
gairion|jester (n)
gairwen; gerwen|mirth, fun (adj)
gal- [ng-]|to shine clear, shine golden as the Sun (vb)
gal-|to shine (golden, as the Sun) (vb)
gala-|to grow (vb)
galad [ng-]|radiance, glittering reflection (n)
galad; gaul|light (n)
galadh; orn|tree (n)
galadhremmen|tree-meshed (adj)
galas|plant, growth (n)
galenas|pipeweed; pipeweed, nicotiana, *tobacco (n)
galenathrod|(smoking) pipe (n)
galen|grown (esp. of plants) (adj)
galf|back [of a body], shoulders [collectively] (n)
galtha-|to be glad (vb)
galu|increase, growth (n)
galvorn|type of dark metal devised by Eöl, *(lit.) shining-black (n)
gammas|s-sign (n)
gamp|hook, claw; hook, crook; claw (n)
gandos|morose temper (n)
gand|dark & gloomy; morose; harsh, ill tempered, sour, gloomy of temper (adj)
gann(ad)a- [ng-]|to play a harp (vb)
ganna-|to gain, profit, increase; to be profitable, bring in revenue (vb)
gannan|waxen, grown big, grown up, adult, [originally?] large (adj)
gannel [ng-]|harp (n)
gant (adj)|larger, greater, more, (lit.) increased (adj)
gant (adv)|larger, greater, more, (lit.) increased (adv)
gar(th) (gardh-)|place, district (n)
gar-|to hold, have, *possess (vb)
garadren|having room for, convenient, adequate, opportune (adj)
garadros|opportunity (n)
gardh|region (n)
garion|hauberk (n)
garnen|own, held, possessed (adj)
garn|‘own’, property (n)
garob|cloak, outer garment; robe, cloak, outer garment; robe, outer garment (n)
gartha- (Emotion)|to admire, have affection or respect for (vb)
gartha- (Possession and Trade)|to defend (vb)
gartha-|to defend, keep (vb)
garth|fort, fortress (n)
gar|?to go (vb)
gasdil|stopgap (n)
gas|hole, gap (n)
gauda-|to invent, originate, devise (vb)
gaudhwen|fever (n)
gaud|device, contrivance, machine (n)
gaug|clumsy (adj)
gaul [ng-]|wolfhowl (n)
gaur [ng-]|werewolf (n)
gauth|heat (esp. of body) (n)
gaw- [ng-]|to howl (vb)
gawad [ng-]|howling (adj)
gawlas; goloth [ng-]; taur|forest (n)
gaw|void (n)
ged- [ñg-]|to get, catch, obtain, take (vb)
gelia- [ng-]|to learn (vb)
gella-|to rejoice, delight (vb)
gellam|jubilation (n)
gellui|triumphant (adj)
gell|joy, triumph (n)
gem|sickly (adj)
genedia-|to reckon (vb)
genediad|reckoning (n)
gentha-|to grip, seize, lay hold of (vb)
gen|closed hand, grip (n)
geria-|to ponder (vb)
gern|worn, old, decrepit (of things) (adj)
gersoth|mine (n)
geth|ore of metals (esp. raw iron) (n)
gil [ng-]|star; (bright) spark, silver glint, twinkle of light (n)
gil- [ng-]|to gleam, shine pale and silver (as of the moon [or stars]) (vb)
gil-|to gleam, shine pale and silver (as of the moon) (vb)
gildin|silver spark (n)
gilhof|dew, *(lit.) star-juice (n)
gilith|starlight, *region of the stars (n)
ging; lhingril; ungol|spider (n)
gintha-|to join to (intr.), add, increase, add to (vb)
gir-|to shudder (vb)
girith|shuddering, horror; shuddering; horror (n)
gir|interior, inwards, centre, inner parts, inside, heart (n)
giwl; giwol; gŷl|fecund; conceiving, having conceived, just pregnant (adj)
giwth; gŷth|germ, foetus, embryon (n)
glab-; glavra-|to babble (vb)
gladh-|to laugh [at a joke], *guffaw (vb)
gladhweg|cheerful, (lit.) apt to laugh (adj)
glad|wood (n)
glae(gal)|light (as an ethereal substance), *photons (n)
glae; half|grass (n)
glaenas|fair weather; serenity (n)
glaen|serene, clear, fair (espec. of weather) (adj)
glaer|long lay, narrative poem (n)
glaew|ointment, salve (n)
glaich|merry, joyous, happy (adj)
glais|sweetness (n)
glaiw|salve (n)
glam(m) [ng-]; tevas|hatred (n)
glamm|shouting, confused noise; barbarous speech (n)
glamog|orc (n)
glamra-|to abominate, loath, detest (vb)
glamri|bitter feud (n)
glam|din, uproar, bellowing of beasts, shouting, confused noise; barbarous speech (n)
glan (Mind and Thought)|clear (adj)
glan (Sense Perception)|pure, clean, (originally) bright (adj)
glan(n)|boundary (n)
glandagol|boundary mark (n)
glann; puig|clean (adj)
glanna-|to cleanse, purify, purge, *to clear, make clear (vb)
glannaith|cleanliness, purity (n)
glannas|purification (n)
glannen|cleanly, pure (adj)
glarossiol|dazzling (adj)
glarosta-; glartha-|to dazzle (vb)
glassui|joyful, happy (adj)
glass|joy, *happiness (n)
glasta-|to joke; to make happy (vb)
glast|marble (n)
glas|joy (n)
glathralvas|flashing glass/crystal, *heliograph (n)
glathren|[of or like] marble (adj)
glaur (adj)|light, bright (adj)
glaur (n adj)|gold [light or colour] (n adj)
glaur; glôr (n)|gold (n)
glavaitha-|to blaze (vb)
glavaith|blaze, burning, blazing light (n)
glavradeb|full of the din of voices (adj)
glavradol|chattering, talkative (adj)
glavradon|vain talker, *chatterbox (n)
glavras|babble, chatter, babel, din of voices (n)
glavrol|babbling (adj)
glaw (Physical World)|sunshine; radiance (n)
glaw (Sense Perception)|radiance (n)
glawar (Physical Acts and Materials)|gold (light or colour); sunlight, radiance (of Laurelin) (n)
glawar (Physical World)|sunlight, radiance of Laurelin (n)
gledhrin; nind|slender (adj)
gledhrinios; glen(d)rinios|slenderness (n)
gleina-|to bound, enclose, limit (vb)
gleinannen|bounded, enclosed, limited (adj)
glenna-|*to travel (vb)
glent|thinness (n)
glidheb|like honey (adj)
glim (adj)|shimmering (adj)
glim (n)|voice, *utterance (n)
glimri|sheen (n)
glind; glinn|*song (n)
gling-|to hang, dangle (vb)
glintha-|to glance (at) (vb)
glinthad|look, glance, flash of the eye (n)
glir-|to sing, recite poem (vb)
glisca-|to have a sweet tooth, like sweet things (vb)
glist|sugar (n)
glodhren|jocular (adj)
glonta-|to swallow, gulp, devour (vb)
glorchadhu|lotus, (lit.) golden seat (n)
gloss (adj)|(dazzling) white, snow-white, clear white; white, clear white (adj)
gloss (n adj)|snow, snow-white (n adj)
glosui|snow white (adj)
glum|cloud (n)
glâm|hatred, loathing, fierce hate (n)
glân (adj)|[bright shining] white; clear; pure, †bright (adj)
glân (n)|hem, border (n)
glâs|brilliance, clarity (n)
glîn(n)|gleam, glint (n)
glîr|song, poem; song, poem, lay (n)
glî|honey (n)
glóna-|to dawn (vb)
glôrin|golden, of gold (adj)
glûdh|soap (n)
go-; gwa-|together; together, co(n)-; together, co-, com-; together, in one; with (pref)
gobel|(walled) village, town (enclosure); walled house, *manor; walled house or village, town (n)
gobem; gogel; gogìl|mouth (n)
gobennas; pennas|history (n)
gobennathren|historical (adj)
gobeth|dictionary (n)
gochestri; gochethri; hestri; hethri|consanguinity (n)
gochest|brother and brother, brother and sister, etc.; brother and brother, brother and sister, etc., *a set of siblings (n)
godaithrinwed|grammatical (adj)
godref|abreast; *together-through (adv)
goe (Emotion)|terror, great fear, dread (n)
goeol|*fell, terrible, dire (adj)
gofelthi|exact similarity (n)
gofil; gwafel|exactly alike (adj adv)
gog; gwag; rhaen|crooked (adj)
goianna-|to join with, add to (vb)
golain|connection, relation, context, (lit.) threadage (n)
golas; golass|foliage, collection of leaves (n)
golbar [ng-]|school, university, (lit.) wisdom-house (n)
golbh; goluidh; golw; thostol|stinking (adj)
golc|stink, stench (n)
golf|branch (n)
goll [ng-]; sael|wise (adj)
gollor [ng-]|magician (n)
golodh [ng-]|lore-master, sage (n)
golof|consonant (n)
goloth|inflorescence, *collection of flowers (n)
goltha- [ng-]|to teach, educate, tutor, (lit.) make knowledgable (vb)
golthannen [ng-]|learned, educated (adj)
golthanneth [ng-]|teaching, lesson (n)
golthas [ng-]|education, erudition (n)
golthor|teacher (n)
golu [ng-]|lore, *wisdom (n)
golwen [ng-]|wise, learned in deep arts (adj)
golwin; gulwin|*Gnomish woman (n)
golyn; laer (Language and Music)|song (n)
gomintha|together (adv)
gonathra-|to entangle, enmesh (vb)
gonathras|entanglement (n)
gond (Physical World)|stone, rock, stone (as a material) (n)
gond; gonn|stone, rock (n)
gondram|hewn stone (n)
gondren|*of stone (adj)
gond|rock; stone (n)
gonebedach-|to approach one another, to become like, resemble (vb)
gonn (Physical World)|(great) stone, rock; rock, stone (as a material) (n)
gonneb|stony, rocky (adj)
gonnos|great rock (n)
gonnoth|pillar, stele, memorial (n)
gonod-|to count (up) (vb)
gonoded|counting, accounting (n)
gor [ng-]|horror, dread, fear (n)
gor- (pref)|hard, difficult (pref)
gor- (vb)|to warn, urge (vb)
gor- [ng-]|all, altogether, quite (pref)
goras|advice (n)
gorbedui|only to be said with horror or grief, lamentable to tell (adj)
gorchanui|complicated, enigmatic, cryptic, hard to understand (adj)
gordh (adj)|difficult, laborious (adj)
gordh (n)|deep thought (n)
goredhin [ng-]|related, sib, akin (adj)
goredhin|sib, akin, [closely] related (adj)
goredhnir|cousin (f.) (n)
goredin|*related (adj)
gorf|impetus, vigour (n)
gorgor [ng-] (adj)|dreadful (adj)
gorgor [ng-] (n)|extreme horror, terror, haunting fear (n)
goriad|greater (adj)
gorn [ng-]|revered (adj)
gornod(ui)|hard to count (adj)
gorn|impetuous (adj)
goroth [ng-]|horror, dread (n)
gorth [ng-]|dead; dead (person) (adj n)
gorthad [ng-]|wraith, spirit of Dead (n)
gorthob [ng-]|horrible (adj)
gosta-|to fear exceedingly (vb)
gost|dread, terror; fear (n)
gothnir; othwen|amazon (n)
govad-|to meet (vb)
govaethas|government (n)
govai|alike, similar (adj adv)
goveg|just like (adj)
goven|crossroads (n)
govin(d)riol; govinra; nochinra|long-acorned (adj)
govod|companionship, living together; community, fellowship, *(orig.) eating-together (n)
govron; gronoch; noch|acorn (n)
gowest|contract, compact, treaty (n)
grand|town (n)
gratha-|to rub, scratch, fray (vb)
graug|demon (n)
graus|sow, *female pig (n)
graw|dark, swart (adj)
grendi|cousinship, family (in a wide sense) (n)
grest (Possession and Trade)|succour, salvation (n)
grest (Social Relations)|aid, support, help, succour (n)
gresta-|to aid, help, succour, support (vb)
grileg|ringed, hooped shape (adj)
grind|ankle, wrist (n)
grith-|to attend to, tend, care, care for, mind (vb)
grithonwed|thoughtful, careful; unselfish (adj)
griw|alimentary canel (n)
grod|large excavation, delving, underground dwelling (n)
groga-|to feel terror (vb)
grond (n)|cave, cavern (n)
grond (n, Warfare and Hunting)|club (n)
grond; gronn (adj)|weighty, ponderous (adj)
grondolas; grontholas|oakleaved (adj)
grondos; gronthorn; gronthos|oaktree (n)
grondrui|oakwood (n)
gronduru|oakwood (mat) (n)
groth|cave, tunnel; large excavation, delving, underground dwelling; cave, tunnel, grot (n)
gruim|fierce (adj)
gruin|ruddy (adj)
gruitha-|to terrify (vb)
gruith|deed of horror, angry or violent act, vengeance (n)
grôn|oak, oaktree (adj)
gudh-|to be hot (intr.) (vb)
gudhriol|inflamed, inflammatory (adj)
gudhri|inflammation; conflagration (n)
guin; gwein|*woman (n)
guireb; uireb|eternal (adj)
guir|slow (adj)
guldur [ng-]|black arts, sorcery (n)
gulweg|*Gnomish man (n)
gum-|to lade (vb)
gunn|?dragon (n)
gur; laich; leich|sweet (adj)
gurgof|traitor (n)
gurth [ng-]; gurth(u) (Body Parts and Functions)|death (n)
gurth [ng-]|*death (n)
guru [ng-]|death (abstract) (n)
guruthos [ng-]|dread of death, death-horror, shadow of death, fear of death; fear of death (n)
gu|(together) with (prep)
gwa- (Spatial Relations)|*away (pref)
gwabeth; pethas|sentence, phrase (n)
gwachae|far away (adj)
gwachest|brother and brother, brother and sister, etc. (n)
gwadath(wen)|wandering, journey (n)
gwadoras|union, association, fellowship, society (n)
gwador|(sworn) brother, associate (n)
gwae-|to go, depart (vb)
gwae; gwaew; gwâ|wind (n)
gwaeda-|to enfold (vb)
gwaedh|bond, troth, compact, oath (n)
gwaef|wrap, binding (n)
gwaelphilin|quiver, (lit.) case of arrows (n)
gwaen|stained (adj)
gwaeren|windy (adj)
gwag (Sense Perception)|soft (adj)
gwahae|*far away (adj)
gwain (Body Parts and Functions)|blond (adj)
gwain (Time)|young, *new (adj)
gwaith|people; people, men, folk; people, men, folk; manhood; man-power, troop of able bodied men, host, regiment; region (n)
gwalir (Language and Music)|rhyme, rime (the two actual rhyming words), rhyming poem (n)
gwalir|rime (n)
gwall|excited (adj)
gwalwed|fortunate, happy (n)
gwalwen|fortune, happiness (n)
gwanath; gwanu|death (act of dying) (n)
gwana|fair (n adj)
gwanin|beautiful (adj)
gwanna-|to die, depart (vb)
gwann|dead, (lit.) departed (adj)
gwanod; nath|number (n)
gwanos|family, birth, heredity; family, birth, heredity, *lineage (n)
gwant|beautiful, fair; loveliness (adj n)
gwanunig|twin (n)
gwanuren|of same kindred, akin (adj)
gwanur|kinsman, kinswoman (n)
gwanwen|departed, *gone, lost [to time], past (adj)
gwar- (n)|to yield, give way, surrender (n)
gwar- (vb)|*to dwell (vb)
gwar- (vb, Sense Perception)|to watch (all senses), guard (vb)
gwardhos|m. companion, comrade (n)
gwaren (Mankind)|[nuclear] family (n)
gwaren|family (n)
gwareth|watch, guard, ward; vigilance (n)
gwarieg|watchman, warden (n)
gwarin|circle of trees (n)
gwarth|betrayer (n)
gwass (Physical World)|rush, rushing, noise of rushing, splash (n)
gwass; gwath (Sense Perception)|stain (n)
gwastar|hummock (n)
gwath (Physical World)|shade; shadow, dim light, shade (n)
gwatha-|to soil, stain (vb)
gwathel|[sworn] sister, associate [f.] (n)
gwathra-|to overshadow, dim, veil, obscure (vb)
gwathren|shadowy, dim (adj)
gwathui|*shadowy, of shadow (adj)
gwaun|goose (n)
gwaur|soiled, dirty (adj)
gwe-|you (plural), 2nd-plural pronoun (pron)
gwe; pe|we (inclusive) (pron)
gwedh-|to bind (vb)
gwedh; nûd|bond (n)
gwedhen|oath-bound, allied (adj)
gwedhron|ally, one bound by oath (n)
gwed|*brook, small river (n)
gwef|louse (n)
gwegwin|hermaphrodite (n)
gweg|man, male of the Elda (n)
gweithiad|nation, folk (n)
gweith|people (n)
gwel-|to boil, bubble; to boil; to bubble (intr.) (vb)
gwelch|bubble (n)
gweleb|cool, fresh (esp. of water) (adj)
gweleth|boil, bubble (n)
gweltha-|to squeeze, press (vb)
gwelu|air (as a substance) (n)
gwem; leweg; terch|worm (n)
gweml(i); gwemmel|weevil (n)
gwen; pen|us (inclusive) (pron)
gwend (Emotion)|bond, friendship (n)
gwend (Mankind)|maiden, *young woman (n)
gwendren|maidenly, girlish (adj)
gweneth|maidenhood, virginity; virginity (n)
gwennod|elder tree; elderberry, *(lit.) maiden berry (n)
gwenn|maiden (n)
gwent|big, large; fine (adj)
gwenwi|past, past tense (n)
gwerb(e)lin|top, whirligig, *(lit.) wind-unwind (n)
gweria-|to betray (vb)
gwes(t)|rich (adj)
gwesg (adv adj)|weakly, *weak (adv adj)
gwesg (adv)|weakly (adv)
gwest (Law and Judgment)|oath (n)
gwest; gwîs; nethias|entertainment (n)
gwesta-|to swear (vb)
gweth-|*to report (vb)
gwethlir|song of welcome (n)
gwethriol|welcome, acceptable (adj)
gwi-|twi-, bi-, di- (pref)
gwidhren|adolescent, pre-adult (adj)
gwil-|to sail, float, fly (vb)
gwilbriniol|like a butterfly (adj)
gwilith|air (as a region), *lower sky; breeze (n)
gwiltha-|to air, expose to air (vb)
gwilvrin; gwilwileth|butterfly (n)
gwilwa-|to flutter, flit (vb)
gwilwist|weather (n)
gwilw|quiet, peaceful (adj)
gwimmaf|whale, (lit.) sheep of the waves (n)
gwineb|youthful (adj)
gwingil|foam maiden, mermaid; mermaid, (lit.) foam maiden (n)
gwing|foam, spindrift, flying spray; wave-crest; spindrift, flying spray; wave-crest, crest, foam (n)
gwinig|little-one, baby (n)
gwinn; raef; raew|net (n)
gwinta-; tíra-|to see (vb)
gwiog; gwion; neth|young (adj)
gwir-|to weave (vb)
gwirfin|braid, pigtail, (lit.) woven-tress (n)
gwiril|spindle (n)
gwirtha-|*to not to wish, not mean to, mean not to (vb)
gwirthar|shuttle, (lit.) weave-across (n)
gwirthol|reluctant (adj)
gwirth|unwillingness, reluctance (n)
gwista-|to change, alter, vary (vb)
gwistanneth|alteration, variation (n)
gwistol|changing, varying, variable (adj)
gwist|change (n)
gwithant|shuttle (n)
gwâw; hwaewar; hwâ; wá(wa)|breeze[?] (n)
gwê|living creature, *living being (n)
gwí|just, just now, only just, already (adv)
gwîb|penis (n)
gwîn; nîth (n)|youth (n)
gwîn; pîn (pron)|our (inclusive) (pron)
gythra-|to germinate, be conceived (vb)
gythren|embryonic (adj)
gôf·clochiol|stone-fruit (n)
gôma-|to nickname (vb)
gôr|each, all (adj)
gûl [ng-] (Religion and Beliefs)|black arts, sorcery, (evil) knowledge, magic (n)
gûl [ng-]; saelas (Mind and Thought)|wisdom (n)
gûr|heart (inner mind) (n)
gýda-|to impregnate, make pregant (vb)
hab-|to clothe (vb)
habad|shoe (n)
hach|the hams, buttocks (n)
had-|to hurl, *fling; throw at (vb)
hada-|to throw at, aim at (vb)
hadang|javelin, (lit.) hurling iron (n)
hadh- (Spatial Relations)|to sit (vb)
hadh-|sit (vb)
hadhma-; hadhwa-|to seat (vb)
hadhu|seat, *chair (n)
hadlath; tlaiw|sling (n)
hador; hadron|thrower (of spears and darts) (n)
hadruithog|thirsting for vengeance (adj)
hadruithol|vengeful (adj)
haeda-|to remove, (lit.) make distant (vb)
haedh|fenced enclosure (n)
haena-|to leave, depart, (lit.) be(come) distant (vb)
haered|remoteness, (remote) distance (n)
haeron|*distant (adj)
haer|remote, *distant (adj)
haew|custom, habit (n)
hae|*far; far, (very) far away (adj adv)
hai (Spatial Relations)|there (by him) (adv)
hai (Time)|in good time, punctually, early (adv)
haidra|timely, punctual, in good time (adv)
haidri|forenoon, after breakfast (n)
haid|way, road, path (n)
haim|gone, departed, lost (adj)
hair (adj)|timely, punctual, in good time (adj)
hair (n adj)|left (hand) (n adj)
haith|moist, wet (adj)
hal-|to lift (vb)
halath|skin, fell (n)
haldir|fur-hunter (n)
half|seashell (n)
hall (Physical World)|veiled, hidden, shadowed, shady (adj)
hall (Spatial Relations)|exalted, high (adj)
hallas|height (n)
haltha-|to screen (vb)
hamma-|to clothe, *put on clothes, get dressed (vb)
hammad|clothing, *clothes (n)
hammen|clothed, clad (adj)
hamra-|to abase, abash; to humble oneself (vb)
ham|?chair (n)
hanar; hawn; muindor; tôr|brother (n)
hana|it (pron)
hand|intelligent (adj)
hannas|understanding, intelligence (n)
hannen|seated (adj)
hant|throw, cast; turn or move in games (n)
han|above (n)
haradren; harn|southern (adj)
harad|south (n)
hardúnen|southwestern (adj)
hardûn|southwest (n)
harn (Body Parts and Functions)|wounded (adj)
harn (Spatial Relations)|south, southern (adj)
harna-|to wound (vb)
harnas|harm, damage (n)
harrúnen|southeast (adj)
harrûn|southeast (n)
hartha-; ûna-|to hope (vb)
harthad|hope (n)
haru; harw|wound (n)
harvo|left hand, left side (n)
has-; hath-|close to, by, beside, touching (pref)
hasta-|to hack through, *cleave (vb)
hast|axe-stroke (n)
hathel|broadsword-blade, axe-blade (n)
hathol; peleg; tael|axe (n)
hau-; haw-|to lie (vb)
haudha-|to lay in store; to hoard, save, record; to bury (vb)
haudh|(funeral) mound, grave, tomb; [orig.] †heap, piled mound; grave, tomb; (piled) mound, heap (n)
haug|low (adj)
haust|bed (n)
hav-|to pray (vb)
ha|there you are (interj)
he; hen(e)|she (pron)
heb-|to keep (vb)
hebia-|to delay, retain, keep (temporarily) (vb)
hebwirol|circumspect (adj)
heb|about; ?from, round about, around; round about, around (prep)
hedril|thrower (f.) (n)
hel-|to freeze (vb)
helch|bitter cold, ice-cold, icy (adj)
heledhren|glassy, like glass, of glass (adj)
heledir(n)|kingsfisher, (lit.) fish-watcher (n)
heleg; lhinc|ice (n)
heleth|fur, fur-coat (n)
helfin(n)|icicle (n)
helf|fur, *hide (n)
hellen|frozen (adj)
hell|naked, *stripped (adj)
heltha-|to strip, *flay, peel skin; *to despoil, make bare (vb)
helw|ice-cold, icy, cold (adj)
hemp|a band, bond; cord; band, bond (n)
hen(d); hen(n); hên|eye (n)
hendelu|brow (n)
henia-|to understand (vb)
henna-|to read (vb)
henneth|window (n)
hent|eyesight; eyesight, *(sense of) sight (n)
herdir|master (n)
herf|protection, lordship, sway (n)
heria-|to begin suddenly and vigorously (vb)
heron; hîr|lord, master (n)
herth|household, troop (n)
herven; hervenn|husband (n)
herves; hervess|wife (n)
hesg|withered (adj)
hest|brother or sister, *sibling; †consanguinity; sibling (n)
hethgedwi|twins (n)
hethrin|of the same family (in a close sense), consanguine (adj)
hethu|foggy, obscure, vague (adj)
hich-|to vomit (vb)
hilf|posterity; one’s descendants, progeny, offspring (collective-noun)
hilon|adolescent (adj)
hilvias|inheritance, heritage (n)
him|enduring, continually; steadfast, abiding; ever, enduring, continually; steadfast, abiding (adv adj)
hin; mu; o|from (prep)
hinia-|to stick to, adhere, cleave to, abide by (vb)
hir-|to find, *light on, chance on (vb)
hirilwen|anxiety (n)
hiril|princess, †queen (n)
hiriol|anxious (adj)
hiron|guardian, overseer, lord, master (n)
hirtha-|to care for, mind, tend; to care, reck, mind (vb)
hirthol|careful, attentive (adj)
hista-|to listen, hearken, listen to (vb)
hithlain|mist thread, grey elvish rope (n)
hithren; mith; mithren; musc; thinn|grey (adj)
hithui|misty (adj)
hithu|fog (n)
hiw|sticky, viscous (adj)
ho(n)-|grandson of (pref)
hobas; lonnas|harbourage (n)
hoda-|to lay, stretch out, lay flat on ground (vb)
hogren|lowly, humble, mean (adj)
hol-|to close, shut (vb)
hollen|closed, shut (adj)
holl|cock, cockerel, rooster (n)
honeg; honig|brother (diminutive) (n)
hora-|to await, expect (vb)
horn|driven under compulsion, impelled (to do something) (adj)
horoth|age, eld, oldness (adj)
hortha- (Social Relations)|to urge on, speed (vb)
hortha- (Time)|to grow old (vb)
horweg|an ancient, old man (n)
hosta-|to gather, collect (vb)
host|gross (144) (n)
hothrim; othrim|army (n)
hothron|captain (n)
hoth|folk, people, †army; host, crowd; group plural; host, folk; host, horde (n)
huan|great dog, hound; hound (n)
huar|wild dog (n)
hugin|young pig (n)
huia-|to urge on (vb)
huil|bitch, *female dog; hen (n)
huitha-|it is misty (vb)
humethla; humloth|(red) poppy (n)
hunc|pig (n)
hunn; ordh|boil, pus (n)
huorn|?spirit tree (n)
husta-|to burn (tr.), destroy (vb)
hwand; hwann|sponge, fungus (n)
hwegol|brush (n)
hwegra-|to sweep (vb)
hweg|broom (n)
hwest|puff, breath, breeze (n)
hwiel|niece (n)
hwind|eddy (n)
hwinia-|to twirl, whirl, eddy (vb)
hwiniol|whirling, giddy, mad, fantastic (adj)
hwinn|birch (n)
hwion|nephew (n)
hwîn|giddyness, faintness (n)
hygion; pogron|fututor, *one who copulates (n)
hyriaith|gale (n)
hâdh|*cleaver (n)
hâl; lim|fish (n)
hên (Mankind)|child (n)
hída-|to (come to) pass, happen (vb)
hí|now (adv)
hîl|heir (n)
hîr (Emotion)|care, anxiety; heed (n)
hîr (Social Relations)|master, lord (n)
hîth|mist (n)
húda-|to curse (vb)
hûb|haven, harbour, small landlocked bay (n)
hûd|assembly, *gathering, moot (n)
hûl|cry of encouragement in battle (n)
hûn|*heart; heart (physical) (n)
hûr|readiness for action, vigour, fiery spirit (n)
hû|dog; hound, dog (n)
i (article)|the (article)
i (pron)|who, that, indefinite indeclinable relative particle (pron)
iach|ford (n)
iaeda-|to mock, deride, make fun of, laugh at (vb)
iaeth|neck (n)
iaewen|scornful (adj)
iaew|mocking, scorn (n)
ialla-|to call (vb)
ialtha-|to yoke (vb)
ialt|yoke (n)
ial|*cry, shout (n)
ianna-|to join, connect (vb)
iannen|joined, connected (adj)
iant|bridge (n)
iath; iâth|fence (n)
iaun (adj)|wide, extensive, large, roomy, vast, huge (adj)
iaun (n)|holy place, fane, sanctuary, *shrine, temple (n)
iaur|ancient, old(en); old; ancient, olden (adj)
iaust|crop, *yield, produce (n)
iau|corn, *cereal crop (n)
iav-|to produce, yield, bear fruit (vb)
iavas|autumn, *harvest (time) (n)
iavren|fertile (adj)
iaw|when (conj)
ia|gulf (n)
idanc|masked, *not firm (adj)
idhor|thoughtfulness (adj)
idhraluin|long ago (adv)
idhren|pondering, wise, thoughtful (adj)
idhril|*Man (f.) (n)
idhrinn|year, *(lit.) year-circle (n)
idhrog|*Man (m.) (n)
idhruglin|the language of Men (n)
idir|no king (n)
idra-|to value, prize (vb)
iell; sui|daughter (n)
iesta- (Emotion)|to wish (vb)
iesta- (Time)|to begin (vb)
iestor|first day of the new year (n)
iest|wish (n)
ifant; iphant|aged, having lived long, (lit.) year-full (adj)
ifant|*aged (adj)
il(d)rim|unquiet, disturbance; disease (n)
ilaurui|*daily (adj)
ilgioth|sterility (n)
ilhad|everywhere (pron)
illadui|general (adj)
illad|everything (n)
ilnad|everything (pron)
ilphen|everyone (pron)
ilrimog|uneasy (adj)
ilt(h)a-|to yoke, join (vb)
ilu|universe, the whole, cosmos (n)
ilvrant; ninniach|rainbow (n)
ilwi(n)|sky, heavens (n)
il|*all (adj)
im (n, Physical World)|valley; dell, deep vale (n)
im (n, Religion and Beliefs)|fairy (n)
im (prep)|between (prep)
im (pron)|I; I, I myself; reflexive, self(same) (pron)
imeneth|namesake, (lit.) same name (n)
imladren|vale like, of the vale (adj)
imlad|deep valley, narrow valley with steep sides, gap, gully, dell, glen; dell, deep vale, glen (n)
imm|dell, deep vale (n)
imrad|path or pass between mountains or trackless forest, *(lit.) valley path (n)
imrath|long narrow valley with road or watercourse running through it lengthwise, *(lit.) valley course (n)
in(d)wed|indoors, at home; homely, domestic(ated) (adj)
in-|house of (pref)
inathadren; pennoediad|innumerable (adj)
inc|guess, idea, notion (n)
ind(r)|long, a long time (adv)
indram|shock, (lit.) mind-blow (n)
ind|inner thought, meaning, heart; some particular purpose or intention of an individual; heart [metaphorical], inner thought, meaning (n)
ingem|old (in mortal sense), suffering from old age, decrepit, (lit.) year-sick (adj)
inib|*twelve (cardinal)
inna; int|in home, to its house/its right place (adv)
innas|*will (n)
inni|home, at home, in right place (adv)
innor|master (of house), lord (n)
innos|house, hall (n)
inn|house, abode; inner thought, meaning, heart; some particular purpose or intention of an individual (n)
intha-|to go (indefinite), fare, proceed (vb)
inthi|less (adv)
inu|female (adj n)
inwas|feminity, womanhood (n)
inwathren|feminine (adj)
in|go, move, turn, occasion (n)
iofog|fruit drink, cider (n)
iolf|brand (n)
ion(n)|son, *boy (n)
iorbeth|archaism, archaic word (n)
io|ago (adv)
ir (conj)|?when, while (conj)
ir (prep)|dative and allative (prep)
irdh|entrails, bowels, innards (n)
irm|a wish, intention, resolve (n)
irn|desired, wished for (adj)
irtha-|to peck (vb)
irtha|her (pron)
irthod|intent, intention, will (n)
irthol|intentional (adj)
irth|beak (n)
ist (Emotion)|feeling, sensation; notion (n)
ist (Mind and Thought)|lore, knowledge (n)
ista-|to have knowledge, know; to know, be aware, perceive, feel (vb)
istui|learned (adj)
ith; itheg|anything (n)
ithildin|*moon-star; magical alloy that glows in moonlight, (lit.) moon-star (n)
ithog|any (adj)
ithrin; ithriol|of any kind (adj)
ithron|Wizard (n)
ithweg; ithwin|anyone (n)
iuitha-|to employ (vb)
iuith|use (n)
ivangod; ivongod|walnut (n)
ivil|inside (n)
ivogodron|walnut tree (n)
iâd|waist; isthmus (n)
iâf|fruit (n)
iâ|chasm, pit; void, abyss; gulf (n)
iôr|course (n)
iûl|embers (n)
l(h)ô|flood, fenland (n)
laba-|to hop (vb)
laboth|a hare; hare, *rabbit (n)
labra|loose, lax, flapping; weak (adj)
lacha-|to flame (vb)
lach|(leaping) flame (n)
lad (Physical World)|plain (n)
lad (Quantity and Number)|nothing, zero (n)
lad (Spatial Relations)|a level, a flat; fair dealing (n)
lad-|to stretch, extend (in length) (vb)
laden (Spatial Relations)|flat, wide, *level; open, cleared; fair, equitable (adj)
laden|flat (and wide) (adj)
ladog|tin; tin [metal] (n)
ladwen|levelness, flatness; plain, heath; plane; surface (n)
laeda-|to refresh, revive (vb)
laegas|verdure, greenness (n)
laeglin(n)|greenfinch (n)
laeg|green, viridis, green (of leaves/herbiage), fresh; keen, sharp, acute (adj)
laew (Quantity and Number)|frequent, many (adj)
laew (Time)|fresh (adj)
laeweth|freshness (n)
lae|great number (n)
laf; laph|loose-end, end of rope, hem of robe (n)
lagor|swift, rapid (adj)
laidh|horizontal, (lit.) lying flat (adj)
lain (adj)|free(d), *liberated (adj)
lain (n)|thread, warp (n)
laithra|dead and gone, over, former, of yore, forgotten (adj)
laith|*lost (adj)
lalaith|laughter (n)
lallen|funny, amusing (adj)
lall|laugh (n)
laltha-|to amuse, make laugh (vb)
lalweg|cheerful (adj)
lam (Language and Music)|(physical) tongue; language; tongue, speech (n)
lam (Sense Perception)|echo (n)
lamel|phonetics (n)
lamengolu|linguistics (n)
lamma-|to echo (vb)
lammad|*echoing (n)
lammen|of tongue, spoken with tongue (adj)
lanad|weft, woof (n)
lanc (n)|sharp edge (not of tools), sudden end (n)
land|broad; wide, broad; open space, level (adj)
lang (Body Parts and Functions)|passage; neck, *throat (n)
lang (Warfare and Hunting)|cutlass, sword (n)
lang-|to blare, clang, ring (vb)
langan(d)|stringed instrument with a neck (lute, guitar, etc.) (n)
lann (adj)|wide, broad (adj)
lann (n)|thin cloth, tissue (n)
lann; lhann|broad (adj)
lanthir; âch|waterfall (n)
lant|clearing in the forest (n)
lanu|loom (n)
laptha-|to relax, loosen (vb)
larm|elm, elm-wood (n)
las-|to look at, glance at (vb)
las; lhas|leaf (n)
lasbelin (Time)|leaf-fall, autumn (n)
lass|leaf; leaf; petal (n)
lasta-|blink, wink; to listen, give ear (vb)
lastadui|audible (adj)
lastad|listening, hearkening, attention (n)
lasto|listen, *hark (interj)
last|(sense of) hearing (n)
lathr(ad)a-|to listen in, eavesdrop (vb)
lathron|hearer, listener, eavesdropper (n)
lath|thong (of leather) (n)
laub|shirt (n)
laudh (Body Parts and Functions)|gluttonous eating, †licking up (food or drink); licking up (food or drink), gluttonous eating (n)
laudh|gluttonous eating (n)
laug|warm (adj)
laur|threatening, foreboding, darkling (adj)
lav-|to lick (vb)
lavan|animal (n)
lavra-|to lap (of animals), suck up (vb)
law; lin|sound (n)
le (prep)|and (prep)
le (pron)|thee, you (polite) (pron)
leb-|to pick, pluck, take or feel or touch with fingers, cull (vb)
lebdas; tas|index finger (n)
lebenedh|middle finger (n)
lebent|fourth finger (n)
leben|five (cardinal)
leberen; lepthindros|fingered, of fingers (adj)
leber|finger (n)
lebethron|Gondorian hardwood, *(lit.) finger tree (n)
lebig; niged|little finger (n)
lech|smooth place; slide (n)
lectha-; maegra-|to sharpen (vb)
ledh-|to go, *travel, journey (vb)
ledia-|to open; unlock (transitive) (vb)
ledil|key (n)
lefnui; levnui|fifth (ordinal)
legol|[Ilk.] nimble, active, running free (adj)
leg|keen, sharp, piercing (adj)
leidhron|liberator, saviour (n)
leinas|freedom, liberty (n)
leithia- (Possession and Trade)|to release, set free (vb)
leithia-|to release (vb)
leithian (Possession and Trade)|release from bondage, release, freeing (n)
leithian|release from bondage (n)
lembas|waybread; waybread, journey-bread (n)
lemfin|halved, in half (adj)
lemma-|to beckon, crook the finger (vb)
lempachùn|wishbone (n)
lendri; toled|coming, arrival (n)
lend|tuneful, sweet (adj)
lenia-|to sound, make a noise (vb)
lenthol|coming, approaching (adj)
lenwin|‘arrival’, a stranger (fem.) (n)
lephaen|fifty (cardinal)
lest|girdle, *belt (n)
lethril|hearer, listener, eavesdropper (f.) (n)
lethrin|slippery, peril(o)us (adj)
leth|therewith, with it, withal (adv)
leutha-|to pick (up/out) (vb)
lhab-|to sup, *sip (vb)
lhab|sip (n)
lhaden|flat, smooth (adj)
lhaew|sickly, sick, ill (adj)
lhain|lean, thin, meagre (adj)
lhalwen|elm-tree (n)
lham(b)|tongue (n)
lhassa-|to hear (vb)
lhaw|ears (of one person) (n)
lheweg|ear (n)
lhid-|to sort out, sift, sieve, discriminate (vb)
lhig-|to creep, sneak, do or go by stealth (vb)
lhim(p); limp; mesc; mesg; nenui (adj)|wet (adj)
lhim|sliding, gliding, slippery, sleek (adj)
lhind (n)|arrow (n)
lhind; thlind (adj)|fine, slender (adj)
lhing|spider’s web, cobweb (n)
lhinnas|slenderness, thinness (n)
lhoeg|keen (adj)
lhoereb|venomous, poisonous (adj)
lhoer|venom, poison(ousness) (n)
lhoew|poison(ous substance) (n)
lhongannas|phonology, (lit.) shapes of sounds (n)
lhongant|allophone, surface sound, (lit.) sound-shape (n)
lhossa-|to whisper, rustle (vb)
lhui; nimp|pale (adj)
lhunc|pharynx, gullet (n)
lhuth|magic, spell (n)
lhê|fine thread, spider filament (n)
lhîd|sieve (n)
lhîw|sickness, disease (n)
lhôn|noise; *phone (in linguistics), speech sound (n)
lhûg|reptile, snake, serpent, worm, *lizard; dragon (n)
lhýda-|to make sick, sicken (vb)
lillir|a song, lullaby (n)
liltha-|to dance (vb)
lilt|dance (n)
lim (adj)|*swift; quick, swift (adj)
lim (n)|sheaf, bundle (n)
limfelis|drink of the fairies (n)
limig|[small] drop; drop of water (n)
limlug|fish-dragon, sea-serpent (n)
limmeg|young fish, small fry (n)
limmid(a)-|to moisten (vb)
limp (adj n)|clear, sparkling; (bright/clear/gleaming) liquid (adj n)
lind|song, chant, singing (n)
linna-|to sing, chant (vb)
linnas|music (n)
linnathren|musical (adj)
linnod|type of poetic meter, (lit.) ?seven-chant (n)
linnor|singer (n)
linn|song, chant (n)
linthanin|playing or music of instruments (n)
liscaloth|reedy, reed grown (adj)
lisg|reed, sedge (n)
lissuin|a fragrant flower (n)
liss|fragrant, sweet (adj)
lista-|to show grace, kindness (vb)
listo|please! (interj)
list|grace, favour, kindness (n)
lithin|bygone, ended (adj)
lithra-|to cease speaking, become silent (vb)
lithui|ash[en]; ashen, ashy, of ash, ash-coloured, dusty (adj)
lith|ash; sand; sand (n)
liv-|to drip (vb)
lo (conj)|while (conj)
lo (n)|flood (n)
lob-|to gallop, *lope; to run, gallop (of animals) (vb)
lobor|[heavy riding] horse (n)
lobrob|gallop; sound of horse’s feet (n)
loch|ringlet (n)
loda- (Body Parts and Functions)|to swallow, gulp down (vb)
loda- (Motion and Transportation)|to float (vb)
loen|soaking wet, swamped (adj)
loetha-|to curl, bend, wind, twine (vb)
loeth|twist, tendril, spiral, coil (n)
loew|moss (n)
log-|to haul, drag (vb)
logra-|to stoop, bow, cower; to submit (vb)
logren|curled, curly, *bending, looping (adj)
logrifidhrin; logrifindel|curly haired (adj)
logweg|meandering, twisting, winding; intricate; (lit.) apt to bend (adj)
lom|weary, *tired (adj)
lonc|curl (n)
lond|(land-locked) haven; narrow path, strait, pass (n)
lonn|(land-locked) haven; pass (n)
loph|nugget, (small) chunk, clump, tidbit (n)
lor-|to sleep deep, dream (tr.); to sleep, slumber (vb)
lorn|asleep (adj)
lortha-|to put to sleep, send to sleep (vb)
losbas|ryebread (n)
losc; losg|rye (n)
loss (Physical World)|snow (n)
lossen|snowy (adj)
loss|blossom, bloom (n)
lost; nil|empty (adj)
losta-|to bloom, blossom (vb)
lostad|blooming, florescence (n)
lothalan|raft, (lit.) floating platform (n)
lotheg|single [small] flower, *floret (n)
loth|flower, lily; flower, single blossom; inflorescence, head of small flowers (n)
loven|echoing (adj)
luig|minute, moment (n)
luin|blue (adj)
luithia-|to quench (vb)
lui|blueness, livor, livid mark; blueness; livor, livid mark, *bruise (n)
lulwi|a lullaby (n)
lumba|overcast (adj)
lummor|foul weather (n)
lumren|shady, overcast (n)
lum|cloud; shade, *a thing blocking light; [dark] cloud (n)
lung (adj)|heavy; grave, serious (adj)
lung (n)|heavy (n)
lung (n, Sense Perception)|heavy; grave, serious (n)
lungra-|to weigh, bear on, hang heavy (vb)
luntha-|to balance, weigh (vb)
lunthang|balance, scales (n)
lunt|boat (n)
lur-|to frown, scowl (vb)
lurc|a frown, scowl (n)
lurlos|poppy, (lit.) flower of sleep (n)
luv-|to hang, lower (of clouds) (vb)
lu|occasion, time (n)
lígu|candle (n)
lín|*thy (pron)
lítha-|to let slip, lose, mislay; (intr.) to be lost; forget (vb)
lîdh|journey (n)
lîf|link, *joint (n)
lîg|wax (n)
lîn|pool, mere (n)
lîr; tî|line, row (n)
lî|folk, many people, ‘they’, a crowd of folk; people (of one kind or origin) (n)
lóran|seasonal year, (lit.) growth-cycle (n)
lôda-|to smooth out, stroke, caress, soothe, beguile (vb)
lô|pool, lake (n)
lúda-|to pass (of time); to come to pass, occur, *happen (vb)
lútha-|to enchant (vb)
lúthad|enchantments, sorcery (n)
lûb|fat, (fat) flesh (n)
lûg|bend, loop, wind, twist; guile, deceit (n)
lûr|sleep, slumber; slumber (n)
lûth (Agriculture and Vegetation)|blossom, inflorescence [on a single plant] (n)
lûth (Religion and Beliefs)|spell, charm, magic (n)
lû|time, occasion (n)
lŷg|snake (n)
mab (Body Parts and Functions)|hand(s) (n)
mab-|to seize, *grasp, grab (vb)
mabed-|to ask [a question] (vb)
mablanthos|sycamore (n)
mablod|palm of the hand (n)
mabrenas|dexterity (n)
mabren|handed, having hands, dextrous (adj)
mab|grasp (n)
mad-|to eat (vb)
madha|mud (n)
madheg|something (n)
madhias|softness, pliancy (n)
madhin|some (adj)
madhir|someone (f.) (n)
madhon|someone (m.) (n)
madhren|muddy (adj)
madriol|edible, fit for food, wholesome (adj)
madui|edible (adj)
madweg|gluttonous (adj)
mae (adj)|soft, pliant (adj)
mae (adv adj)|well; excellent, admirable (adv adj)
maeas|dough (n)
maecheneb|sharp-eye[d] (adj)
maed (Emotion)|shapely, *pretty (adj)
maed (Physical Acts and Materials)|handy, skillful, skilled (adj)
maedol|welcome (adj n)
maeg|piercing, sharp, *penetrating (adj)
mael (adj)|well (adj)
mael (n adj)|stain; stained (n adj)
mael (n)|lust (n)
maeligeb|wealthy, rich (adj)
maelig|wealth, abundance (n)
maelui|lustful (adj)
maen (adj)|skilled, clever (adj)
maen (n)|a treasure (n)
maenas|craft, handicraft, art (n)
maenor|craftsman (n)
maeras|goodness (n)
maeron|artist (n)
maer|good, excellent, fair; useful, fit, good (of things); useful, fit, good (of things) (adj)
maeth (Social Relations)|management (n)
maeth (Warfare and Hunting)|fight, battle (n)
maetha- (Physical Acts and Materials)|to handle, wield, use, manage, treat, deal with (vb)
maetha- (Warfare and Hunting)|to fight (vb)
maethas|control, *authority (n)
maetheb|having control or authority (adj)
maethon|snuffling (adj)
maethor|warrior (n)
maew|gull (n)
maf|sheep (n)
maga-|to forge metal (vb)
magor|swordsman (n)
magradh-|?to smell (vb)
maidhon|midday (n)
maidh|pale, fallow, fawn [light yellowish tan colour] (adj)
maien; mairien|better (adj)
maimelion|dearly beloved (adj)
main (adj)|prime, chief, pre-eminent (adj)
main (adv)|better (adv)
maint|*better (adv)
mairos|mane, long hair (n)
mair|precious (adj)
maithod|rapture (n)
maith|goal, intention (n)
mai|well (adv)
malcwed|lordly, noble, mighty (adj)
malen|pale, wan, yellowish, sickly; yellow, yellowish (adj)
mallen|of gold (adj)
mallorn|gold tree; gold tree, yellow tree (n)
mallos|golden flower (n)
mallú|when, (orig.) what time (adv)
malthen|of gold [metal] (adj)
malthos|butter cup (n)
malt|gold (as metal) (n)
malu|fallow, pale (adj)
mam|grandmother; grandmother, mother (n)
manadh|doom, final end, fate, fortune; final bliss (n)
manc|grip, grasp, hold (n)
mang|butter (n)
mann; math|food (n)
man|*what, who (pron)
mar(o)n|ripe (adj)
mara|sand (n)
marn|?ripe (adj)
maroglin|yellow song, daffodil (n)
masta-|to [put to] feed, graze; to feed, graze (vb)
mastir|*shepherdess (n)
mast|feed, food, nourishment; fodder; fodder, feed (n)
matha-|to stroke, feel, handle (vb)
mathad|handling, feeling, stroking, caressing; appraising, assay (n)
maudra-|be early, come first; to prefer, to be preferred (vb)
maudrin; maurin|early, betimes, up early; premature (adj)
maudri|early morn before dawn, time before first meal (n)
maudro|sooner, earlier; rather (adv)
maul (Animals)|the lowing of cattle, bellowing (n)
maul (Food and Drink)|flour (n)
maur|gloom (n)
maus|pleasure; pleasant taste, pleasant (n adj)
mau|soon, early (adv)
mav-|to like (vb)
mavor|appetite (n)
mavras; mavros|desire, eager longing (n)
mavren; mavrothwed|delectable, delightful, desireable (adj)
mavron|shepherd, herdsman (n)
mavuin; mavwen; mavwin|ancestress, †mother (n)
mawedh|glove (n)
mawr; môr (adj)|good (adj)
maw|soil, stain (n)
ma|good, excellent, that’s right (interj)
me-|we, 1st-plural pronoun (pron)
mechor; naith|gore (n)
medhia-|to knead, soften (vb)
media-|to feed (vb)
medion|eater, feeder (n)
medlin|*bear-like (adj)
medlivorn|blackbear (n)
medli|bear, (lit.) honey-eater (n)
medui|end, final, last (adj)
megil|sword, longsword; †sword (n)
megr|sharp-pointed (adj)
meg|any small animal; (esp.) mole (n)
meidianweb|worthy of being eaten (adj)
mein; minui|first (ordinal)
meiras|value, preciousness (n)
meitha-|to aim at, *have as a goal (vb)
meithas|meaning (n)
mel-; mela-|to love (vb)
melch|greedy (adj)
meldir|friend [m.] (n)
meldis|friend (f.) (n)
melethel|darling, sweetheart (n)
melethor; melethril; melethron; seron|lover (n)
melethril|lover (f.) (n)
melethron|lover (m.) (n)
meleth|love (n)
melillin|daffodil, (orig.) yellow song (n)
melingarn|orange, tawny (adj)
mellavan|pet, (lit.) love-animal (n)
mellon|friend (n)
mell|dear; dear, beloved (adj)
meltha|dear, beloved (adj)
melui|lovely, sweet (adj)
men (n, Motion and Transportation)|road, way (n)
men (pron)|us (pron)
men-|to go (vb)
men; sad (n, Spatial Relations)|*place (n)
meneg|thousand, *large in number (cardinal)
menel|*the heavens; the heavens, firmament, region of the stars (n)
mengui|thousandth (ordinal)
menna-|to send, (lit.) make go (vb)
ment (Language and Music)|message (n)
ment (Spatial Relations)|point (n)
mer-|to hope, wish, desire, want (vb)
meren|festive, gay, joyous (adj)
mereth|feast, festival (n)
merifind|Black-haired (adj)
meril|rose (n)
mertha-|to gladden, make happy (vb)
meru|valuable, worthy (adj)
meth (adj)|last (adj)
meth; methed (n)|end (n)
methal|footstep (n)
me|we (exclusive) (pron)
mib-; mítha-|to kiss (vb)
mib|(little) kiss, peck (n)
midh|mist, drizzle (n)
miginthi|littleness (n)
migligen; tidig|little (of amount) (adj)
milbar|dear home, beloved dwelling [place] (n)
milf|greed (n)
milt|semen (n)
milui|friendly, loving, kind (adj)
mim|gum (n)
min (cardinal)|one; one, single (cardinal)
min (n)|peak (n)
minai|distinct, unique, single (adj)
minas|tower, fort, city (with a citadel and central watch tower) (n)
mindon|tower; tower, isolated hill (especially a hill with a watchtower) (n)
minib|eleven (cardinal)
minlamad|?alliteration, (lit.) first-echoing (n)
minna-|to enter; to go in, enter (vb)
minn|?one (cardinal)
minol|ingot (n)
mintha|ūna, in one place, together (adj)
minuial|(dawn) twilight (n)
mirian|Gondorian coin (n)
mirith|jewelry (n)
mirtha-|to value, esteem, treasure, cherish (vb)
miruvor|a special wine or cordial (n)
miru|wine (n)
mirwelthen|vintage, *(lit.) wine pressing (n)
mirybin|grape, (lit.) wine-berry (n)
mista-|to stray about (vb)
mistrad|straying, error (n)
mist|error, wandering (n)
mithril|*true-silver; Moria-silver, true-silver (n)
mith|grey, light grey, pale grey (adj)
mivan|where, (lit.) in/at what (adv)
mi|*in (prep)
modog|*a large number (adj)
modra-|count, measure (vb)
modri|measurement (n)
modrog; modron|rich man (adj)
modwen|a large number (adj)
mod|a number, figure (n)
moir|goods (n)
mol-|to grind, pulverize (vb)
molif|wrist, (lit.) hand-link (n)
molnel|molar (n)
molor|mill (n)
morchant|shadow cast by light, (lit.) dark shape (n)
mord|man, warrior; †shepherd (n)
morgul|black arts, sorcery, necromancy; sorcery (n)
morn (adj n)|black, dark (adj n)
morn (adj)|black, dark; dark, black (adj)
morn; môr (adj, Sense Perception)|black (adj)
mornechui|coffee (n)
mothren|dusk, dusky (adj)
mothwen|1000; †flock (n)
moth|dusk (n)
movan|how, (lit.) by means of what (adv)
mo|by (agent of) (prep)
mu; mutha|will, am going to, am about to (prep)
muda-|to labour, toil, *work (vb)
mug-|to keep silent, say nothing (about) (vb)
mugol|taciturn (adj)
mui (Food and Drink)|crumb (n)
mui; muig (n)|cat (n)
muia-|to whine, moan, whimper, caw, meow (vb)
muig (adj)|soft, gentle (adj)
muil|drear[iness] (n adj)
muin (adj)|dear (adj)
muin (n)|kine, cattle (n)
muinos|security (n)
muinthel; nethel; nîth; thêl|sister (n)
muint|best thing (n)
muir; muthli|heifer (n)
muis|softness, tenderness, gentleness (n)
mul-; mum-|to low, bellow (vb)
mumla-|stammer, gibber (vb)
mumloth|stuttering (n)
mumol|stammering, gibbering, inarticulate (adj)
munc|shut mouth, silence, secretiveness; (aj.) mum (n)
mund|bull (n)
munneg|calf (n)
munnost|byre, cowhouse (n)
murc|a nightmare, vision of the night (n)
muthra-|to veil (vb)
mâd|meal (n)
mâf|pile or mass of rock or earth (n)
mâl|pollen, yellow powder (n)
mân|departed spirit (n)
mínem|movie, motion picture (n)
mín|our (pron)
mírad|treasury, hoard (n)
mírdan|jewel smith (n)
míria-|to sparkle like jewels (vb)
míriel|sparkling like jewels, like a jewel (adj)
mîdh|dew; dew, *moisture, damp(ness) (n)
mîg|among (prep)
mîl|love, affection (n)
mîn (Motion and Transportation)|motion (n)
mîn (Spatial Relations)|[thing] between; gap, space, barrier; anything intervening between two other things (n)
mîr|jewel, precious thing, treasure (n)
mîw|small, tiny, frail (adj)
mî|(to the) inside; into (adv prep)
môl|the (inside of the) mouth (n)
môna; môni|spirits of the air (n)
môn|bare hill, knoll (n)
môr (n)|dark(ness); †night (n)
mútha-|depart, go, leave; (c. gen.) leave the place of/time of/speaker, go forward (vb)
mûg|dung (n)
mûl|slave, thrall (n)
mûm|lowing (n)
mûn|womb (n)
na (Grammar)|of; with, along with, accompanied by, provided with or by, associated with, marked with; by; with, by; of (prep)
na (Spatial Relations)|to, towards, at (prep)
na(n)|of; provided with or by, associated with, marked with (prep)
na-|to be (vb)
nab-|to take, lay hold of (vb)
nabant|almost, (lit.) towards full (adv)
nabas; naboth|seizure (n)
nabor; naw|booty (n)
naden|until, up to, as far as (prep)
nadh-; nag-|to chew, gnaw (vb)
nadha|fetter (n)
nadhor; nadhras|pasture (n)
nadren|real; possible (in sense possible to exist or think of) (adj)
nad|thing (n)
naeag|goat (n)
naeda-|to oppress, cause great grief to (vb)
naedh|wounding, wound (n)
naed|true, real (adj)
naegos|anguish (n)
naegra-|to pain (vb)
naeg|pain (n)
naena-|to lament, wail for, make moan for (vb)
naeras|sorrow, woe (n)
naergon|woeful lament (n)
naer|dreadful, horrible, unendurable; lamentable (adj)
naeth (Body Parts and Functions)|biting, gnashing of teeth (n)
naeth (Emotion)|woe; biting, gnashing of teeth (n)
naew|jaw (n)
nae|alas (interj)
naf-|to suspect, have inkling of (vb)
nafa; nôf|suspicion, inkling (n)
nafol|suspicious (subjective) (adj)
nafra-|to nose about in others’ business (vb)
nag-|to bite (vb)
nagnel|incisor (tooth) (n)
nail; nelui|third (ordinal)
naithol|miserable (adj)
naithonwi|misery (n)
naith|spearhead, gore, wedge, narrow prominitory; angle (n)
nala|(yellow) lily (n)
nalla-|to cry (vb)
nalla; nallan; nallar; nalloth|call (n)
nam-|withdraw, draw out, draw back, take back; (intr.) withdraw, retire (vb)
naman|how, (lit.) with what (adv)
nan(d)|vale, valley, dale; wide grassland (n)
nana|mother (hypocoristic), *mommy (n)
nanc|bite (n)
nand; nann (Agriculture and Vegetation)|field acre (n)
nand|dale (n)
nann (Physical World)|dale; wide grassland (n)
nanu|truth (n)
nanweg|*farmer (n)
nanwen|true (adj)
nara-|to tell (vb)
narcha-|to rend (vb)
narch|bitter-biting (adj)
narcos|rot, decay (n)
nardh|knot (n)
narn|tale, saga (n)
narog|violent (of water, rain, etc.), torrential (adj)
narphen|character [in a story] (n)
nartha-|to kindle, *ignite, inflame, set fire to (vb)
narthan|beacon (n)
narthiel|fragrance (n)
narthol|fragrant, odorous (adj)
narth|list, (lit.) product of recitation (n)
naru|[fiery] red (adj)
narvaenas|firework (n)
nass|point, (sharp) end; angle, corner (n)
nasta-|to prick, point, stick, thrust (vb)
nast|being (abstract); being (creature); being (used for both a creature and the state of existence) (n)
natha-|to bring help to, save, rescue (vb)
nathal|guest (n)
nathanwi|fatherhood (n)
nathla-|to welcome (vb)
nathol|affable, kindly, welcoming (adj)
nathren|welcome, acceptable, agreeable (adj)
nathron|weaver, webster (n)
nath|web (n)
naub|thumb (n)
naud (adj)|bound (adj)
naud (n)|treasure (n)
naudra-|to abash, to make ashamed (vb)
naug|dwarf; dwarf; dwarf(ed), stunted (n)
nauin|dwarf (adj)
naur (adj)|ill-tempered, sour, grumbling (adj)
naur (n, Emotion)|a snarl, ugly grin (n)
naur (n, Physical World)|fire; flame (n)
naus|keen-witted, observant; notice (adj n)
nautha-|to conceive (vb)
nauth|thought (n)
navan|where, whither, to where, (lit.) at/to what (adv)
naw (interj)|yes (interj)
naw (n)|idea (n)
ne-|in (pref)
nectha|honey comb (n)
nederphaen|ninety (cardinal)
neder|nine (cardinal)
nedh-|mid- (pref)
nedhor|mid-day, noon (n)
nedhu; nef|bolster, cushion (n)
nedhwad|lunch, (lit.) middle-meal (n)
nedia-; nod-; nœdia-|to count (vb)
nedrui|ninth (ordinal)
ned|*one more (n)
nef|hither, on this (the speaker’s) side of; †beyond [loose translation]; *near (prep)
negen|sharp, angular (adj)
neibio|nearly, almost (adv)
neitha-|to wrong, deprive (vb)
neithan|one deprived, exile whose rights and goods have been confiscated (n)
nel-|tri- (pref)
neldor|beech (n)
neledh-|*to go in, enter (vb)
neledh|three (cardinal)
neleg; nêl|tooth (n)
nelio|buckwheat (n)
nella-|to sound (of bells), *ring (vb)
nelladel|ringing of bells (n)
nellad|sound of bells, ringing (n)
nelluin|bluebell (n)
nell|bell (n)
nelphaen|thirty (cardinal)
nelthil|triangle (n)
nel|point, end, tip, jutting end (n)
nem (adj)|seeming, evident, probably but not necessarily so (adj)
nem (n)|nose (n)
nemmas|evidence (n)
nen(n)|water, river, stream; water; river (n)
nendil; nennil|waterfay (n)
nend|watery (adj)
nennibis|waterlily, (lit.) water snowflake (n)
nen|water; water; lake, pool; (lesser) river, stream (n)
nepheg|mid-point, (lit.) mid-spot (n)
nermil|a fay that haunts the meadows and riverbanks (n)
ness|*headland; (water) meadow; long grass; water meadow; long grass (n)
nest; nesta; nethra|?heart, core (n)
nesta-|to heal (vb)
nestad|healing (n)
nestag-|to insert, stick in (vb)
nethan-|to inspire, kindle inside (vb)
nethia-|to entertain, (orig.) to make welcome (vb)
nethig|sister, girl (diminutive) (n)
nethor|herd, flock (n)
neth|(little) girl (n)
nev-|to seem, appear (vb)
nevia-|to localize, bring close, translate (into your own language), translate (into another language when used with the dative case) (vb)
nevra-|to face, go forward (vb)
nevui|nearly (adj)
neðw|scarred, bruised (adj)
ni (prep)|without (both senses) (prep)
ni (pron)|I (pron)
ni-|I, 1st-singular pronoun (pron)
niben|petty, *small (adj)
nibis|snowflake (n)
nich|frost (n)
nidh-|to will (vb)
niel; siel|granddaughter (n)
nifredil|(green) snowdrop; *(lit.) pale point (n)
nifred|pallor, fear (n)
nigol|mouse, (lit.) small one (n)
nigren|stealthy, (orig.) mouse-like (adj)
nigrim|to swarm (n)
nilta-; niltha-|to empty (tr.) (vb)
nimmas|whiteness (n)
nimmid(a)-|to whiten (vb)
nimp|pale, pallid, white; small and frail, wan, sickly; pallid; wan, pale, sickly (adj)
nim|white (adj)
nind; ninn|blue stone, turquoise (n)
ninghonin|*snowdrop (n)
ninglor|golden water-flower, *yellow iris (n)
niniel|tearful (adj)
ninion|water lily (n)
ninna-|to weep; to weep, *cry (tears) (vb)
nin|me (pron)
nion|bee; grandson (n)
niosturwin|queen bee (n)
niphredil|white flower (similar to a snowdrop); *(lit.) pale point (n)
niphred|pallor; fear (n)
nirnaeth|tears, lamentation (n)
nir|grandchild of (pref)
nista-|to press, thrust, force (in a given direction) (vb)
nivol; nîf|phantom, a seeming (n)
niwrim|swarm (n)
no-|re-, back, again (pref)
nobad|thumb and index finger as a pair, *(lit.) pickers (n)
nobra-|to follow, go after (vb)
nobromath; nuimoth|‘second twilight’, first signs of dawn (n)
nobron|the second, next following (n)
nod-|to tie (vb)
noden|prone, face down (adj)
nodro|farther on, further forward, later, again (adv)
nodui|some, few, several (adj)
nod|forward, on, in advance (adv)
noen|wise, sensible (adj)
nogen|boy, lad, urchin; *(orig.) short (of persons) (n)
nogra-|to excell, exceed (vb)
nogriol|excellent, conspicuous (adj)
nontha|the next, the succeeding (time only) (adj)
nor-|*to run; to run (or leap) of animals or men; to roll [of vehicles]; to run, roll (vb)
nordh|cord (adj)
norn (adj)|twisted, knotted, crabbed, contorted (adj)
norn (n)|wheel (n)
norna-|to complain of (vb)
nornad|complaint (n)
noroth|giant (n)
northa-|to make run, *ride; to send rolling [as a vehicle], speed; to send rolling, speed (vb)
north|riding, race (of people running), charge or gallop (n)
norweg|often running (adj)
nos(s)|family, kindred, clan, house; race, tribe, people (n)
noss (Social Relations)|clan, family, ‘house’ (n)
noss; oronnad|birthday (n)
nosta-|to smell (vb)
nos|kin, people (n)
noth (adj)|damp, wet (adj)
noth (n)|rain (n)
nothlir|folk, family (n)
novaer|goodbye, farewell, (lit.) be well (interj)
no|then, next, again; then, after(wards) (adv)
nufleg; nuthleg|keen-nosed (adj)
nufli; nufri|sense of smell (n)
nuicha-|to take notice, perceive; *(orig.) to smell [something] (vb)
nuidro|still later (adv)
nuinvrond|steadfastness (n)
nuin|mind, thought (n)
nuir; orvedui|yesterday (n)
nuitha-|to stunt, prevent from coming to completion, stop short, not allow to continue (vb)
nui|before (of time) (prep adv)
nunna-|to incline head, bend face down, *nod; to assent, *agree (vb)
nuru-|to growl, grumble (vb)
nusiothli|sagacity (n)
nu|under (prep)
nâla|yellow-lily (n)
nâr|rat (n)
nída-|to weep, cry (tears) (vb)
nídha-|to be determined to (vb)
nín|my (pron)
nírnaeth|lamentation (n)
nírol|sad, sorrowing, *sorrowful (adj)
nítha- (Physical World)|to snow, hail (vb)
nítha- (Spatial Relations)|to reduce, make small (vb)
níthannen|reduced, minor (vb)
níwost|hive (n)
nî-|was (vb)
nîdh (Food and Drink)|honeycomb (n)
nîdh (Mind and Thought)|full vigorous purpose, exertion of will (n)
nîd|damp, wet; tearful (adj)
nîf (Spatial Relations)|front, face (n)
nîn (adj)|wet, *watery (adj)
nîn (n)|tear; weeping (n)
nîr|grief, sorrow; tear; weeping, grief, sorrow (n)
nîw|bee (n)
nî|once, at one time; was (adv)
nîð|hurt, bruised (adj)
núnad-|to wester (vb)
núnadol|westering (n)
nún|sinking, going down; west (n)
nûr (adj)|deep (adj)
nûr (n)|race (n)
nŷw|noose, snare (n)
o(r)dhraust|without work, workless (adj)
o(r)ngolodh|without gnomes (adj)
o-|he (conj)
obin|second, next (adj)
obron|*next (adv)
obruith|(evil) consequences (n)
ochui; odothui; othui|seventh (ordinal)
och|egg (n)
od; og|sharp corner (n)
odhril|parent (f.) (n)
odhron|parent (n)
odinthos; paenodog|seventeen (cardinal)
odlad; oglad|week (n)
odo; odog (cardinal)|seven (cardinal)
odog (adj)|mighty, great; violent, excessive, exceeding, very; much, abundant; large in quantity (adj)
odophaen|seventy (cardinal)
odra-|am able, can (vb)
odrim|(very) many (adj)
odrog; odron|dour, mighty, stout, brave; a brave man (adj n)
oel|cool (adj)
oer|nasty (adj)
oetha-|to lay eggs, nest (vb)
oew|an evil deed (n)
oglas|wickedness, *evil (n)
ogod|knee (n)
ogol|bad, evil, wrong; gloom(y) (adj)
ogra-|to be able, can (vb)
ogra|able to (prep)
ogriol|possible (adj)
ogron|wicked or evil person (n)
oith|feud (n)
ol-|to pour (vb)
ol; ôla|cliff, seaward precipice (n)
ola-|to become (vb)
oland|tide, motion of sea (n)
olaud|tide, motion of the sea (n)
olerdh|pitiless, cruel, (lit.) without bowels (adj)
olfin(g)|branch, wand, stick (n)
olf|jar, flagon, *pitcher (n)
olla-|to ooze, *trickle (vb)
oll|torrent, mountain-stream (n)
olor|dream, apparition, vision (n)
olost|drowsy, dreamy, lazy (adj)
oltha-|to appear as an apparition; to dream; to dream (vb)
olui|dreamy (adj)
oman|whence, from where, (lit.) from what (adv)
omla|a horse chestnut (n)
omlos|(horse) chestnut tree; chestnut tree, *chestnut (n)
oneth|*giving (n)
onna-|*to birth, give birth to; ?to beget, make born (vb)
onnad|birth (n)
onnen|born (adj)
ontha; tîn|his (pron)
ont|no, none (adj adv)
on|*he (pron)
or (adv prep)|(av.) on, on top; (prep.) on, onto (adv prep)
or (prep)|above; onto (prep)
or- (Time)|-day (pref)
or-|privative prefix, without, -less (pref)
ora-|to heat up (vb)
orann|doorless (adj)
orchal|superior, eminent, lofty; tall; superior, eminent, lofty (adj)
orchen|dandelion, (lit.) day-eye (n)
orch|Orc, goblin; goblin; orc, goblin (n)
ordarn|gateless (adj)
oren|hot (weather) (adj)
orerdh|without bowels, pitiless (adj)
oreth|hour (n)
orfang|beardless (adj)
orfing|pear; pear, *(lit.) hair-apple (n)
orf|apple (n)
orhaud; orhod|seatless (adj)
ormagodron|a (Spanish) chestnut tree (n)
ormagod|a (Spanish) chestnut (n)
ormar|houseless (adj)
ormast|breadless (adj)
orna-|to burn (tr. and intr.) (vb)
ornath|numberless (adj)
orn|(tall straight) tree (n)
orodben|mountaineer, one living in the mountains (n)
orod|mountain (n)
orost|rising, sunrise (n)
oroth (Emotion)|rage, anger (n)
oroth (Time)|impetus, speed, haste, rash courage (n)
orsarn|stoneless (adj)
ortha-|to raise (vb)
orthad|*raising (n)
orthalos|courageless (adj)
orthanc|unbroken, without break or cleavage, united, continuous; masked (adj)
orthannen|raised (adj)
orthel-|to roof, screen above (vb)
orthelian|canopy (n)
orthor-|to master, conquer (vb)
orth|upper (adj)
orvab|handless (adj)
orvaith (Clothing and Adornment)|garmentless (adj)
orvaith (Law and Judgment)|unravished (adj)
orvang|staffless (adj)
orvath|foodless (adj)
orvel-|to favour, *(lit.) love above (vb)
orvlann|without deceit (adj)
orvlod|without pride, spiritless (adj)
orvog|priceless (adj)
orwadh|barkless (adj)
os-|about (pref)
osgaef|surroundings, environs, milieu (n)
osgar-|to cut round, amputate (vb)
ospathol|ebullient (adj)
ospoth|froth (n)
osp|smoke (n)
oss|outer wall (with moat), town wall, moat (n)
ost (n)|city; city, town (with wall round); enclosure, yard; town; fort, fortress, stronghold, citadel; (fortified) town, city; [orig.] enclosure (n)
ost (pron)|yourselves (pron)
osta-|to surround with walls, build up, fortify, protect; to surround (vb)
ostol-|to circumnavigate, come around (vb)
ostor|enclosure, circuit of walls; enclosure, circuit of walls, *town wall (n)
os|*about; *around (prep)
oth-|[wrong] with a bad sense; unsuitable, bad, improper, useless, wrong (pref)
othas|warfare (n)
othestannen|infamous, of evil name, (lit.) ill-named (adj)
othgar(ed)|doing wrong, *wrong doing (n)
othgarn|misdeed, *sin (n)
othidh|armistice (n)
othlonn|paved way (n)
othol|stranger, guest (n)
othovor|too much, (lit.) abundant in a bad way (adj)
othra-|to get away, escape (vb)
othrad|street (n)
othren|strange, weird, odd (adj)
othrol|warlike (n)
othrond|underground city, fortress; underground stronghold, underground city, fortress (n)
oth|ye (pron)
ovor|abundant (adj)
ovra-|to abound (vb)
ovras|crowd, heap (n)
o|*than; of; about, concerning; from, of (prep)
pad-|to step, walk (vb)
padhra-|to skin, peel, flay (vb)
padra-|to walk (vb)
pae; paean; sath|ten (cardinal)
paedolodh|eighteen (cardinal)
paegan|fourteen (cardinal)
paeleben|fifteen (cardinal)
paeneder|nineteen (cardinal)
paeneg|sixteen (cardinal)
paenel|thirteen (cardinal)
paenui|tenth (ordinal)
paetha-|to utter, speak, talk (vb)
paethad|oratory (n)
paethas|grammar, speech-system (n)
paethron|orator (n)
paeth|speech (n)
pagra-|to pave (vb)
pagros|pavement (n)
paib|sour (adj)
paich|juice, syrup, *sap (n)
palan-díriel|far-gazer (n)
palan-hinnen|famous, *(lit.) widely-known (adj)
palan-tîriel|*far-gazer (n)
palan|afar, abroad, far and wide (adv)
palath|surface (n)
palt|wide flat leaf; page of book (n)
pan (Quantity and Number)|arrangement, settlement, *grouping (n)
pan (Spatial Relations)|arrangement, settlement; place, spot (n)
pan-|to arrange, order, settle; to set, put, place; to write a book (vb)
panas|floor (n)
pand|courtyard (n)
panna-|to open, enlarge (vb)
pannad(a)-|to fill (trans.) (vb)
pannen; sam|arranged, settled, done (adj)
pann|wide (adj)
pant (adj)|full; full; (with article) the whole, all the (adj)
pant (n, Possession and Trade)|money (n)
pant; thoss (n, Emotion)|fear (n)
panu|arrangement, plan; structure, ordering; (musical) theme (n)
paran|bare, naked; smooth, shaven (adj)
parchol|towel (n)
parch|dry (adj)
parf|book (n)
parlas|parchment, document (n)
paron|full-moon (n)
partha-|to arrange, compose (vb)
partham|library (n)
parth|field, enclosed grassland, sward (n)
pasta-|to shake, wag, nod, flap (vb)
past|shaking (adj)
path (adj)|smooth (adj)
path (n)|peel, skin of fruit, fine bark (paper) (n)
path-|to smooth (vb)
patha-|to reveal, show (vb)
pathra-|to fill (intr.) (vb)
pathred|fullness (n)
pathren|fearful (adj)
pathu|level space, sward (n)
paur|fist, closed hand (n)
pau|sickness (n)
pavra-|to ail, be ill (vb)
paw|sickness, *illness, ailment (n)
pechof|squirrel (n)
pechol|hazel (n)
ped-|to say; to say, speak; to speak (vb)
pedh-|to incline, slope (vb)
pedui|*utterable, pronouncable, able to be spoken (adj)
pedweg|talkative, saying a lot (adj)
peg|dot, small spot (n)
peidion|sayer, soothsayer (n)
pel-|to fade, wane (vb)
pela(h)|along, (lit.) by the boundary of (prep)
peleth|waning, *fading (n)
pelia-|to spread (vb)
pell|still, quiet, hushed (adj)
pelthaes|pivot (n)
pelu-|to fence, enclose (vb)
pemp|lip (n)
pen (prep pref)|without, lacking, -less (prep pref)
pen (pron)|one, somebody, anybody (pron)
pen-channas|stupid, idiotic, *(lit.) lack-wit (adj)
pen-ind|insane, heartless, crazy (adj)
pen-|to have not (vb)
penbed|not pronouncable (adj)
pendrath|passage up or down slope, stairway (n)
pend|slope, steep incline, hill side, declivity; sloping (down), steeply inclined (n adj)
penestel|hopelessness, despair, desperation; hopeless, despairing, desperate (n adj)
pengas|archery (n)
pengolodh|teaching sage, doctor (of lore), *professor (n)
pengron|archer (n)
penia-|to fix, set (vb)
penna-|to come down (in a slant), fall (vb)
pennig|coin (n)
penninor|full year (last day of year), *new year’s eve (n)
pennod|without count (adj)
penn|declivity (n)
pent|tale, story (n)
per-|half (pref)
perin|half (adj)
perna-|to turn (vb)
perol|jar (n)
perthol|peninsula (n)
pesgannas|syntax, study of syntactical structures, (lit.) shapes of phrases (n)
pesgant|syntax, syntactical structure, (lit.) phrase-shape (n)
pess (Body Parts and Functions)|feather (n)
pess (Language and Music)|saying, proverb; saying, to say, a saying, [sic.] saw (n)
pessa-|to affect, concern (vb)
pesseg|pillow (n)
pesson|plume, (great) feather (n)
pethgannas|morphology, (lit.) shapes of words (n)
pethgant|surface representation (of a word), (lit.) word-shape (n)
pethlongannas|morphophonology (n)
pethron|narrator, reciter, minstrel; speaker, reciter, narrator, minstrel (n)
peth|word (n)
pibinaith(ros); pinaithros; tadhos|hawthorn (n)
pibin|small berry, haw (n)
pichen|juicy, *oozing (adj)
pictha-|to make urine (vb)
piectha-|to pin, prick (vb)
pigen|tiny (adj)
pigwed; saer|bitter (adj)
pil-|to steal, rob, thieve (vb)
pilimbes|arrow feathering (n)
pilin(d)|arrow, dart (n)
pilingwathil|feathering of an arrow (n)
pilinoth|arrow of war, arrow sent as a summons to war (n)
pillor|bat (animal) (n)
pilu|stealing, robbery, theft (n)
pimp|tail (n)
pind|crest, ridge (n)
pir-|to stir, stir round, make spin (vb)
piren|spun, rounded, cylindrical (adj)
pirin|flower that opened and shut quickly with any change of light (n)
piruin|spinning wheel (n)
pista-|to suppose (vb)
pi|if (adv)
plada-|to feel with the hand, stroke (vb)
plador; plados|oar (n)
plad|palm, flat of the hand (n)
plant|flat, open, expansive; candid, blunt (of words) (adj)
podod|potato (n)
podra-; ponta-|to turn round, turn back, retrace (vb)
poen|small gull, petrel (n)
pog-|futuere, *to copulate, have sex (vb)
poiant|stern (n)
poi|aft (on a ship) (n)
pol-|can, to be (physically) able to (vb)
polch|trunk, torso (n)
poll|ram (n)
polod; polodh|power, might, authority (n)
polodhren|mighty, *powerful (politically) (adj)
poltha-|to (physically) enable (vb)
polwed|strong (physically) (adj)
polwin|strength (physical) (n)
pont|the back, reverse or far side (n)
porochuil|hen (n)
porogog|the clucking and noise of fowls (n)
porog|fowl (domestic); fowl (domestic), *chicken (n)
posta-|to stop, cease, leave off (vb)
postad|stopping, cessation, leaving off (n)
post|pause, halt, rest, cessation, respite (n)
potha-|to tremble, quiver (vb)
press|trouble, disturbance (n)
presta-|to affect, trouble, disturb (vb)
prestannen|affected (of vowels), mutated (adj)
prestanneth|affection (of vowels), mutation (n)
pridu-|to decide (vb)
pridwen|judgment (n)
prind|distinction (n)
pruin|charcoal (n)
puch|cunnus, vagina (n)
puibra-|to wash, cleanse, soap (vb)
puida-|to clean, tidy, cleanse (vb)
puidad|(act of) cleaning, cleansing (n)
puidh|wash, cleaning (n)
puig|clean, neat, tidy; clean, tidy, neat (adj)
puitha-|*to have sex (with) (vb)
puith|coitus, *sex (n)
pâd|?way; a step (action); track, road; ford; way (n)
pân (adj)|all, *complete, entire, full, the whole (adj)
pân (n)|plank, fixed board (especially in a floor) (n)
pêl|fenced field (n)
píeg|mosquito (n)
pítha-|to shoot (vb)
pîl|robber, thief (n)
pîn|little (adj)
pîr|cream (n)
pôd|animal’s foot (n)
pôg|bag (n)
quing|bow (n)
rachui|dangerous (adj)
rach|danger (n)
rada-|to make a way, find a way (vb)
radh-|to return (intransitive) (vb)
raebroch; ribrog|zebra (n)
raeb|scored, striped (adj)
raeda- (Emotion)|to smile (vb)
raeda- (Motion and Transportation)|to catch in a net (vb)
raeg|wrong, awry, twisted, distorted, perverse, leering (of face) (adj)
raen (Emotion)|smiling, gracious, sweet-faced (adj)
raen (Motion and Transportation)|netted, enlaced (adj)
raeth (Physical Acts and Materials)|breach, *burst (n)
raeth; raith (Motion and Transportation)|extent, reach; region, sphere, district, scope (n)
raetha-|to reach at, reach for; to reach, extend (intr.) (vb)
raew|fathom (n)
rae|smile (n)
rag-|to break (asunder), burst (vb)
ragui|fragile, breakable (adj)
raibros|(female) zebra (n)
raim|edge, border-line (n)
rain (adj)|free, *unconstrained (adj)
rain (n, Motion and Transportation)|erratic wandering (n)
rain (n, Social Relations)|border (n)
rain (n, Time)|anniversary, year complete (n)
raitha-; reitha-|to try, strive (vb)
ram(m)as|*great wall (n)
rammas|great wall (n)
ram|wall (n)
ran-|to wander (vb)
ranc|arm (n)
randir|wanderer, wandering man, pilgrim (n)
randis|wanderer (f.) (n)
rand|cycle (n)
ranoth|month (n)
rant|course, water-channel; lode, vein; lode, vein (n)
raph-|to snatch, seize, steal (vb)
raph|rope, strap (n)
ras(t)|cape, shore (n)
ras-|to scorch, toast (vb)
rasc|toast(ed bread) (n)
rasg|wain, *wagon, cart (n)
rass|horn [of both animals and mountains] (n)
rath (Body Parts and Functions)|the full arm, the extent of one’s arm, one’s reach; a measure = 2 feet (n)
rath (Motion and Transportation)|course, river-bed; street; course, river-bed (n)
raudh|hollow, cavernous (adj)
raud|noble, eminent; lofty, high, tall; excellent (adj)
raug|demon, powerful hostile and terrible creature (n)
raun|errant (adj)
ravaed|skillful (adj)
ravn|wing (horn), extended point at side (n)
raw (Animals)|lion (n)
raw (Body Parts and Functions)|wing (n)
raw (Physical World)|bank (especially of a river) (n)
red-|to climb (vb)
redh-|to sow (vb)
redhia-|*to return (transitive) (vb)
redhin|related (adj)
redhor|farmer (n)
redhos|land (n)
rein|slot, spoor, track, footprint (n)
reitha- (Possession and Trade)|to rescue, save (from ruin, peril, loss) (vb)
reithron|rescuer, saviour (n)
rem (adj)|frequent, numerous (adj)
rem (n)|mesh, net (for catching) (n)
remmen|entangled, meshed, netted, woven (adj)
ren(d)|cousin (m.), relative (n)
ren-|to remember (vb)
rend|male cousin, relative (n)
renia-|to sail, fly; to stray, wander (vb)
renna-|to remind (vb)
rennas|kinship, relation (n)
ress (adj)|cleft, cloven, separate (adj)
ress (n)|cousin (f.), relative; female cousin, relative (n)
rest|cut (n)
reth-|to remain in same place (vb)
reth|*climber (n)
rhach|curse (n)
rhaed; rhîd|peculiar hue, (special) fashion (n)
rhaid-|to rush, hustle (vb)
rhaid|a rush(ing) (n)
rhanc|awkward, hard (adj)
rhaw (adj)|wild, untamed (adj)
rhaw (n)|flesh (n)
rheidiant|set free (adj)
rhess|ravine (n)
rhib-|to scratch (vb)
rhimma-; rib-|to flow like a (?torrent) (vb)
rhofan|wilderness (n)
rhofelf|body-feeling, [physical] sensation (n)
rhogrin|doughty (adj)
rhoidia-|to let go (vb)
rhond|body (n)
rhosc|russet, brown (adj)
rhovan|wilderness; wild beast (n)
rhu-|evil- (pref)
rhudol|unwelcome, coming with evil omen or intent (adj n)
rhufaug|drunken (adj)
rhugarol|wicked, doing evil (adj)
rhugaron|sinner (n)
rhugar|evil deed, *sin (n)
rhîf|brink, brim (n)
rhîw|winter (n)
rhód|course, running; way, method (n)
rhôg|strength (n)
rhúnen|eastern (adj)
rhû (n adj)|evil, wicked (n adj)
rhû (n)|matter (n)
rhûn|east, eastern; †rising (n)
ribin; rimin|striped, edged (adj)
rib|shore; stripe, line; border, fringe; stripe, line (n)
rig-|to twist, contort; to twist, contort; *to confuse, disarrange, upset (vb)
rig|a snarl, a sneer (n)
rim (n adj)|peace, quietness, calm; quiet, calm, peaceful (n adj)
rim (n, Language and Music)|stripe, line; border, fringe (n)
rim (n, Physical World)|cold pool or lake (in mountains) (n)
rim (n, Quantity and Number)|host, great number, people (of one kind or origin), crowd (n)
rimin|quiet, calm, peaceful (adj)
rimp|shred, slice, sliver (n)
rin-|to revolve; to revolve, return, come back; to do again (vb)
rinc|twitch, jerk, sudden move (n)
ring|cold, chill, cool; cool, cold (adj)
rista-|to cut; to rend, rip; to rend, rip (vb)
ritha-|to jerk, twitch, snatch; to try, strive (vb)
ro-|*superlative (pref)
rochben; rochon|rider (n)
rochir|knight, horse-lord (n)
roch|(swift) horse; horse (n)
rodel|lady, high lady (n)
rodol|little pipe (especially musical) (n)
rodrin|cylindrical (adj)
rod|tube, stem; tube, stem, *pipe (n)
rogol|saddle (n)
romru|sound of horns (n)
rom|horn, trumpet (n)
rond|(vaulted or arched) roof; vaulted chamber or cavern; heavens [as a roof of the world] (n)
ronga-|to hasten (vb)
rong|soon (adv)
ross (adj)|red-haired, copper-coloured (adj)
ross (n)|rain; spray (n)
rosta-|to hollow out, excavate (vb)
rostaur|rainforest (n)
rosta|ascent, uprising, rising (n)
rost|rainy (adj)
rothron|polisher (n)
roth|cave, grot (n)
rov-; ruf-|to tear (vb)
rovaed|[most] skillful (adj)
roval|winged; pinion, great wing (of an eagle) (adj n)
ruida-|to pursue, chase (vb)
ruim|secret, mysterious (adj)
ruin|red flame; fiery red (n adj)
ruist|fireplace, hearth (n)
rui|hunt, hunting, *chase (n)
run-|to rub, grind (vb)
runna-|to polish, burnish (vb)
rusc|fox (n)
rusg|oatcake (n)
rust (Agriculture and Vegetation)|inhabitation; cultivation, tillage (n)
rust (Physical Acts and Materials)|copper (n)
rustui|copper, *of copper, like copper (adj)
ruthla|oaten (adj)
ruthli|oats (n)
ruthra-|to rage (vb)
râd|path, pass, track; path, track (n)
rían|queen, *(lit.) crowned-lady (n)
rídhas|the country, countryside, farmland (n)
rídhathren|rustic, rural (adj)
rínada-|to crown, coronate (vb)
rî (Clothing and Adornment)|wreath, garland; crown (n)
rî (Sense Perception)|coolness, cool; a sudden breeze or cold breath (n)
rîdh|sown field, acre; ‘sown’, sown field, acre (n)
rîn (adj)|crowned (adj)
rîn (n)|remembrance (n)
rîth|effort, endeavour (n)
rôg|doughty, strong (adj)
rôl|a song (n)
rôn (Body Parts and Functions)|liver (n)
rôn (Possession and Trade)|embrace, clasp (n)
rôs; rôtha-|embrace (n)
rúthui|angry, wrathful (adj)
rû (Physical Acts and Materials)|loud sound, trumpet-sound (n)
rûdh|bald (n)
rûm|secret, mystery (n)
rûn|polished, burnished, smoothed by polishing (adj)
rûth|wrath, anger (n)
rû|mystery (n)
rŷn|chaser, hound of chase (n)
sa (prep adv)|beside, alongside, next (to) (prep adv)
sa; san (pron)|that (pron)
sab-|to dig (vb)
sabar|delving (n)
sachwen|summer, midsummer (n)
sad-|to reck, care, value, esteem, show respect for, consider (vb)
sador|steadfast, trusty, loyal (adj)
sadron|trusty follower, loyal companion (n)
sad|place, spot (n)
saeb (adj)|hungry (adj)
saeb (n)|boot (n)
saeda-|to teach, *train, (lit.) make wise (vb)
saegon|famine, (great) hunger (n)
saeg|hunger (n)
saelor|advisor (n)
saera-|to urinate (vb)
saerlin|urine (n)
saetha-|to cause hunger (vb)
saichwed|fiery, fierce (adj)
saictha-|to have hunger (vb)
said|private, separate, not common, excluded (adj)
sain|new (adj)
sairos|great age (n)
sairothwen|antiquity (n)
sairweg|old man, sage (n)
sairweigian|proverbial wisdom, sage saying (n)
sair|aged, ancient (adj)
sai|those (pron)
salab|herb (n)
salcha-|to scythe or mow (vb)
salch|green cut grass, ensilage (n)
salph|broth (n)
salta|a game (n)
saltha-|play (vb)
salum|*harp (n)
sam; tham|chamber, room (n)
sammar|*neighbor (n)
samp|spade, shovel (n)
samtha-|to settle a matter legally (vb)
sant|garden, field, yard (n)
sara-|ait (vb)
sarch|grave (n)
sardh|table (n)
sarn (n adj)|(small) stone, pebble; stony (place); stone as a material (n adj)
sarn (n)|a stone; stone (n)
sarnas|cairn (n)
sarneg|pebble (n)
sarothod; sarothwad|voyager, seafarer, (lit.) foreigner from overseas (n)
sarth|note, jot, scribbling (n)
sath|part (n)
saur|bad (of food), putrid (adj)
sautha-|to drain (vb)
sav- (Mind and Thought)|to believe in, accept as fact (vb)
sav- (Possession and Trade)|to have (vb)
saw (Food and Drink)|juice (n)
saw (Sense Perception)|filth, putrescence (n)
se; sen; then|this (pron)
secthadron|midmost (adj)
sedh-|to rest (vb)
seidia-|to set aside, appropriate to a special purpose or owner (vb)
sein|usual (adj)
sell|daughter; †girl, maid; girl, maid (n)
senc|mineral-like, flinty; flint (adj n)
send|?rest (n)
sennas|guesthouse (n)
sennui|?rather, instead (adv)
seregon|stonecrop, plant with red flowers, (lit.) blood of stone (n)
sereg|blood (n)
serni|shingle, pebble bank (n)
sesta-|to set, (lit.) to make rest (on) (vb)
si(n)-|granddaughter of (pref)
sibra-|to weep, whimper; to whimper (vb)
sigil (Clothing and Adornment)|necklace (n)
sigil (Physical Acts and Materials)|dagger, knife (n)
silef (adj)|silver, shining white (adj)
silef (n adj)|(white) crystal (n adj)
silevren|like silef (crystal) (adj)
silif|light of Silpion, †silver, *moonlight (n)
silith|light of Silpion, *moonlight (n)
silivren|(white) glittering, crystalline (adj)
sinc (Physical World)|*mineral (n)
sinc; tinc (Physical Acts and Materials)|metal (n)
singil|mirror (n)
singren|salt, *salty (adj)
sing|salt (n)
siniath|news, tidings (n)
sinnarn|novel tale (n)
sinnen|known (adj)
sin|these (pron)
sion|grandson (n)
siria-|to flow (vb)
siriol|flowing, fluent, liquid, melliflous (adj)
sirith|flowing (n)
sith|affair, matter (n)
soethor|drinking-horn (n)
sog-|to drink (vb)
solch|root (especially as edible) (n)
solph|soup (n)
somma-|to dive, duck (vb)
sommor|duck, waterfowl (n)
sov-|to wash clean, bathe (vb)
suilad|greeting (n)
suilanna-|to greet, *give greeting (vb)
suitha-|to dry, wipe (vb)
suithlas|tea; tea, *(lit.) drink of leaf (n)
suith|draught, a drink; drink, draught (n)
sui|*as (prep)
sulus|air-spirit (n)
sunt|nostrils (n)
suss (interj)|hush (interj)
suss (n)|hush, sudden quiet (n)
suthra-|to hush, to make or go quiet (vb)
sâdh|sward, turf (n)
sídheb|peaceful, full of peace (adj)
síla-|*to shine (vb)
sír|*today, this day (n)
sí|here, in this place (of speaker) (adv)
sî (adv)|yet, hither(to), hereto (adv)
sî (n)|bead, small gem or pearl (n)
sîdh|peace (n)
sîr (Physical World)|river; river, stream (n)
sîr|stream (n)
súda-|to blow (of wind) (vb)
sûl (Food and Drink)|goblet (n)
sûl (Physical World)|[strong] wind, *gust (n)
sûn|bath (n)
sûr|long, trailing (adj)
sû|noise of wind (n)
tab-|to stop, block, close (vb)
tachol|brooch, clasp, pin (n)
tad-dal|two-legged, *biped (adj)
tadui|second (ordinal)
taeg|boundary, limit, boundary line (n)
taen (adj)|long (and thin) (adj)
taen (n)|height, summit of high mountain (n)
taer|lofty, *high; straight (adj)
taes|nail (n)
taetha-|to fasten, tie (vb)
taew|holder, socket, hasp, clasp, staple (n)
tag-|to fix, make firm, *fasten; to fix, make firm, construct (vb)
taglos; tagron; ŷr|smith (n)
tagol|post, mark (n)
taid|supporting, second in command (adj)
taig|marking (a boundary) (adj)
tail; tâl|foot (n)
tain|letter, epistle, missive (n)
tair (adj)|vertical, (lit.) standing (adj)
tair (n)|look-out, watch, guard; gaze, regard (n)
taith|a letter, mark, sign; sign, symbol; mark, stroke (n)
talad|incline, slope (n)
talaf|ground, floor (n)
talagan|harper (n)
talan|flet; platform, flat space, flet [Middle English = ‘floor’] (n)
talath|flat lands, plain, vale (n)
talc|upright (adj)
talf|wang, flat field, topographical flat area (n)
tallam|conlang (n)
tallen|playful, fun(ny) (adj)
tallif|ankle (n)
taloth|(foot)path (n)
talpa-|to prop up, buttress up (vb)
talphressui|mischievous (adj)
talphres|mischief, (lit.) play(ful)-trouble/disturbance (n)
talpon|a slender pillar (n)
talraph|stirrup (n)
taltha-|to slip (down), collapse, fall in ruin (vb)
talt|slipping, falling, insecure (adj)
talvad|footpath (n)
tamma-|to knock (vb)
tammos|cauldron (n)
tana-|to show, indicate, point out (vb)
tanc (Emotion)|firm; steady, steadfast; settled (adj)
tanc (Mind and Thought)|firm, steady, settled; firm, steady, steadfast (adj)
tanga-|to set light to, kindle (vb)
tangad(a)-|to make firm, confirm, establish, fix (vb)
tangad-|to fix, make firm (vb)
tangod|fixing, confirming, making (n)
tangor|hearthgrate, fireplace (n)
tangos|firmness, steadiness (n)
tang|bowstring (n)
taphaen|twenty (cardinal)
tar-|to stand (vb)
tarag|horn; steep mountain peak (n)
tara|tough, stiff (adj)
tarchas|roughness, ruggedness, rudeness (n)
tarch|stiff, rough (or tough) (adj)
tarf|dry, stale (adj)
tarias|stiffness, toughness, difficulty (n)
tarlang|proud, obstinate, (lit.) stiff-necked; stiff neck (a nickname applied to men of haughty carriage or mood) (adj n)
tarnon|porter (n)
tarn|gate (n)
tarph|dry [esp. of foods], stale (adj)
taru (adj)|horned (adj)
taru (n)|cross, *crucifix; cross; crossing (n)
tass|labour, task (n)
tast (Quantity and Number)|total, amount (n)
tast (Spatial Relations)|border, fringe (n)
tasta-|to (put to the) test, *verify (vb)
tastaith|test (n)
tathar|willow (tree) (n)
tathren|of willow(s) (adj)
tathrin|willow (n)
taudha|phosphorous (n)
taugla-|to resist (vb)
taug|firm, strong, (?withstand) (adj)
taul|pillar (n)
taur (adj)|vast, mighty, overwhelming, awful, huge; high, sublime (adj)
taur (n, Physical World)|dense wood or forest; forest, great wood; forest, wood, great wood, dense wood (n)
taur (n, Social Relations)|king (of a whole tribe) (n)
tauron|forester (n)
taus|thatch (n)
tavnen|made (by craft of hand), wrought, fashioned (adj)
tavn|thing made by handicraft (n)
tavor (Animals)|woodpecker, knocker (n)
tavor (Religion and Beliefs)|wood fay (n)
taw (adj)|of wool, woollen (adj)
taw (adv)|thither (adv)
taw (n)|wood as material (n)
tawar|wood (material), *forest (n)
tawen|wood (of material), wooden (of make) (adj)
teb|point, nib, neb, nose (n)
techu|chip (n)
teflarol; tefra|abject, mean (adj)
tegil|pen (n)
teglath|noted year, special year, feast year (n)
teglos|awning (n)
tehar|brick (n)
teitha-|to write, draw; to write, draw, inscribe, make marks or signs (vb)
tel-|to end, finish, be done (vb)
telch|stem (n)
teleg|leg (n)
teleir|*Telerin (adj)
tele|end, rear, hindmost part (n)
telf|conclusion, ending, anything used to finish off a work or affair (n)
telien|sport, play, game (n)
telingail|sign of heaven (n)
tellyn|sole of foot (n)
tell|last, final (in a series) (adj)
teloth|roofing, canopy, shelter (n)
telthion; telwed|roofed in, sheltered, protected (adj)
telthon|roof (n)
telt|lid (n)
telum (Agriculture and Vegetation)|mushroom (n)
telum|roof; sky (n)
telu|dome, high roof (n)
tengedion|confirmer, fixer, establisher (n)
tengolu|semantics (n)
tentha-|feel with the feet, walk on tiptoe (vb)
tent|toe (n)
ten|*it, passive voice marker (pron)
tertha-|to destroy, *ruin, †(orig.) to make pierced; to devour, destroy (vb)
terthaith|waste, ruin, destruction (n)
tess(il)|little flower; †maiden (n)
tess|fine pierced hole (n)
tev-|to detest, hate (vb)
tevren|hateful (adj)
tew; têw; tîw|letter (n)
tewig|morpheme (n)
thaes|attraction, temptation (n)
thaetha-|to split (vb)
thaf; thâf|hay (n)
thag-|to draw, pull (vb)
thagel|pulling, luring (adj)
thaigra|choice, select, elegant (adj)
thaig|choice (n)
thain (Law and Judgment)|law-abiding, regular, normal, *lawful, formal, according to custom (adj)
thain (Spatial Relations)|level, even (adj)
thairin|magic (adj)
thalas|valour, courage (n)
thala|stalwart, steady, firm, hardy, valiant, bold; valiant, hardy, bold (adj)
thalieth|heroine, dauntless woman (n)
thalion (adj n)|strong, dauntless; hero, dauntless man (adj n)
thalion (n)|hero, dauntless man; warrior hero (n)
thall|steep, falling steeply (of river) (adj)
thalos; thórod|torrent (n)
thalph|grease (n)
thamas|great hall (n)
thanc|cleft, divided, split, cloven, forked, bifurcated; cleft, break, breach; cleft, split; forked, cleft, split, divided, cloven, bifurcated; cleft, break, breach (adj n)
thand (adj)|firm, true, abiding (adj)
thand (n)|shield (n)
thang (Quantity and Number)|a crowd, crush, herd (n)
thang (Social Relations)|compulsion, duress, need, oppression; oppression, pressure; compulsion, duress, need (n)
thangail|shield-fence, shield-wall (n)
thar-|to saw (up) (vb)
tharan|vigorous (adj)
tharas|hassock, footstool (n)
tharchol-|to translate, (lit.) carry-across (vb)
tharf; thram|saw (n)
tharn|sapless, stiff, rigid, withered (adj)
thar|across, athwart, over; across, beyond (prep pref)
thas-|to shave (vb)
thasgim|*razor, (lit.) shave-blade; razor, (lit.) shave-blade (n)
thasg|shaven (adj)
thast|shaving(s) (n)
thas|thy (pron)
thathri|shavings, sawdust (n)
thaur|abominable, horrible (adj)
thavn|post, wooden pillar (n)
thavron|carpenter, wright, builder (n)
thaw|corrupt, rotten (adj)
thegin|leading, chief (adj)
thegla|first lights of dawn (n)
thegor|chief (n)
thegra|first, foremost (adj)
theinas|law, rule (n)
theinweg|lawman, lawyer (n)
thel-|to intend, mean, purpose, resolve, will (vb)
thela|point (of spear) (n)
thennas|shortness (n)
ther-|to sew (vb)
theres|ribbon; tie, ribbon (n)
theria-|to be vigorous, flourish (vb)
theriol|flourishing (adj)
thibindon|flute-playing (n)
thibinor|piper (n)
thibin|flute (n)
thig-|to pick out, select, choose (vb)
thilia-|to glisten (vb)
thilim|gleaming (adj)
thimma-|to play a flute or whistle (vb)
thimp|the stop on a flute (n)
thim|milk (after separation) (n)
thinc|a pick, a choice; a bunch, posy (n)
thind; thinn|grey, pale (adj)
thinna-|to fade, *(lit.) become grey (vb)
thinta-; thiv-|to skim (vb)
thirad-|to make complete, fill in the last details (vb)
thiradant|elaborately finished (adj)
thirph|straw (n)
thisin|parched, withered; parched, withered, *desiccated (adj)
thista-|to dry up; to dry up (tr.) (vb)
thivol|whistle, piccolo (n)
thlidhra|‘willowy’, gracile (adj)
thlim|race, kind, species, sort (n)
thloss|breaker (n)
tho-|*will be (vb)
thol-|to roll (vb)
tholos|axle of a wheel (n)
thond|root, base (n)
thoniel|kindler (in the past) (adj)
thonnas|root-word; *foundation (n)
thonn|base, root, root-word (n)
thora-|to fence (vb)
thoren|*fenced (adj)
thorn (adj)|steadfast (adj)
thorn; thoron|eagle (n)
thornang|steel, (lit.) hard-iron (n)
thorombar|eagle’s nest, eyrie (n)
thossui|fearful, afraid (adj)
thosta-|to stink, *give off a smell (vb)
thost|smell (n)
thos|puff (of air) (n)
thothri|black magic (n)
thriben|lean (adj)
thrimp|stalk (n)
throthriol|wizardous (n)
throth|beat (of oars, wings, etc.) (n)
thug|?resin (n)
thuia-|to breathe (vb)
thuif; thuis|resinous juice; any adhesive substance (n)
thurin|secret, hidden (adj)
thâr|stiff grass (n)
thîn|evening (n)
thîr (adj)|complete, full, accomplished, ended, up to the required number (adj)
thîr (n)|face, look, expression, countenance; look, face, expression, countenance (n)
thôl|helmet, helm (n)
thôr|swooping, leaping down (adj)
thúna-|to be spiritually affected, inspired (vb)
thúnas|inspiration (n)
thû (Emotion)|movement of spirit (n)
thû (Sense Perception)|stench; black mist, horrible darkness (n)
thûg|resin (n)
thûl|breath (n)
tif-; tiph-|to whistle (vb)
tifin; tiphin|small flute (n)
tiglas; tiglath|remorse (n)
tilithli|little elf (n)
tilithril|f. elf (n)
tilithrin|elfin (adj)
tilithron|m. elf (n)
till (Body Parts and Functions)|horn (n)
till (Spatial Relations)|point, spike, (sharp) horn, tine, ending (n)
timpintha-|to ring, jingle, tinkle (vb)
timp|hoot, note of a flute (n)
tin (pron)|them (pron)
tin; tîn (n)|spark, sparkle, twinkle of stars (n)
tingen|metallic (adj)
tiniath|group of stars, star-cluster, constellation (n)
tinna-|to glint (vb)
tinnu|(starry) twilight, dusk, early night (without moon) (n)
tinthiltha-|to twinkle, *sparkle (vb)
tinthilthad|sparkling, twinkling, scintillation (n)
tir-|to look (out) for, watch for, await, expect; to look (towards), watch (over), guard; to watch (vb)
tiria-|to watch; to watch, gaze; to ward, guard (vb)
tirion (Warfare and Hunting)|tower (n)
tirion|watch-tower, turret, tower (n)
tirith|watch, guard; watching, guarding, watch, ward, guard (n)
tirnen|guarded (adj)
tisga-|to tickle (vb)
tisg|ticklish (adj)
tithen|little, tiny (adj)
tith|breast [of a woman], teat; breast, teat (n)
tiwdi|alphabet (n)
ti|*they (pron)
tlacha-|to clap, clash, clatter (vb)
tlachol|clashing (adj)
tlach|clap, clash (n)
tlais; tlass|splashing, flapping noise (n)
tlaud|sloping (adj)
toba-|to cover, roof over (vb)
tobas|roofing, roof (n)
tobla-|to hide (vb)
toch|cud (n)
tog-|to bring (vb)
tol(l)|island, (high steep-sided) isle (n)
tol-|to come (vb)
tol; toll|island, isle (n)
tolch; toleg|*sticker-up (n)
tolcha-|to support, *steady, comfort (vb)
tolf|mast (n)
tolhui; tollui|eighth (ordinal)
tolodh|eight (cardinal)
tolog|stalwart, trusty (adj)
tolophaen|eighty (cardinal)
tolpheg|spoon (n)
tolph|bowl, basin (n)
toltha-|to fetch (vb)
tol|isle (with high steep coast) (n)
tomp|humped, bulging (adj)
tond (adj)|tall (adj)
tond; tonn|(bored) hole, perforation (n)
tong|taut, tight; resonant (of strings) (adj)
tor-|to win, have victory (vb)
torchal|shark or other large predatory fish (n)
torc|a sear, mark of a burn (n)
torech|lair, (secret) hole, excavation (n)
torn|burial mound (n)
tortha-|to wield, control (vb)
tor|the Dead (n)
toss|bush, low-growing tree (n)
tosta-|to cough (vb)
tovn|lowlying, deep, low (adj)
tranc|criss-cross, crossed; cross, at cross purpose, perverse (adj)
trannail|regional, local (n)
trann|shire, *county, adminitrative region (n)
trasta-|to harass, trouble (vb)
trastadweg|annoying (adj)
tre-|through (pref)
trenar-|to recount, tell to the end (vb)
trenarn|account, tale (n)
trevad-|to traverse (vb)
trog|easy to handle; convenient, tractable, docile (adj)
trunc|great stake (n)
trîw|fine, very slender (adj)
trî|through (prep)
tudheg|match (n)
tudh|tinder (n)
tufrin|fluffy (adj)
tuf|down, fluff (n)
tuia-|to sprout, spring; to swell (vb)
tuig|shoot, sapling; shoot, sapling, sprout (n)
tuilas|petal, (lit.) bud-leaf (n)
tuilinn|swallow, (lit.) spring-singer (n)
tuilu-|to bud, open (of flowers and leaves) (vb)
tui|sprout, bud (n)
tulog|steady, firm (adj)
tultha-|to lift, carry (vb)
tulus|poplar-tree (n)
tulu|support, prop (n)
tum(b)|flat vale (n)
tump (Dwelling and Furniture)|shed (n)
tump (Physical World)|hump (n)
tum|(deep) valley; (deep) valley, vale (n)
tunc|chance, occurrence; chance; occurrence; arrival; hit at shooting; luck (n)
tundeb; tunneb; tunnen|full of holes, riddles (adj)
tund|log for the fire; log for the fire, *firewood, fuel; mound, hill (n)
tur-|can, to have power to (vb)
turinthir|*queen (n)
tuthlos|a teazle (n)
tâd|two (cardinal)
tâl|foot; (lower) end; foot; [lower] end (n)
tân|builder, smith; builder, smith, wright, artificer (n)
tê|line, way; mark, line; track; path (n)
tírad(a)-|to correct, straighten, rectify (n)
tírad|vision, seeing (n)
tî (adj n)|straight; line (adj n)
tî (n)|line (n)
tîf|resentment, ill feeling, bitterness (n)
tîl|cicatrice, scab, healing of a wound; scab, cicatrice, healing of a wound (n)
tîn (adj)|silent, quiet (adj)
tîr (adj n)|†straight, upright, honest (aj.); esteem, regard, honour (adj n)
tîr (adj)|straight, right; upright, honest; esteem, regard, honour (adj)
tîr (n)|king (n)
tôdhi|paddock (n)
tôg|storey, floor (of a house) (n)
tô|fleece, wool; wool; wool, fleece (n)
túgomui|corpulent, (lit.) having a fat belly (adj)
túgom|fat-bellied (adj)
túliel|come, arrived (adj)
tûg|thick, fat (adj)
tûm|valley (n)
tûr (Body Parts and Functions)|power (n)
tûr (Social Relations)|mastery, victory, power [over others] (n)
tûr (Warfare and Hunting)|mastery, victory (n)
tûs-|to tease wool, comb out (vb)
tû|muscle, sinew; vigour, physical strength (n)
tŷg|thigh (n)
u(r)dhrog|without slaves (adj)
u(r)ngúl|without wisdom (adj)
u(r)vrog|horseless (adj)
u-|negative prefix (pref)
uanui|monstrous (adj)
ubed|denial (n)
uchirin|secure (adj)
uchirthol|reckless (adj)
uchir|recklessness; carelessness; security (n)
uchuil; urguil|lifeless (adj)
udrug|intractable, fierce, untamed (adj)
ufedhron|lawless man (n)
ufedhwed|lawless (adj)
ufeth|without a word (adj)
uf|fine wool, down (n)
ug-|negative verb (vb)
ugwedriol|ineffable, unspeakable, awful (adj)
ui (adv)|ever (adv)
ui (n)|envelope (n)
ui-|twi- (pref)
uial|twilight; twilight, evendim (n)
uil-|to rain (vb)
uilos|white flower like a star (n)
uir (adj)|*fiery (adj)
uir (n)|eternity (n)
uir-|not to wish, not mean to, mean not to (vb)
uirol|unwilling, reluctant (adj)
uista-|not to notice (vb)
uitha-|to smoke (trans.) (vb)
ul-|*ugly (pref)
ulcrum|sin (n)
uluchnir; ulugwin|she-dragon (n)
uluithiad|unquenchable (adj)
ulunn|monster, deformed and hideous creature (n)
ulvon|*monster, giant (n)
um; umin|we (pron)
umboth|nightfall (n)
umli|a dell (n)
ummast|without bread (adj)
unath; unt|nothing (n)
unathriol|unreal; impossible (adj)
unaudrathrol|unabashed, shameless (adj)
unc|ourselves (pron)
ungathos; unthos|eighteen (n)
ungorod|without a chief (adj)
ungra|eighth (adj)
unnor|without a land (adj)
urbeth|wordless (adj)
urdhuilin|without swallows (adj)
urduf|humorless (adj)
urfuin|nightless (adj)
urgeleb|without silver (adj)
urhonn|heartless (adj)
urnor|landless (adj)
urnui|inflammable; touchy, irritable (adj)
urorod|without chief (adj)
urrost|never coming to life (adj)
urtha-|to work, wreak, fashion, make, devise (vb)
urug|bogey (n)
uru|brazier, grate (n)
usb; usg|fog, mist (n)
usta-|to leave, depart (vb)
uthairiol|unintentional, unintended; reluctant (adj)
uthir|without a king (adj)
uthwen|escape, way out, exit (n)
uvan|*noone, nobody (pron)
uvlant|pathless (adj)
uvost|without a town (adj)
uwedhen|outlaw, outcast (adj)
uwedhron|outlaw, outcast (n)
u|no, not, nor (adv)
ven|toward (n)
vi|in (prep)
ylf|drinking-vessel, *cup (n)
ylin|liquid (adj n)
ylvon|chalice (n)
yrin|made (by craft of hand) (adj)
yrith|care-free (adj)
yrlhinn|arrowless (adj)
yrlhith|dustless (adj)
Úrui|August, *Hot-one (n)
êg|thorn (n)
ínias|annals (n)
íphathred|yearfullness, age of person (n)
írui|desirable, lovely (adj)
í|indefinite indeclinable relative particle (pron)
î(r)|impersonal plural pronoun (pron)
îdh|rest, repose, peace, tranquility (n)
îd|treasure, thing of great worth, jewel (n)
îf|cliff, sheer descent (n)
în (n)|year (n)
în (pron)|his, *reflexive possessive = his own (pron)
îr-|to be willing; to will, intend to, mean to (vb)
îr|*sexual desire (n)
î|indeed (interj)
ôf|hood (n)
ôl (Body Parts and Functions)|dream (n)
ôl (Spatial Relations)|height, stature (n)
ôn|crown of head, top (n)
ôs|bog (n)
ú-|no, not, negative; impossible; un, bad- (pref)
úan|monster (n)
úbedui|not fit to say, unspeakable (adj)
úben|nobody, no one (n)
úgan(n)|gutless, faint-hearted, diffident (adj)
úgarol|idling, not now doing or making (adj)
úgarth|trespass, *(lit.) misdeed (n)
úgethiol|boring, (lit.) not interesting (adj)
úlam|dumb, unable to speak, (lit.) untongued (adj)
úlan(n); úland|narrow, (lit.) not broad (adj)
úlren|odorous (adj)
únodui|countless (adj)
únoth|without number, countless (adj)
úr|sun (n)
úthaes|inducement to do wrong, *temptation (n)
úthúlui|breathless (adj)
úvae|vowel; vocalic (n adj)
úvelui|not amiable, unloveable (adj)
û (adv interj)|no, not, nor (adv interj)
û (adv)|*negative (adv)
û-|not to be, not to do (vb)
ûl|odour, *smell, scent (n)
ûmi|large (adj)
ûn|creature (n)
ýda-|to hint; *to wink (vb)
ýneg|twelve (cardinal)
ŷl|lamb (n)
