-(i)ol|active participle; adjective suffix (suf)
-(i)on|adjectival suffix (suf)
-(r)il; -dis|feminine agent (suf)
-(r)on; -or|agental suffix (suf)
-ad; -ed|gerund (suf)
-ant|regular past tense (suf)
-as; -os; -th|abstract noun (suf)
-ath|collective or group plural (suf)
-dor|*king, lord (suf)
-eb; -en; -iel; -in; -ren; -rin; -ui|adjective suffix (suf)
-eg|diminutive/singular ending; suffix for ordinal numbers (suf)
-gon|valour (suf)
-ian(d)|-land (suf)
-iel|daughter; feminine suffix (suf)
-ien|feminine ending (suf)
-il|feminine suffix (suf)
-ion (Mankind)|son (suf)
-ion (Social Relations)|-region, -land (suf)
-lim; -rim|group plural (suf)
-od|singular suffix (suf)
-on; -we (Mankind)|masculine suffix (suf)
Anaur; Anor|Sun (n)
Aranor|*Sun-day (n)
Ardórin|?Day of Kings (n)
Argaladath|*Day of the Trees (n)
Argalad|Tree Day (n)
Argilion|*Star-day (n)
Arithil|*Moon-day (n)
Aroeren|Sea-day (n)
Arvelain|*Day of the Valar (n)
Arvenel|*Heavens-day (n)
Balan|Power, God (n)
Cadloer|July, *After-summer (n)
Cathriw|January, *After-winter (n)
Cerfeth|July (n)
Dantilais; dannas; firith; lasbelin|autumn (n)
Dân [nd-]|Green-elf (n)
Ebloer|June, ?Before-summer (n)
Edhel|firstborn, eldest (n)
Eledh|Star-folk, Elf (n)
Ephriw|December, *First-winter (n)
Girithron|December, *Shuddering-one (n)
Golodh [ng-]|one of the wise folk, Gnome (n)
Gwaeron|March, *Windy-one (n)
Gwirith|April, *Freshness (n)
Hithui|November, *Misty-one (n)
Ifonneth|September, *Yavanna-ness (n)
Ithil; Rhân|Moon (n)
Lothron|May, *Flower-ness (n)
Narbeleth|October (n)
Nawag; naug|Dwarf (n)
Nenneth|February, *Watery (n)
Nerwinien|January (n)
Nórui|June, *Fiery (n)
Ogod|Ent (n)
Perian|Halfling (n)
a-|intensive prefix (pref)
a; ar|and (conj)
aclod|sloping, tilted (adj)
ad-|back, again, re- (pref)
adab|building, house (n)
adar|father (n)
ada|father (hypocoristic) (n)
adel|behind, in rear (of) (prep)
aderthad|reuniting (n)
adleg-; adleitha-|*to release (vb)
adleithian|*release, freeing (n)
ad|*against (prep)
aer; oear; oer|sea (n)
aes|cooked food, meat (n)
aew|(small) bird (n)
afarch|arid, very dry (adj)
aglareb|glorious (adj)
aglar|glory, splendour (n)
agor|narrow (adj)
ai|hail (interj)
al-|no, not (pref)
alagon|storm (n)
alagos|storm (of wind) (n)
alag|rushing, impetuous (adj)
alf|swan (n)
am-|snake (pref)
amar|Earth (n)
amath|shield (n)
ambend; ambenn|uphill (adv)
amben|uphill (adj)
amlug; lhûg|dragon (n)
ammarth|fate, doom (n)
amon|hill (n)
amrûn|uprising, sunrise, Orient, east (n)
am|up (adv)
an-|with, by (pref)
an; nan|of (prep)
anann|long (adv)
anc|jaw, row of teeth (n)
andabund; andrabonn; annabon|elephant (n)
andeith|long-mark (n)
andrand|*long cycle (n)
angol (Religion and Beliefs)|deep lore, magic (n)
angol; ongol; thû|stench (n)
angos; del; goroth [ng-]|horror (n)
angren|of iron (adj)
angwedh|chain, fetter, (lit.) iron-bond (n)
ang|iron (n)
anna-|to give (vb)
annon|great gate, door (n)
ann|long (adj)
annûn; dûn [nd-]|west (n)
anrand|cycle, age, (lit.) long cycle (n)
ant|gift (n)
anw|male (person or animal) (n adj)
ar(a)-|noble, royal (pref)
ar- (Spatial Relations)|outside, beside; without (pref)
ar- (Time)|day (pref)
arad|daytime, a day (n)
araf|wolf, dog (n)
aran|king, lord (of a specific region) (n)
ardh|realm (n)
arnediad|without reckoning, numberless, innumerable, countless, endless (adj)
arnen|?royal (n)
arnœdiad; aronoded|innumerable, countless, endless (adj)
ascar; asgar|violent, rushing, impetuous (adj)
ast|dust (n)
ath-|on both sides, across (pref)
athan|beyond (prep)
athelas|a healing plant (n)
athrada-|to cross, traverse (vb)
athrad|ford, crossing (n)
atlanna-|to slope, slant (vb)
atlant|oblique, slanted (adj)
aur|day, morning (n)
auth|war, battle (n)
awartha-|to forsake (vb)
awarth|abandonment (n)
bach [mb-]|article (for exchange), ware, thing (n)
bachor [mb-]|pedlar (n)
bad-|*to tread, travel (vb)
badh- [mb-]|to judge (vb)
badhor [mb-]; badhron [mb-]|judge (n)
balch [mb-]|cruel (adj)
banga- [mb-]|to trade (vb)
bann [mb-]|duress, prison (n)
barad [mb-]|doomed, *fated (adj)
baradh|steep (adj)
barad|fort, tower, fortress (n)
baran|brown, swart, dark brown (adj)
bara|fiery, eager (adj)
bartha- [mb-]|to doom (vb)
barth|fate (n)
basgorn [mb-]|loaf (n)
bast [mb-]|bread (n)
batha-|to trample (vb)
baudh [mb-]|judgement (n)
baug [mb-]|tyrannous, cruel, oppressive (adj)
baugla- [mb-]|to oppress (vb)
bauglir [mb-]|tyrant, oppressor (n)
baul [mb-]|torment (n)
baur [mb-]|need (n)
bein|fair, beautiful (adj)
beleg; daur|great, large (adj)
bellas|bodily strength (n)
belt|strong in body (adj)
bennas|angle (n)
benn|man, male, †husband (n)
beor|follower, vassal (n)
beren|bold; festive, gay, joyous (adj)
bereth (Time)|feast, festival (n)
bereth; rhîs (Social Relations)|queen (n)
beria-|to protect (vb)
beril|rose (n)
bertha-|to dare (vb)
bess|woman; †wife (n)
blab-|to flap, beat (wings etc.) (vb)
bon(n) [mb-]|snouted (adj)
both [mb-]|puddle, small pool (n)
brannon|lord (n)
brann|lofty, noble, fine; high (adj)
brassen|white-hot, *very hot (adj)
brass|white heat, *extreme heat (n)
bregedur|wild fire (n)
breged|violence, suddenness (n)
bregolas|fierceness (n)
bregol|violent, sudden, *fierce (adj)
breig|wild, fierce (adj)
breitha-|to break out suddenly (vb)
brenia-|to endure (vb)
brennil; hiril|lady (n)
brethel; brethil|beech (n)
breth|mast, *fallen nuts or acorns (n)
brith|gravel (n)
brona-|to last, survive (vb)
bronadui|enduring, lasting (adj)
bronwe|endurance (n)
brui|loud (adj)
brôg|bear (n)
brûn|old (has long endured) (adj)
bui [mb-]|must (impersonal), (lit.) *[it] needs (vb)
buia-|to serve, hold allegiance to (vb)
bunn [mb-]|snout, nose; cape [of land] (n)
bár|home; earth (n)
bâd|beaten track, pathway (n)
bôr|steadfast; trusty man, faithful vassal (adj n)
cabor|frog (n)
cadwar; cadwor|shapely (adj)
cadw|shaped, formed (adj)
cad|*after (adv)
caeleb|bedridden, sick (adj)
cael|lying in bed, bedridden, sickness (adj)
caer (cardinal)|ten (cardinal)
caer (n)|flat isle on a river (n)
caew|lair, resting-place (n)
calad; galad|light (n)
calardan|lampwright (n)
calen|green, (orig.) bright-coloured (adj)
calf|water-vessel (n)
callon|hero (n)
cam; camm|hand (n)
camland; dalf; dalv|palm of hand (n)
canad|four (cardinal)
cann|bold (adj)
cant|outline (n)
car(dh)|house (n)
car-|to do, make (vb)
carab|hat (n)
carach|jaws (n)
caraes|*jagged hedge of spikes (n)
carag|spike, tooth of rock (n)
caran; caron; naru|red (adj)
caras|a city (built above ground) (n)
carch|tooth, fang (n)
carth|deed (n)
caun (Emotion)|valour (n)
caun (Quantity and Number)|empty, void (n)
caw|top (n)
ceber|?limestone, -rock (n)
cef|soil (n)
ceir; cîr|ship (n)
celebren|of silver, like silver (adj)
celeb|silver (n)
celeg|swift, agile (adj)
celeir|brilliant (adj)
celeth|stream, *brook, rill, runlet; (lit.) a flowing (n)
celevon|*of silver (adj)
celw|spring, source (n)
cennan; cevnor|potter (n)
cerch|sickle (n)
ceredir|doer, maker (n)
cerin|round enclosure (n)
cevnas|earthenware (n)
cevn|of earth, earthen (adj)
chwann; hwann|sponge, fungus (n)
chwest|puff, breath, breeze (n)
chwinia-|to twirl, whirl, eddy (vb)
chwiniol|whirling, giddy, mad, fantastic (adj)
chwinn|eddy (n)
chwîn|giddyness, faintness (n)
cirban; lorn|haven (n)
cirdan|shipbuilder (n)
ciriaeth|shipwright (n)
cirith|cleft, pass (n)
claur|splendid; †splendour, glory (adj n)
cobar|knob, head, tip (n)
coenel|gore, wedge (n)
coe|earth (n)
coll|red, scarlet (adj)
corch|crow (n)
corn|round, globed (adj)
coron|globe, ball (n)
corw|cunning, wily (adj)
cost|quarrel (n)
coth|enmity, enemy (n)
cram|cake of compressed flour or meal (n)
crann|ruddy (of face); face, blush, the cheeks (adj n)
criss|cleft, cut, slash; pass (n)
crist|cleaver, sword (n)
critha-|to reap (vb)
crom|left (adj)
crumguru|wiley, sinister, guilty (n)
crumui; hargam; harwed|left-handed (adj)
crum|left hand (n)
cuen|small gull, petrel, sea-bird (n)
cugu|dove (n)
cuia-|to live (vb)
cuil|life (n)
cuina-|to be alive (vb)
cuin|alive (adj)
cum|mound, heap (n)
cunn; ernil|prince (n)
curunir|a man of craft, wizard (n)
curu|cunning (n)
câs|top, summit (n)
cîl|cleft, pass between hills, gorge (n)
cîn|wedge, gore (n)
côl|gold (metal) (n)
cúran|crescent moon (n)
cûl; naur|flame (n)
cûn|bowed, bow-shaped, bent (adj)
cû|arch, crescent (n)
dadbenn|downhill (adj)
dadben|downhill, inclined, prone (adj adv)
dad|down (adv)
dae (adv)|very (adv)
dae (n)|shadow (cast by an object or form), shade (n)
daedelu; orthelian|canopy (n)
daen [nd-]|corpse (n)
daew|shadow (n)
dag- [nd-]|to slay (vb)
dagor [nd-]|battle (n)
dagra- [nd-]|to battle (vb)
dalath|flat surface, plane, plain (n)
dalw|flat (adj)
dam [nd-]; dring|hammer (n)
damma- [nd-]|to hammer (vb)
dangen|slain (adj)
dannen|fallen (adj)
dant-|to fall (vb)
dant|*fall (n)
dar-|to stop, halt (vb)
dartha-|to wait, stay, remain, last, endure (vb)
dath|hole, pit; steep fall, abyss (n)
daudh|pit (n)
daug [nd-]|warrior, soldier (chiefly used of orcs) (n)
davnan|?closed (adj)
daw|night-time, gloom (n)
deleb|horrible, abominable, loathsome (adj)
deleg|sword? (n)
delia-; doltha-|to conceal (vb)
delos; deloth|abhorrence, detestation, loathing (n)
delw|hateful, deadly, fell (adj)
dem (dimb-)|sad, gloomy (adj)
dess|young woman (n)
di [nd-]|in (prep)
dilia-|to stop (up) (vb)
dineth [nd-]; dîs [nd-]|bride (n)
doer [nd-]|bridegroom (n)
dofn; dufui|gloomy (adj)
dolen|hidden, secret (adj)
doll [nd-]|obscure, dark, dusky, hidden, secret (adj)
dolt [nd-] (adj)|obscure (adj)
dolt [nd-] (n)|round knob, boss (n)
donn|swart, swarthy; shady, shadowy (adj)
doron|oak (n)
dortha- [nd-]|to dwell, stay (vb)
drafn|hewn log (n)
drambor|clenched fist; blow with a fist (n)
dram|heavy stroke, heavy blow (n)
draug; garaf [ng-]|wolf (n)
drava-|to hew (vb)
dringa-|to beat (vb)
duilin; dúlin(n); merilin(n)|nightingale (n)
duin|water, river (n)
duirro|*river-bank (n)
dum|root, foundation (n)
durgul; morgul|sorcery (n)
dâf|permission (n)
dínen|silent (adj)
dî [nd-]|woman, bride, lady (n)
dîl|stopper, stopping, stuffing (n)
dîn|opening, gap, pass in mountains (n)
dîr|man, adult male; agental suffix (n)
dôl [nd-]|head, hill (n)
dôr [nd-]|land, dwelling-place, region where certain people live (n)
dú(w)ath|night-shade (n)
dúven [nd-]|*sunken, western (n)
dûr|dark (adj)
dû|night, night-fall, late evening (n)
eb|?before (prep)
echad-|to fashion, shape; make (vb)
echain|new, built again (adj)
echui(w)|awakening (n)
echuir|early Spring, (lit.) stirring (n)
ech|spine, *spiny quill or bristle (n)
ecthel|?point (of spear) (n)
ed-|forth, out (pref)
eden|new, begun again (adj)
edhen; ereg|first (adj)
edinar|anniversary day (n)
edonna-|to beget (vb)
edra-|to open (vb)
edraenui|?outside, bordering, outer (adj)
edrein|*(outer) border (n)
eges|mouths (n)
egledhia-|to go into exile (vb)
egledhron|exile (n)
eglenn|exiled (adj)
egnas|sharp point, peak (n)
eil-|to rain (vb)
eilian(w); elianw|rainbow, (lit.) sky-bridge (n)
eithel|issue of water, spring, well, fountain (n)
eith|spear-point (n)
el; geil|star (n)
elanor|sun-star (n)
elf; mellon; thond|friend (n)
ell|sky (n)
elw|(pale) blue (adj)
emil; naneth|mother (n)
emlin|yellow bird, yellow hammer (n)
enedh|centre, middle, core (n)
eneg|six (cardinal)
ennin|Valian year (n)
ephel|outer fence (n)
erceleb; mithril; thilevril|*true-silver (n)
ercha-|to prick (vb)
erch|prickle (n)
ereb|isolated (adj)
eredh|seed, germ (n)
eregdos|holly, holly-tree (n)
ereg|holly-tree (n)
eria-|to rise (vb)
eriol|single, alone (adj)
eru|waste, desert (n)
er|one, alone (adj)
ethir|mouth of a river (n)
ethuil|spring (n)
falas; faur|beach, shore (n)
falf|foam, breaker (n)
faltha-|to foam (vb)
fang|beard (n)
fanui|cloudy (adj)
fara-|to hunt (vb)
faras|hunting (n)
farf|?carpet (n)
farn|enough (adj)
faron; feredir|hunter (n)
far|sufficient, enough, quite (adj adv)
fast|shaggy hair (n)
faug|thirsty (adj)
faun|cloud (n)
fein|white, radiant (adj)
feir (adj)|right (hand) (adj)
feir (n)|mortal man, mortal (n)
feira-|to suffice (vb)
fela; gathrod; rond|cave (n)
feleg|(animal’s) horn; steep mountain peak (n)
fenn|threshold, door (n)
fern|dead (of mortals) (n adj)
fervein; forodren|northern (adj)
fileg; filigod|small bird (n)
finnel|(braided) hair (n)
firen|human (adj)
flaew|sickly, sick, ill (adj)
flinc|*finch (n)
fliw; paw|sickness (n)
floss; thross|whispering or rustling sound (n)
foeg|mean, poor, bad (adj)
foen|radiant, white (adj)
forgam|righthanded (adj)
forn(en)|closed (adj)
forn|right or north (adj)
forod; forven|north (n)
fuia-|to feel disgust at, abhor (vb)
fuilas; galenas; marlas; romloth|pipeweed (n)
fuin|night, dead of night (n)
fêr|beech-tree (n)
gad-|to catch (vb)
gador|prison, dungeon (n)
gae; goe|dread (n)
gael|pale, glimmering (adj)
gaer; gorgor [ng-]|dreadful (adj)
gail|bright, light (adj)
gala-|to grow (vb)
galadh; orn|tree (n)
galas|growth, plant (n)
galw|?increase, growth (n)
gammas|s-sign (n)
gamp|hook, claw (n)
gann(ad)a- [ng-]|to play a harp (vb)
gannel [ng-]|harp (n)
gar-|to hold, have (vb)
garn|‘own’, property (n)
gartha-|to defend, keep (vb)
garth|fort, fortress (n)
gasdil|stopgap (n)
gas|hole, gap (n)
gath|cavern (n)
gaud|device, contrivance, machine (n)
gaul [ng-]|wolfhowl (n)
gaur [ng-]|werewolf (n)
gaw- [ng-]|to howl (vb)
gawad [ng-]|howling (adj)
gaw|void (n)
gellam|jubilation (n)
gellui|triumphant (adj)
gell|joy, triumph, (?victory) (n)
gem|sickly (adj)
gern|worn, old, decrepit (of things) (adj)
gildin|silver spark (n)
gilhof|dew, *(lit.) star-juice (n)
gilith|starlight, *region of the stars (n)
gir-|to shudder (vb)
girith|shuddering, horror (n)
glaer|long lay, narrative poem (n)
glaew|ointment, salve (n)
glair|*poem (n)
glaiw|salve (n)
glamm|shouting, confused noise; barbarous speech (n)
glamor|echo (n)
glamren|echoing (adj)
glan|clear (adj)
glass|joy, *happiness (n)
glas|joy (n)
glaur|gold (n)
glavra-|to babble (vb)
glavrol|babbling (adj)
glawar|sunlight, radiance of Laurelin (n)
glaw|radiance (n)
glin-|to sing (vb)
gling-|to hang, dangle (vb)
glinn; glîr; lhîr|song, poem, lay (n)
glinn|(pale) blue (n)
glir-|to sing, recite poem (vb)
gloriel|golden (adj)
gloss|snow, snow-white (n adj)
glî|honey (n)
glûdh|soap (n)
go-; gwa-|together (pref)
gobel|walled house or village, town (n)
gobennas; pennas|history (n)
gobennathren|historical (adj)
godrebh|abreast; *together-through (adv)
goer|red, copper-coloured, ruddy (adj)
golf|branch (n)
goll [ng-]; sail|wise (adj)
gollor [ng-]|magician (n)
golw [ng-]|lore (n)
golwen [ng-]|wise, learned in deep arts (adj)
gonathra-|to entangle, enmesh (vb)
gonathras|entanglement (n)
gondrafn; gondram|hewn stone (n)
gondren|*of stone (adj)
gond|rock (n)
gonn|rock, stone (as a material) (n)
gonod-|to count (up) (vb)
goren|dead (of elves) (adj)
gorf|impetus, vigour (n)
gorn|impetuous (adj)
gosta-|to fear exceedingly (vb)
gost|dread, terror (n)
govad-|to meet (vb)
gowest|contract, compact, treaty (n)
grau|dark, swart (adj)
grond|club (n)
groth; roth|cave, tunnel (n)
gruin|ruddy (adj)
guir; uir|eternity (n)
guireb; uireb|eternal (adj)
gurth [ng-]|*death (n)
guru [ng-]|death (abstract) (n)
guruth [ng-]|death (n)
guruthos [ng-]|fear of death (n)
gwa-|*away (pref)
gwador|(sworn) brother, associate (n)
gwaeda-|to enfold (vb)
gwaedh|bond, troth, compact, oath (n)
gwaew|wind (n)
gwahae|*far away (adj)
gwaloth|blossom, collection of flowers (n)
gwanath; gwanw|death (act of dying) (n)
gwanna-|to depart, die (vb)
gwann|departed, dead (adj)
gwanod|tale, number (n)
gwanur|kinsman, kinswoman (n)
gwarth|betrayer (n)
gwass; gwath|stain (n)
gwastar|hummock (n)
gwath; lhum|shade (n)
gwatha-|to soil, stain (vb)
gwathel|[sworn] sister, associate [f.] (n)
gwaun|goose (n)
gwaur|soiled, dirty (adj)
gwedh-|to bind (vb)
gwedh; nûd|bond (n)
gweith|manhood; man-power, troop of able bodied men, host, regiment (n)
gwelwen|air, lower air (n)
gwelw|air (as a substance) (n)
gwend|bond, friendship (n)
gweneth|virginity (n)
gwenn|maiden (n)
gweria-|to betray (vb)
gwesta-|to swear (vb)
gwest|oath (n)
gwe|man, warrior (n)
gwilith|air (as a region) (n)
gwilwileth|butterfly (n)
gwind|pale blue (n)
gwing|spindrift, flying spray (n)
gwinna-|to fade (vb)
gwîn; neth (adj)|young (adj)
gwîn; thîn (n)|evening (n)
gwî|net, web (n)
gûl [ng-]|magic (n)
ha; hana|it (pron)
hab-; hamma-|to clothe (vb)
habad|shoe (n)
had-|to hurl (vb)
hadh-|sit (vb)
hador; hadron|thrower (of spears and darts) (n)
hae; haen; hoe|*far (adj adv)
haedh|heap, ‘piled mound’ (n)
haew|custom, habit (n)
haf-|to sit (vb)
haglath|sling (n)
hal-|to lift (vb)
halath|skin, fell (n)
haldir|fur-hunter (n)
half|seashell (n)
hall (Physical World)|veiled, hidden, shadowed, shady (adj)
hall (Spatial Relations)|exalted, high (adj)
haltha-|to screen (vb)
ham; hanw|?chair (n)
hammad|clothing (n)
hamp|garment (n)
handos|*understanding, intelligence (n)
hand|seat (n)
hannas|understanding, intelligence (n)
hann|intelligent (adj)
har-|to stand (vb)
haradren; harn|southern (adj)
harad|south (n)
harfen|*south-region (n)
harn (adj)|wounded (adj)
harn (n)|helmet (n)
harna-|to wound (vb)
hartha-|to hope (vb)
harthad|hope (n)
harw|wound (n)
hasta-|to hack through (vb)
hast|axe-stroke (n)
hathel|broadsword-blade, axe-blade (n)
haudh|grave, tomb; (piled) mound, heap (n)
haust|bed (n)
he; hen(e)|she (pron)
hebel|?fence (n)
heir|left (hand) (n adj)
helch|bitter cold (adj)
heledir(n)|kingsfisher, (lit.) fish-watcher (n)
heleg|ice (n)
heleth|fur, fur-coat (n)
hele|glass (n)
helf|fur (n)
hell (adj)|naked (adj)
hell (n)|frost (n)
heltha-|to strip (vb)
henia-|to understand (vb)
heria-|to begin suddenly and vigorously (vb)
heron|lord, master (n)
herth|household, troop (n)
herven; hervenn|husband (n)
herves; hervess|wife (n)
hethw|foggy, obscure, vague (adj)
him|enduring, continually; steadfast, abiding (adv adj)
hithui|misty (adj)
hithw|fog (n)
hiw|sticky, viscous (adj)
hmael|stain; stained (n adj)
hmalt; malt|gold (as metal) (n)
hmalw|fallow, pale (adj)
hmaw|soil, stain (n)
hmâl|pollen, yellow powder (n)
hniof|noose, snare (n)
ho; hon(o)|he (pron)
hobas|harbourage (n)
horn|driven under compulsion, impelled (to do something) (adj)
hortha-|to urge on, speed (vb)
host|gross (144) (n)
hoth|host, crowd; group plural (n)
huan|hound (n)
hâdh|*cleaver (n)
hâl; lhim|fish (n)
hên|eye (n)
hîr|master, lord (n)
hîth|mist (n)
hûb|haven, harbour, small landlocked bay (n)
hûd|assembly (n)
hûl|cry of encouragement in battle (n)
hûn|heart (physical) (n)
hûr|readiness for action, vigour, fiery spirit (n)
hû|dog (n)
iaeth|neck (n)
iaew|mocking, scorn (n)
ialla-|to call (vb)
ial|?cry, shout (n)
iant|yoke (n)
ianw|bridge (n)
iathrad|crossing, ford (n)
iath|across (prep)
iau (Agriculture and Vegetation)|corn (n)
iau (Physical World)|ravine, cleft, gulf (n)
iaun|holy place, fane, sanctuary (n)
iaur|ancient, old(en) (adj)
ia|gulf (n)
idher|thoughtfulness (n)
idhren|pondering, wise, thoughtful (adj)
idhrin|year, *(lit.) year-circle (n)
iell|daughter (n)
iest|wish (n)
ifant|aged, having lived long, (lit.) year-full (adj)
imlad|dell, deep vale, glen (n)
imm|dell, deep vale (n)
im|I (pron)
inc|guess, idea, notion (n)
ind; inn|inner thought, meaning, heart (n)
ingem|old (in mortal sense), suffering from old age, decrepit, (lit.) year-sick (adj)
inw|female (adj n)
iofog|fruit drink, cider (n)
iolf|brand (n)
ionn|son (n)
io|ago (adv)
ista-|to have knowledge (vb)
istui|learned (adj)
ist|lore, knowledge (n)
ithildin|*moon-star (n)
ithil|Moria-silver, true-silver (n)
iuitha-|to employ (vb)
iuith|use (n)
i|the (article)
iâr|blood (n)
iôr|course (n)
iûl; uilw|embers (n)
laden|flat (and wide) (adj)
lalf; lalven; lhalorn; lhalwen|elm-tree (n)
laudh|licking up (food or drink), gluttonous eating (n)
lebethras|Gondorian tree (n)
ledh-|to go (vb)
leithia-|to release (vb)
leithian|release from bondage (n)
lembas|waybread (n)
lhaden|flat (and wide); open, cleared (adj)
lhad|plain (n)
lhaeg|keen, sharp, acute (adj)
lhaer|long lay (n)
lhaes|babe (n)
lhaew|frequent, many (adj)
lhae|great number (n)
lhagr|swift, rapid (adj)
lhain|free(d) (adj)
lham(b)|tongue (n)
lhanc|throat (n)
lhand|open space, level (n)
lhang|cutlass, sword (n)
lhann; pann; ûr|wide (adj)
lhant|clearing in the forest (n)
lhasbelin|leaf-fall, autumn (n)
lhass|leaf (n)
lhathr(ad)a-|to listen in, eavesdrop (vb)
lhathron|hearer, listener, eavesdropper (n)
lhath|thong of (?leather) (n)
lhaug|warm (adj)
lhav-|to lick (vb)
lhaws; lhoch|ringlet (n)
lhaw|ears (of one person) (n)
lhebed|finger (n)
lheben|five (cardinal)
lheithia-|to release, set free (vb)
lheithian|release from bondage, release, freeing (n)
lhend|tuneful, sweet (adj)
lhethril|hearer, listener, eavesdropper (f.) (n)
lhevnar|week (n)
lhewig|ear (n)
lhimlug|fish-dragon, sea-serpent (n)
lhimmid(a)-|to moisten (vb)
lhimp; mesc; mesg; nenui|wet (adj)
lhinn|air, tune (n)
lhoda-|to float (vb)
lhoeb|fresh (adj)
lhoeg|keen (adj)
lhom|weary (adj)
lhong|heavy (adj)
lhonn|(narrow) path, strait, pass (n)
lhorn (adj)|asleep (adj)
lhorn (n)|haven, quiet water, anchorage, harbour (n)
lhoss; rhofan|wilderness (n)
lhost|empty (adj)
lhothod|single flower (n)
lhoth|flower(s) (n)
lhumren|shady (n)
lhunt|boat (n)
lhîn|pool (n)
lhîr|row (n)
lhûn|blue (adj)
lhûr|slumber (n)
lhûtha-|to enchant (vb)
lhûth|spell, charm (n)
lhû|time, occasion (n)
lim|*swift (adj)
lithui|ash[en] (adj)
lith|sand (n)
lobor|horse (n)
loer|summer (n)
lonn|path (n)
lothren|wild, waste (adj)
lo|flood (n)
luithia-|to quench (vb)
mab|grasp (n)
mad-|to eat (vb)
mada|soft, pliant, yielding (adj)
madhias|softness, pliancy (n)
maenas|craft, handicraft, art (n)
maen|skilled, clever (adj)
maer|useful, fit, good (of things) (adj)
maetha-|to fight (vb)
maethon; magol; megil|sword (n)
maethor|warrior (n)
maeth|battle, fight (n)
maew|gull (n)
maidh|pale, fallow, fawn [light yellowish tan colour] (adj)
mai|well (adv)
malen|yellow (adj)
mallen; malthen|of gold (adj)
mallorn|gold tree (n)
manadh|doom, final end, fate, fortune; final bliss (n)
mann|food (n)
matha-|to stroke, feel, handle (vb)
maur|gloom (n)
meglin|*bear-like (adj)
meglivorn|blackbear (n)
megli|bear, (lit.) honey-eater (n)
mela-|to love (vb)
melch|greedy (adj)
meldir|friend [m.] (n)
meldis|friend (f.) (n)
melethril|lover (f.) (n)
melethron|lover (m.) (n)
meleth|love (n)
mell; muin|dear (adj)
men (pron)|*us (pron)
men; sad (n)|*place (n)
menel|*the heavens (n)
ment|point (n)
methen|end, final (adj)
meth|end (n)
mid; mith (adj)|grey (adj)
milui|friendly, loving, kind (adj)
mindon|tower, isolated hill (especially a hill with a watchtower) (n)
minei|single, distinct, unique (adj)
minna-|to enter (vb)
minnas; tirion|tower (n)
min|one (cardinal)
mista-|to stray about (vb)
mistrad|straying, error (n)
mist|error, wandering (n)
mith (n)|white fog, wet mist (n)
mithren|small (adj)
moeas|dough (n)
moed|handy, skilled (adj)
moelui|lustful (adj)
moel|lust (n)
moe|soft, pliant (adj)
morn; môr|black (adj)
muda-|to labour, toil (vb)
muindor; tôr|brother (n)
muinthel; thêl|sister (n)
muin|secret (adj)
mân|departed spirit (n)
mîdh|dew (n)
mîl|love, affection (n)
mîr|jewel, precious thing, treasure (n)
mîw|small, tiny, frail (adj)
mûl|slave, thrall (n)
mû|no (interj)
nadhor; nadhras|pasture (n)
nad|thing (n)
naeg|pain (n)
naes; nagol; neleg; nêl|tooth (n)
naeth|biting, gnashing of teeth (n)
naew|jaw (n)
nae|alas (interj)
nag-|to bite (vb)
naith|gore (n)
nana|mother (hypocoristic), *mommy (n)
nann|wide grassland (n)
nara-|to tell (vb)
narcha-|to rend (vb)
narch|*bitter-biting (adj)
nardh|knot (n)
narn|tale, saga (n)
nartha-|to kindle (vb)
nass|point, (sharp) end; angle, corner (n)
nasta-|to prick, point, stick, thrust (vb)
nathron|weaver, webster (n)
nath|web (n)
naud|bound (adj)
naugla|*Dwarf (n)
naugol (naugl-)|Dwarf (diminutive) (n)
nautha-|to conceive (vb)
nauth|thought (n)
naw|idea (n)
na|with, by; of (prep)
ne-|in (pref)
neder|nine (cardinal)
nedh-|mid- (pref)
nedhw; nef|bolster, cushion (n)
negra-|to pain (vb)
nel-|tri- (pref)
neled; neledh|three (cardinal)
neledh-|*to go in, enter (vb)
nella-|to sound (of bells) (vb)
nelladel|ringing of bells (n)
nell|bell (n)
nelthil|triangle (n)
nem|nose (n)
nenn|watery (adj)
nen|water (n)
nest; nesta; nethra|?heart, core (n)
nesta-|to heal (vb)
nestad|healing (n)
nestag-|to insert, stick in (vb)
neðw|scarred, bruised (adj)
nifredil|(green) snowdrop; *(lit.) pale point (n)
nifred|pallor, fear (n)
nimmid(a)-|to whiten (vb)
nimp (nim-)|pale (adj)
nimred|pallor (n)
niniel|tearful (adj)
ninn|slender (adj)
nod-; nœdia-|to count (vb)
nod-|to tie (vb)
noen|wise, sensible (adj)
noer|sad, lamentable (adj)
nor-|*to run (vb)
nordh|cord (adj)
norn|twisted, knotted, crabbed, contorted (adj)
noroth|giant (n)
noss|clan, family, ‘house’ (n)
no|under (prep)
nud-|*to tie (vb)
nâr|rat (n)
nínim|snowdrop (n)
nínui|*tearful (adj)
nírnaeth|lamentation (n)
nîdh|honeycomb (n)
nîd|damp, wet; tearful (adj)
nîf|front, face (n)
nîn|tear (n)
nîr|tear, weeping (n)
nîth|youth (n)
nîð|hurt, bruised (adj)
nô|thigh (n)
nûr (adj)|deep (adj)
nûr (n)|race (n)
odhril|parent (f.) (n)
odhron|parent (n)
odog|seven (cardinal)
oegas|mountain peak (n)
oeglir|range of mountain peaks (n)
oeg|sharp, pointed, piercing (adj)
oel|pool, lake (n)
oeruil; uil|seaweed (n)
oll|torrent, mountain-stream (n)
oltha-|to dream (vb)
onna-|?to beget, make born (vb)
orchal; orchel|superior, eminent, lofty (adj)
orchall|superior, eminent (adj)
orch|goblin (n)
orod|mountain (n)
ortha-|to raise (vb)
orthannen|raised (adj)
orthel-|to roof, screen above (vb)
orthor-|to master, conquer (vb)
or|above (prep)
os-|about (pref)
osgar-|to cut round, amputate (vb)
osp|smoke (n)
ossrond|*underground city, fortress (n)
ostrad|street (n)
ost|city, town (with wall round) (n)
othlon|paved way (n)
othrond|underground city, fortress (n)
ovor|abundant (adj)
ovra-|to abound (vb)
ovras|crowd, heap (n)
o|about, concerning; from, of (prep)
palath (Agriculture and Vegetation)|iris (n)
palath (Spatial Relations)|surface (n)
palw|agony (n)
panas|floor (n)
panna-|to open, enlarge (vb)
pannad(a)-; pathra-|to fill (vb)
pann|courtyard (n)
pant|full (adj)
parch|dry (adj)
parf|book (n)
pathred|fullness (n)
pathw|level place, sward (n)
path|smooth (adj)
paur|fist (n)
ped-|to speak (vb)
peg|dot, small spot (n)
peich|juice, syrup (n)
pelhes|*pivot (n)
pelia-|to spread (vb)
pelin|*fading (n)
pelthaes|pivot (n)
pendrad; pendrath|passage up or down slope, stairway (n)
penedh; penn (Religion and Beliefs)|Elf (n)
peng|bow (for shooting) (n)
penia-|to fix, set (vb)
penn (Physical World)|declivity (n)
penninar|full year (last day of year) (n)
pent|tale, story (n)
per-|half (pref)
perin|half (adj)
pessa-|to affect, concern (vb)
pesseg|pillow (n)
pethron|narrator, reciter, minstrel (n)
peth|word (n)
pichen|juicy (adj)
pigen|tiny (adj)
poen|small gull, petrel (n)
post|pause, halt, rest, cessation, respite (n)
presta-|to affect, trouble, disturb (vb)
prestannen|affected (of vowels), mutated (adj)
prestanneth|affection (of vowels), mutation (n)
puia-|to spit (vb)
puig|clean, tidy, neat (adj)
pâd|?way (n)
pân|plank, fixed board (especially in a floor) (n)
pêl|fenced field (n)
pôd|animal’s foot (n)
rada-|to make a way, find a way (vb)
ram(m)as|*great wall (n)
rant|lode, vein (n)
rath|course, river-bed (n)
rewinion|of the hunters (n)
rhaen|crooked (adj)
rhaew|fathom (n)
rhafn|wing (horn), extended point at side (n)
rhain (adj)|free (adj)
rhain (n)|border (n)
rham|wall (n)
rhanc|arm (n)
rhandir|wanderer, pilgrim (n)
rhand|cycle (n)
rhasg; till|horn (n)
rhass|precipice (n)
rhas|horn [of both animals and mountains] (n)
rhaud; tinc|metal (n)
rhaudh|hollow, cavernous (adj)
rhaug|demon (n)
rhaun|errant (adj)
rhaw (adj)|wild, untamed (adj)
rhaw (n, Animals)|lion (n)
rhaw (n, Physical World)|bank (especially of a river) (n)
rhedh-|to sow (vb)
rhein|slot, spoor, track, footprint (n)
rhem|frequent, numerous (adj)
rhenia-|to fly, sail; to stray, wander (vb)
rhenn|circular (adj)
rhess; rhis|ravine (n)
rhest|cut (n)
rhib-; rhimma-|to flow like a (?torrent) (vb)
rhien|(crowned) lady (n)
rhim (Physical World)|cold pool or lake (in mountains) (n)
rhim (Quantity and Number)|crowd, host (n)
rhinc|twitch, jerk, trick, sudden move (n)
rhingorn; rhinn|circle (n)
rhing|cold (adj)
rhista-|to cut (vb)
rhitha-|to jerk, twitch, snatch (vb)
rhoeg|wrong (adj)
rhofal|pinion, great wing (of an eagle) (n)
rhomru|sound of horns (n)
rhom|horn, trumpet (n)
rhonn|roof, cave (n)
rhosc|russet, brown (adj)
rhoss (Physical Acts and Materials)|polished metal (n)
rhoss (Physical World)|rain (n)
rhufen|east (adj)
rhui(w)|hunt, hunting (n)
rhuin; ûr|fire (n)
rhíw|winter (n)
rhîf|brink, brim (n)
rhîn|crowned (adj)
rhî|crown (n)
rhûn|east, eastern; †rising (n)
rhû|loud sound, trumpet-sound (n)
rhŷn|chaser, hound of chase (n)
rista-|to rend, rip (vb)
roch|(swift) horse (n)
rosta-|to hollow out, excavate (vb)
râd|path, track (n)
rîdh|‘sown’, sown field, acre (n)
saer|bitter (adj)
saew|poison (n)
salab|herb (n)
salff|broth (n)
sarnas|cairn (n)
sarn|stone as a material (n adj)
sautha-|to drain (vb)
saw|juice (n)
sein|new (adj)
sell|girl, maid (n)
seth|first, forth (adj)
sigil|dagger, knife (n)
silef|silver, shining white (adj)
silif; silith|light of Silpion, †silver (n)
siniath|news, tidings (n)
sinnarn|novel tale (n)
siria-|to flow (vb)
sog-|to drink (vb)
solch|root (especially as edible) (n)
sîdh|peace (n)
sîr|river (n)
sûl|goblet (n)
sûth|draught (n)
tachol|brooch, clasp, pin (n)
tadol|double (adj)
taen (adj)|long (and thin) (adj)
taen (n)|height, summit of high mountain (n)
taer|straight (adj)
taes|nail (n)
taetha-|to fasten, tie (vb)
taew|holder, socket, hasp, clasp, staple (n)
talad|incline, slope (n)
talaf|ground, floor (n)
talagand|harper (n)
talan|flet (n)
talt|slipping, falling, insecure (adj)
tamma-|to knock (vb)
tanc|firm (adj)
tangad(a)-|to make firm, confirm, establish (vb)
tang|bowstring (n)
tarag|horn; steep mountain peak (n)
tara|tough, stiff (adj)
tarias|stiffness, toughness, difficulty (n)
tarlanc|stiff-necked, obstinate (adj)
tass|labour, task (n)
tathor|willow-tree (n)
tathren|of willow (adj)
taur (adj)|vast, mighty, overwhelming, awful, huge; high, sublime (adj)
taur (n, Physical World)|forest, great wood (n)
taur (n, Social Relations)|king (of a whole tribe) (n)
taus|thatch (n)
tavor|woodpecker, knocker (n)
tawaren|wooden (adj)
tawar|wood (material), *forest (n)
taw|of wool, woollen (adj)
tegol|pen (n)
teilia-; telia-|to play (vb)
teitha-|to write, draw (vb)
teith|mark, stroke (n)
telch|stem (n)
tele|end, rear, hindmost part (n)
telien|sport, play (n)
tellen|sole of foot (n)
telu|dome, high roof (n)
terch|lair, hole (n)
tess|fine pierced hole (n)
tew; tîw|letter (n)
thafn|post, wooden pillar (n)
thala|stalwart, steady, firm (adj)
thalion|hero, dauntless man (n)
thamas|great hall (n)
tham|hall (n)
thanc|cleft, split (adj n)
thang|compulsion, duress, need, oppression (n)
thann|firm, true, abiding (adj)
tharas|hassock, footstool (n)
tharn|sapless, stiff, rigid, withered (adj)
thar|across, beyond (prep pref)
thaun|pine-tree (n)
thavron|carpenter, wright, builder (n)
thaw|corrupt, rotten (adj)
thela|point (of spear) (n)
thent|short (adj)
then|this (pron)
thia-|to appear, seem (vb)
thilia-|to glisten (vb)
thilim|gleaming (adj)
thinna-|to fade, *(lit.) become grey (vb)
thinnas|shortness, shortening (n)
thinn|grey, pale (adj)
thlein|lean, thin, meagre (adj)
thlingril; ungol|spider (n)
thling|spider, spider’s web, cobweb (n)
thlinn|fine, slender (adj)
thlê|fine thread, spider filament (n)
thonn; thonnas|base, root, root-word (n)
thora-|to fence (vb)
thoren|*fenced (adj)
thoron; thôr|eagle (n)
thosta-|to stink (vb)
thost|smell (n)
thrib-|to scratch (vb)
thuia-|to breathe (vb)
thâr|stiff grass (n)
thîr|look, face, expression, countenance (n)
thórod|torrent (n)
thôr (adj)|swooping, leaping down (adj)
thûl|breath (n)
tilias|?mountain range (n)
tinna-|to glint (vb)
tinnu|(starry) twilight, dusk, early night (without moon) (n)
tint|spark (n)
tinw|spark, small star (n)
tir-; tiria-|to watch (vb)
tirith|watch, guard (n)
tirnen|guarded (adj)
tithen|little, tiny (adj)
tiwdi|alphabet (n)
tlaud|sloping (adj)
toba-|to cover, roof over (vb)
tobas|roofing, roof (n)
tofn|lowlying, deep, low (adj)
tog-|to bring (vb)
tol-|to come (vb)
tol; toll|island, isle (n)
tolog|stalwart, trusty (adj)
toloth|eight (cardinal)
toltha-|to fetch (vb)
tong|taut, tight; resonant (of strings) (adj)
tonn|tall (adj)
tortha-|to wield, control (vb)
toss|bush, low-growing tree (n)
trasta-|to harass, trouble (vb)
tre-|through (pref)
trenar-|to recount, tell to the end (vb)
trenarn|account, tale (n)
trevad-|to traverse (vb)
trîw|fine, very slender (adj)
trî|through (prep)
tuia-|to sprout, spring; to swell (vb)
tuilinn|swallow, (lit.) spring-singer (n)
tui|sprout, bud (n)
tulus|poplar-tree (n)
tulu|support, prop (n)
tump|hump (n)
tum|(deep) valley (n)
tunn|hill, mound (n)
tâd|two (cardinal)
tâl|foot; (lower) end (n)
tân|builder, smith (n)
tê|line, way (n)
tîr|straight, right (adj)
tî|line, row (n)
tûg|thick, fat (adj)
tûr|mastery, victory (n)
tû|muscle, sinew; vigour, physical strength (n)
uanui|monstrous (adj)
ubed|denial (n)
ui (adv)|ever (adv)
ui (n)|envelope (n)
ui-|twi- (pref)
uial|twilight (n)
ul-|*ugly (pref)
uluithiad|unquenchable (adj)
ulun|monster, deformed and hideous creature (n)
uvan|*noone, nobody (pron)
Úrui|August, *Hot-one (n)
âr|king (n)
êg|thorn (n)
ínias|annals (n)
în|year (n)
îr|*sexual desire (n)
ôl|dream (n)
ú-|un, bad- (pref)
úan|monster (n)
ûl|odour (n)
ûn (Animals)|creature (n)
ûn|howl; groan; idea, thought (n)
