caras|city, fort or dwelling surrounded by bulwarks, circular earthwall with dike (n)
-a|[old] genitive suffix (suf)
a¹|and; †by, near, beside (conj)
adh|and (conj)
ah|and (conj)
ar|and (conj)
a²|O! (interj)
ae|O! (interj)
ab|after (prep)
eb|?before (prep)
ablad|prohibition, refusal (n)
ach¹|neck (n)
ach²|*but (conj)
achad|rock ridge, neck (geographically) (n)
achar-|to avenge, do back, react, requite (vb)
achared|vengeance (n)
acharn|vengeance, (an act of) revenge (n)
-ad|dual (suf)
ad-|back, again, re- (pref)
-ad¹|noun-suffix (suf)
Adan|Man (as a species) (n)
adaneth|(mortal) woman (n)
adar|father (n)
adbed-|to rephrase (vb)
adertha-|to reunite (vb)
aderthad|reuniting (n)
adu|double (adj)
aduial|(evening) twilight (n)
advir|heirloom (n)
aeg|sharp (adj)
aeglir|line of peaks (n)
aeglos|icicle, (lit.) snow-point; snowthorn (a plant) (n)
ael|lake, pool (n)
aelin|lake, pool (n)
aen|*should, could (adv)
ain|*should, could (adv)
aer|*hallowed, holy (adj)
aerlinn|*hymn, (lit.) holy song (n)
aew|(small) bird (n)
aewen|of birds (adj)
agar|blood (n)
aglar|glory, brilliance, splendour, radiance (n)
aglareb|glorious, brilliant (adj)
aglor|brilliant, glorious (adj)
ai¹|hail! (interj)
ai²|*those who (pron)
air|lonely (adj)
îr|*alone (adj)
al-¹|no, not (pref)
al-²|well, happily (pref)
alae|?behold (interj)
alaf|elm (n)
albeth|(word of) good omen (n)
alf|flower (n)
alfirin|immortal, (lit.) not dying; a species of flower (adj n)
alph|swan (n)
alu|wholesome (adj)
alw|wholesome (adj)
alwed|prosperous, fortunate (adj)
am|up (adv)
amar|world, the Earth, (lit.) settlement, the great habitation (n)
amarth|fate, doom (n)
ammarth|fate, doom (n)
amartha-|to define, decree, destine (vb)
amdir|hope [based on reason], (lit.) looking up (n)
amloth|helm crest, (orig.) uprising flower (n)
amon|hill, mountain with steep sides; lump, clump, mass (n)
amrûn|sunrise, east, (lit.) of the uprising (n)
an|to, for (prep)
an-|intensive prefix (pref)
anann|(for) long (adv)
and|long (adj)
ann²|long (adj)
andaith|long-mark (n)
andreth|long-suffering, patience (n)
ang|iron (n)
angerthas|runic alphabetic, (lit.) long rune-rows (n)
anglenna-|to approach (vb)
angren|of iron (adj)
aníra-|to desire (vb)
ann¹|gift (n)
anw|gift (n)
anna-|to give, †add to (vb)
anha-|to give (vb)
anta-|to give, add to (vb)
annon|(great) gate, door (n)
annui|west[ern] (adj)
annûn|sunset, west; (lit.) going down (n)
Anor|Sun (n)
-ant|3rd person past tense (suf)
anwar|awe (n)
aphad-|to follow (vb)
aphadon|follower (n)
ar-|without; by; **beside (pref)
ar(a)-|noble, royal, high (pref)
aran|king, lord, chief, (lit.) high or noble person (n)
aras|deer (n)
arahadhw|throne, (lit.) high seat (n)
archaf|throne, (lit.) high seat (n)
arnad|*kingdom (n)
aranarth|*kingdom (n)
arnediad|unnumbered (adj)
arnoediad|unnumbered, without reckoning (adj)
arod|noble (adj)
arphen|noble, knight (n)
arben|knight (n)
arthor|realm (n)
-as|abstract noun (suf)
ast|light or heat of the sun (n)
astor|loyalty (n)
astorad|loyalty (n)
-ath|collective or group plural (suf)
ath-|easy, easily (pref)
atha-|will (future) (vb)
athae|*healing herb, healing (n adj)
atheg|[little] father; thumb (n)
athelas|kingsfoil, a healing herb (n)
athaelas|*healing herb (n)
athgar|easy (easy to do) (adj)
athgen|easily seen (adj)
athra-¹|to cross (to and fro) (vb)
athra-²|to treat medically (vb)
athrabeth|conversation, debate, (lit.) interchange of words (n)
athrad|ford, crossing (n)
athragared|interaction (n)
athragardh|interaction (n)
aur|(whole) day (n)
auth|dim shape, spectral or vague apparition (n)
ava-|will not, do not (vb)
avad|refusal, reluctance (n)
Gavar|*Refuser (n)
avras|precipice (n)
bain|fair, beautiful; good, wholesome, favorable; fair-haired (adj)
bân|fair, good, wholesome, favorable (adj)
bal-|*to have power (vb)
Balan|Vala (n)
balch|fierce, ferocious (adj)
ban-|?to go (vb)
band|prison, custody, duress (n)
bâr|house, dwelling, home (n)
bar|house, dwelling, home (n)
barad|tower, great towering building (n)
baran|brown, golden-brown (adj)
bardh|home (n)
bardor|home land, native land (n)
barthan|dwelling-house, large building of masonry used as a dwelling (n)
bas(t)|bread (n)
bauglir|constrainer; tyrant, oppressor (n)
baw¹|no, do not! (interj)
baw²|howling (n)
be|in; ?as, like (prep)
belaith|mighty (adj)
beleg|great, mighty; large, big (adj)
bereth|queen, spouse; supreme, sublime (n adj)
besain|the Lady, breadgiver (n)
basoneth|breadgiver (n)
bess|wife (n)
bo|*on (prep)
boda-|to ban, prohibit, refuse, forbid (vb)
bauda-|to ban, prohibit, refuse (vb)
born¹|hot, red (adj)
born²|[stead]fast (adj)
both|fen, marsh (n)
(a)moth|fen, marsh (n)
bragollach|sudden flame (n)
brand¹|towering; tall and massive (adj)
brann|towering, tall and massive (adj)
brand²|steeple (n)
brass|great cliff (n)
brasta-|to tower up, loom (vb)
bregol|quick, sudden (adj)
bragol|sudden (adj)
brethil¹|silver birch (n)
brethil²|princess, (lit.) queen-daughter (n)
bril|glass, crystal (n)
brith|gravel (n)
brithon|pebbly (adj)
brui|loud (adj)
budhu|large fly (n)
cab-|to leap (vb)
cabed|leap (n)
cad|*after (adv)
Cadlaer|July, *After-summer (n)
caer|*flat isle on a river (n)
cáfru|?flea (n)
cai|hedge (n)
cail|fence, palisade of spikes or sharp stakes (n)
cair|ship (n)
cal-|to shine (vb)
calad|light, fire, brightness, shining (n)
calan|day(light) (n)
calar|(portable) lamp (n)
calardan|lampwright (n)
calen|green; fresh, vigorous; †bright (adj)
cam|(cupped) hand, holding hand; handful (n)
camm|hand (n)
can-|to cry out, shout, call (vb)
canad|four (cardinal)
cened²|four (ordinal)
canath|quarter (n)
cannas|[abstract] shape (n)
cant|shape (n)
canthui|fourth (ordinal)
canhui|fourth (ordinal)
cantui|fourth (ordinal)
car-|to do, make (vb)
carach|jaws, rows of teeth (n)
caralluin|*red-blue (adj)
caran|red (adj)
carch|fang (n)
cared|action (n)
carfa-|to talk, speak, use tongue (vb)
carn|deed (n)
carth|deed (n)
carweg|active; busy (adj)
castol|helmet (n)
cathrae|tressure, *headdress (n)
caul|great burden, affliction (n)
caun¹|prince, chief, head (n)
caun²|outcry, clamour (n)
caw-|to taste (vb)
ce|*might, maybe (adv)
ceber|stake, spike (n)
celeb|silver (n)
celebrin|like silver (in hue or worth) (adj)
celeg|*hasty (adj)
cen-|to see, perceive, look (vb)
cened¹|looking (n)
cenedril|mirror, looking-glass, (lit.) looking-crystal (n)
singil|mirror (n)
cerin|circular mound, artificial hill (n)
certh|rune (n)
certhas|runes-rows, runic alphabet (n)
Cerveth|July (n)
ceven|*Earth (n)
ci|thou (pron)
círdan|shipbuilder, shipwright (n)
cirith|cleft, ravine, defile (n)
cîw|fresh, new, renewed (adj)
cîr|fresh, new (adj)
côf|bay (n)
coll¹|cloak, mantle (n)
coll²|hollow (adj)
condir|mayor, *(lit.) chief-man (n)
cor|ring, circle (n)
cordof|pippin, *a type of yellow and red apple (n)
corod|circle (n)
coth|enemy, foe (n)
cova-|to come together, meet; to gather, assemble (vb)
covad(a)-|to bring together, make meet (vb)
craban|bird of crow-kind, *raven (n)
criss|cleft (n)
crist|cleaver (n)
cû|bow (n)
cûd|foe (n)
cuia-|to live (vb)
cuina-|to be alive (vb)
cûl|load (n)
cund|*prince (n)
curu|skill (of the hand), craft, magic (n)
curunír|wizard (n)
cýra-|to renew (vb)
cýron|new-moon (n)
cŷl|*renewal (n)
cŷr|renewed (adj)
dae|shadow (n)
dae-|dreadful, abominable, detestable (pref)
daebeth|blasphemy (n)
daedelos|horrible fear (n)
dael|horror (n)
daer¹|great, large (adj)
daer²|dreadful, abominable, detestable (adj)
dag-|to slay (vb)
dagnir|slayer, bane (n)
dagor|battle (n)
dail|beautiful, fine, delicate, lovely (adj)
deil|beautiful, fine, delicate, lovely (adj)
aphed-|to answer (vb)
dadwen-|to return, go back (vb)
damen-|to return (vb)
dan|back to, (back in return) against, down upon, back on, back again (prep)
den|?against (prep)
dandol-|to return, come back (vb)
dangar-|to undo (vb)
dangen|slain (adj)
dangweth|answer, *(lit.) back-report (n)
danbeth|*answer, (lit.) back-word (n)
danna-|to fall (vb)
dannen|ebb, lowtide (n)
dant|*fall (n)
danwedh|ransom (n)
dar-|*to stop, halt (vb)
daur|league; †stop, pause (n)
de|you (pron)
del|horror (n)
delch|dense (adj)
deloth|abhorrence (n)
delw|thick (of a single thing) (adj)
dern|tough, thrawn (adj)
dev-|to try (vb)
dew-|to fail, miss (vb)
dha|there is (vb)
di¹|beneath, under (prep)
di²|with (prep)
díhena-|*to forgive (vb)
-dil|friend, lover (suf)
-nil|friend, lover (suf)
dim|stair (n)
dîn|silence; silent, quiet (n adj)
tîn³|silent, quiet (adj)
dínen|silent (adj)
tínen|silent (adj)
dîr¹|man (n)
dîr²|hard, difficult (adj)
dirbedui|hard to utter, difficult to pronounce (adj)
dírnaith|wedge-shaped battle-formation, (lit.) man-spearhead (n)
dolen|hidden (adj)
dol(l)|head, hill (n)
dom|blind (adj)
dond|fist (n)
donn|fist (n)
-dor|*king, lord (suf)
dôr|land (n)
dorgannas|shapes of the lands, *geography (n)
dorn|tough, stiff, thrawn, obdurate (adj)
norn|hard; dwarf (adj n)
draug|wolf (n)
drega-|to flee (vb)
dring|hammer (n)
dû|night, dimness; dim, dark (n)
dúath|night shadow, dark/black shadow (n)
duwath|night shadow, dark/black shadow (n)
duin|(large) river (n)
duinen|flood, high tide (n)
dúlin|nightingale (n)
dûn|west (n)
dúnad|descent (n)
dûr|dark (with evil implications), gloomy, hellish (adj)
dýgar|mistaken act; doing a wrong thing (n adj)
dŷl|mistake (n)
dŷr|mistaken, off point, not right (adj)
e|he (pron)
-eb|adjective suffix (suf)
Eblaer|June, ?Before-summer (n)
ech|?you, yourself (singular) (pron)
echad|camp (n)
echad-|to form, make, shape, cut out; (lit.) to shape out (vb)
echil|follower (n)
echor|outer circle; encircling (n adj)
echui|awakening (n)
echuir|early Spring, (lit.) stirring (n)
-ed¹|gerund (suf)
-ad²|gerund (suf)
ed¹|out, out of (prep pref)
-ed²|3rd person singular possessive suffix (suf)
ed²|*it (pron)
edaid|double (adj)
Edhel|Elf (n)
Eledh|Elf (n)
Elen|Elf (n)
edhellen|elvish (adj)
edhelvein|elven fair (adj)
edlen(n)|exiled (adj)
edlon|outsider, stranger (n)
edra-|to open (out) (vb)
edraith|rescue, saving (n)
edregol|in especial (adv)
-eg¹|diminutive/singular ending (suf)
-ig|diminutive/singular ending (suf)
-eg²|2nd person singular familiar possessive suffix (suf)
-egir|2nd person plural familiar possessive suffix (suf)
eglan|forsaken (adj)
egleria-|to glorify (vb)
ego|be off! (interj)
egor|or (conj)
ein-|excellent, admirable (pref)
einior|elder (adj)
eirien|daisy (n)
eitha-¹|to prick with a sharp point, stab; to treat with scorn, insult (vb)
eithad|*insult (n)
eithel|source, spring, well (n)
eithro|*also (adv)
-el|2nd person singular polite possessive suffix (suf)
êl|star (n)
elen|star (n)
elanor|pimpernel, small golden star-shaped flower, (lit.) sun-star (n)
elia-|to cause to prosper, bless (a work), help one (vb)
-elir|2nd person plural polite possessive suffix (suf)
Ell|Elf (n)
Elleth|Elf-maid (n)
Eledhes|*Elf-maid (n)
Ellas|*Elf-maid (n)
Elles|*Elf-maid (n)
Ellon|Elf-man (n)
Eledhon|*Elf-man (n)
elloth|single flower (n)
elo|behold! (interj)
emel|mother (n)
emig|[little] mother, *mommy (n)
-emir|1st person plural exclusive possessive (suf)
en-|*to name (vb)
-en¹|adjective suffix (suf)
-in|adjective suffix (suf)
en¹|of the (prep)
-en²|my, 1st sg. poss. suffix (suf)
en²|1st sg pronoun (pron)
enaid|central, middle (adj)
-enc|our (inclusive), 1st pl. incl. poss. suffix (suf)
-engir|our (inclusive), 1st pl. incl. poss. suffix (suf)
enchui|sixth (ordinal)
encui|sixth (ordinal)
enecthui|sixth (ordinal)
enedh|centre, middle (n)
ened|centre (n)
eneg|six (cardinal)
eneth|*name (n)
ennas|there (adv)
eno|*still (adv)
-ent|their, 3rd pl. poss. suffix (suf)
ent|they, 3rd pl. pronoun (pron)
est²|they, 3rd pl. pronoun (pron)
idi(r)|they, 3rd pl. pronoun (pron)
ith|they, 3rd pl. pronoun (pron)
ephed-|to say out (vb)
ephel|outer fence, surrounding ring (n)
ephola-|?to remember (vb)
er|one, alone (adj)
ereb|single, alone, lonely (adj)
ereg|holly, thorn (n)
felagund|den-dweller; brock, badger (n)
ernil|prince (n)
ero|*only, alone (adv)
ertha-|to unite (vb)
eryn|wood, forest (of trees) (n)
esbin|thin thread, tress (n)
esgal|cast shadow, shade; screen, hiding, veil (n)
est¹|he, she, it, 3rd sg. pronoun (pron)
eth|he, she, it, 3rd sg. pronoun (pron)
is|he, she, it, 3rd sg. pronoun (pron)
esta-|to call, *name (vb)
estel|hope, trust (n)
esten(t)|short (adj)
estola-|to encamp, *erect tents (vb)
estolad|encampment (n)
-eth|feminine ending (suf)
eitha-²|to ease, assist (vb)
ethir¹|mouth of a river, (lit.) outflow (n)
ethir²|spy (n)
ethuil|spring (n)
fae|incarnate spirit (n)
fael¹|gleam of the sun; *gleaming (n adj)
fael²|fair-minded, just, generous (adj)
faen|vapour; [disembodied] spirit (n)
faer|spirit (in general) (n)
fain|white, shimmering, shining; white and shining [thing]; dim, dimmed; filmy, fine-woven; (vague) apparition; cloud (adj n)
fair|quick, ready, prompt (adj)
falas|beach, shore, strand, surf(line) (n)
falch|*cleft, ravine (n)
faloth|large foamy wave (n)
fân|(white) cloud; veil, curtain; form or vision of a spiritual being; spirit [embodied] (n)
fang|beard (n)
fanna-|to veil, cloak (vb)
fanha-|to veil, cloak (vb)
fanui|cloudy, (lit.) having much cloud (adj)
fanwos|mind-picture (of apparition in dream) (n)
faran|rowan (n)
faroth|*hunting (n)
faug|gape (adj)
faw|*breath, puff of breath (n)
Feir|Mortal (n)
fela|mine, boring, tunnel, underground dwelling; minor excavations, den (n)
feleg|cave, mine, underground dwelling (n)
fen(n)|door (n)
fennas|great door, doorway, gateway (n)
fergar|soon done (adj)
fergenol|quick to see or perceive, sharp-sighted or witted (adj)
feria-|to make ready (promptly) (vb)
fern|dead (n adj)
ferui|ready to hand, (quickly) available (adj)
fim|slender, slim (adj)
fîn|(single) hair, filament (n)
find|tress; single hair (n)
finn|tress; single hair (n)
fing|lock of hair (n)
fineg|*lock of hair (n)
finnel|head of hair, fax, mass of long hair; having fine or beautiful hair (n adj)
findel|head of hair, fax, mass of long hair; having fine or beautiful hair (n adj)
fir-|to fade, *die (vb)
Fíreb|Mortal (n)
fíreb|mortal (adj)
Firieth|(Female) Mortal (n)
firin|mortal, dying (adj)
Firion|(Male) Mortal (n)
firith|fading; [late] autumn (n)
flâd|skin (n)
flinc|finch (n)
foen|long sight (n)
forn|north (adj)
for|north (adj)
forod|north (n)
forvo|right hand, right side (n)
fû|path (n)
fuin|night, gloom, darkness (n)
fuir|north (adj)
gaear|sea (n)
aear|sea (n)
gaer²|sea (n)
gaearon|ocean, (lit.) great sea (n)
aearon|*ocean (n)
gaeron|*ocean (n)
gaer¹|awful, fearful (adj)
gal-|to shine clear (vb)
gala-|to grow (vb)
galad|radiance, glittering reflection; light, fire, brightness, shining; bliss (n)
galadh|tree (n)
galadhremmen|tree-meshed (adj)
galenas|pipeweed, nicotiana, *tobacco (n)
galvorn|type of dark metal devised by Eöl, *(lit.) shining-black (n)
gamp|hook, crook (n)
gardh|region (n)
gardhon|province (n)
ardhon|province (n)
gaur|werewolf (n)
gelir|merry (adj)
genedia-|to reckon (vb)
genediad|reckoning (n)
geria-|to ponder (vb)
gil|star; (bright) spark, silver glint, twinkle of light (n)
gail|silver spark (n)
gill|star (n)
gir-|to shudder (vb)
girith|shuddering (n)
Girithron|December, *Shuddering-one (n)
glad|wood (n)
gladh-|to laugh (vb)
glae|grass (n)
glae(gal)|light (as an ethereal substance) (n)
glaer|tale (n)
laer²|song (n)
glam|din, uproar, the confused yelling and bellowing of beasts (n)
glamog|orc (n)
glân¹|white (adj)
glân²|hem, border (n)
glandagol|boundary mark (n)
glan(n)|boundary (n)
glathralvas|flashing glass/crystal, *heliograph (n)
glaur|gold [light or colour] (n adj)
glaw|sunshine (n)
glawar|gold (light or colour) (n)
gleina-|to bound, enclose, limit (vb)
glenna-|*to travel (vb)
glim|voice (n)
glîn(n)|gleam, glint (n)
glintha-|to glance (at) (vb)
glóriel|golden (adj)
glórin|*golden (adj)
gloss|(dazzling) white (adj)
glosui|snow white (adj)
go-|together, co-, com- (pref)
gwa-|together, co-, com- (pref)
go-²|*away (pref)
gobel|village, town (enclosure) (n)
goe|terror, great fear (n)
goeol|*fell, terrible, dire (adj)
gohena-|*to forgive (vb)
golas|foliage, collection of leaves (n)
golass|foliage, collection of leaves (n)
Golodh|one of the wise folk, Noldo (n)
golodh|lore-master, sage (n)
goloth|inflorescence, *collection of flowers (n)
-gon|lord, prince (suf)
gond|stone, rock (n)
gonn|stone, rock (n)
gor|horror, dread, fear (n)
gor-¹|hard, difficult (pref)
gor-²|to warn, urge (vb)
gorbedui|only to be said with horror or grief, lamentable to tell (adj)
gordh¹|difficult, laborious (adj)
gordh²|deep thought (n)
gorgor|extreme horror, terror, haunting fear (n)
gorn¹|revered (adj)
gorn²|hard, stiff, thrawn (adj)
gornod(ui)|hard to count (adj)
gorog|horror (n)
goroth|horror, dread (n)
gorth²|horror (n)
gorth¹|dead; dead (person) (adj n)
gorthad|wraith, spirit of Dead (n)
gorthob|horrible (adj)
govan-|to meet, come to same place (vb)
graw|bear (n)
groga-|to feel terror (vb)
grond|weighty, ponderous (adj)
gronn|weighty, ponderous (adj)
groth|large excavation, delving, underground dwelling (n)
grod|large excavation, delving, underground dwelling (n)
gruitha-|to terrify (vb)
gûl|black arts, sorcery, (evil) knowledge (n)
guldur|black arts, sorcery (n)
gûr|heart (inner mind) (n)
gurgof|traitor (n)
gurth|death (n)
guru|death (n)
guruthos|dread of death, death-horror, shadow of death (n)
gwahae|*far away (adj)
gwae|wind (n)
gwae-|to go, depart (vb)
gwael|?wind (n)
gwaen|stained (adj)
gwaeren|windy (adj)
Gwaeron|March, *Windy-one (n)
gwaew|storm; blow (n)
gwain¹|young, *new (adj)
gwein|young (adj)
gwain²|blond (adj)
gwân|pale, fair (adj)
gwaith|people; region (n)
gwana|fair (n adj)
gwanunig|twin (n)
gwanwen|departed (adj)
gwath|shadow, dim light (n)
gwathra-|to overshadow, dim, veil, obscure (vb)
gwathren|shadowy, dim (adj)
gwathui|*shadowy, of shadow (adj)
gwê|living creature (n)
gwend|maiden (n)
gweneth|maidenhood (n)
gweth-|*to report (vb)
gwîn|youth (n)
gwing|foam, spindrift (n)
gwinig|little-one, baby (n)
Gwirith|April, *Freshness (n)
ha|there you are (interj)
Hadhod|Dwarf (n)
cadhad|dwarf (n)
hadhu|seat (n)
hadhwa-|to seat (vb)
hadhma-|to seat (vb)
hae|far, very far away (adj adv)
haedh|fenced enclosure (n)
haer|remote (adj)
haered|remoteness, (remote) distance (n)
haeron|*distant (adj)
hanar|brother (n)
hawn|brother (n)
honeg|brother (diminutive) (n)
honig|brother (diminutive) (n)
harad|south (n)
harn|south, southern (adj)
harvo|left hand, left side (n)
hathol|axe (n)
haudh|(funeral) mound, grave; heap, piled mound (n)
heb-|to keep (vb)
heledh|glass (n)
hên|child (n)
hen(d)|eye (n)
henneth|window (n)
herdir|master (n)
heryn|lady (n)
heruin|lady (n)
hí|now (adv)
hin|now (adv)
sí(r)|now (adv)
thî|now (adv)
hîl|heir (n)
him¹|ever (adv adj)
him²|cool (adj)
hîr|lord, master (n)
híril|lady (n)
hîth|mist (n)
hithlain|mist thread, grey elvish rope (n)
hithren|grey (adj)
Hithui|November, *Misty-one (n)
hithui|misty (adj)
hol-|to close, shut (vb)
hollen|closed, shut (adj)
hoth|host, horde (n)
hû¹|spirit, shadow (n)
hû²|hound (or ?heart) (n)
huan|great dog, hound (n)
hûn|*heart (n)
huorn|?spirit tree (n)
hwaewar|breeze[?] (n)
gwâw|breeze[?] (n)
hwâ|breeze[?] (n)
wá(wa)|breeze[?] (n)
hwinn|birch (n)
-i|adjectival suffix (suf)
i¹|the (article)
i²|who, that (pron)
iâ|chasm, pit; void, abyss (n)
iach|ford (n)
-ian(d)|-land, country (suf)
iant|bridge (n)
iath|fence (n)
iâth|fence (n)
iaun|wide, extensive, large, roomy, vast, huge (adj)
iand|wide (adj)
iaur|old (adj)
iavas|autumn (n)
íd|extremely, very (adv)
îdh|rest, repose, peace, tranquility (n)
ídhra-|to long for, desire (vb)
-iel¹|daughter; feminine suffix (suf)
-iel²|adjective suffix (suf)
-iel³|perfective-participle (suf)
-ien|feminine ending (suf)
îf|cliff, sheer descent (n)
-il|feminine suffix (suf)
il|*all (adj)
ilaurui|*daily (adj)
im¹|I, I myself; reflexive, self(same) (pron)
im²|between (prep)
im³|valley (n)
imlad|deep valley, narrow valley with steep sides, gap, gully (n)
imrad|path or pass between mountains or trackless forest, *(lit.) valley path (n)
imrath|long narrow valley with road or watercourse running through it lengthwise, *(lit.) valley course (n)
în¹|year (n)
în²|his, *reflexive possessive = his own (pron)
ind|some particular purpose or intention of an individual; heart (n)
inn|some particular purpose or intention of an individual (n)
ínias|annals (n)
innas|*will (n)
-ion¹|-son (suf)
-ion²|-region, -land (suf)
-on(d)|-region, -land (suf)
ion(n)|son (n)
iphant|*aged (adj)
ifant|*aged (adj)
-ir|past of intransitive verbs (suf)
ir|?when, while (conj)
î(r)|impersonal plural pronoun (pron)
írui|desirable, lovely (adj)
Ithil|Moon (n)
ithildin|magical alloy that glows in moonlight, (lit.) moon-star (n)
ithron|Wizard (n)
Ivanneth|September, *Yavanna-ness (n)
laba-|to hop (vb)
lach|(leaping) flame (n)
lhach|leaping flame (n)
lacha-|to flame (vb)
lad|plain, valley (n)
laden|flat, wide (adj)
laeg|fresh and green, viridis, green (of leaves/herbiage) (adj)
laer¹|summer (n)
laew|fresh (adj)
laich|sweet (adj)
leich|sweet (adj)
lain|thread, warp, ‽twine (n)
lala-|to laugh (vb)
lalaith|laughter (n)
lam¹|(physical) tongue; language (n)
lam²|echo (n)
lamma-|to echo (vb)
lammad|*echoing (n)
lammen|of tongue, spoken with tongue (adj)
lanc¹|sharp edge (not of tools), sudden end (n)
lanc²|naked (adj)
land|wide, broad (adj)
lann|wide, broad (adj)
lang|passage; neck (n)
lanthir|waterfall (n)
lass|leaf (n)
las|leaf (n)
lasta-|to listen, give ear (vb)
lasto|listen, *hark (interj)
laudh|gluttonous eating (n)
lavan|animal (n)
le|thee, you (polite) (pron)
lebdas|index finger (n)
leben|five (cardinal)
lebenedh|middle finger (n)
lebent|fourth finger (n)
leber|finger (n)
lebethron|Gondorian hardwood, *(lit.) finger tree (n)
lebig|little finger (n)
legol|[Ilk.] nimble, active, running free (adj)
leithia-|to release (vb)
leithian|release from bondage (n)
lembas|waybread, journey-bread (n)
ledhbas(t)|waybread (n)
lest|girdle (n)
leutha-|to pick (up/out) (vb)
levnui|fifth (ordinal)
lefnui|fifth (ordinal)
leweg|worm (n)
lheweg|ear (n)
lhaw|ears (of one person) (n)
lhim|sliding, gliding, slippery, sleek (adj)
l(h)ô|flood, fenland (n)
(h)law|flood (n)
lô|flood, fenland (n)
lhoer|venom, poison(ousness) (n)
lhoew|poison(ous substance) (n)
lhôn|noise (n)
lhûg|reptile, snake, serpent, worm (n)
lî|people (of one kind or origin) (n)
lîf|link (n)
lim|quick, swift (adj)
limp|clear, sparkling; (bright/clear/gleaming) liquid (adj n)
lín|*thy (pron)
lîn|pool, mere (n)
lind¹|song, chant, singing; singer (n)
glind|*song (n)
glinn|*song (n)
linn|song, chant (n)
lind²|fair (adj)
linna-|to sing, chant (vb)
linnod|type of poetic meter, (lit.) ?seven-chant (n)
lîr|line (n)
lisg|reed (n)
liss|fragrant, sweet (adj)
lissuin|a fragrant flower (n)
lith|ash (n)
lithui|ashen, ashy, of ash, ash-coloured, dusty (adj)
loeg|pool (n)
loen|soaking wet, swamped (adj)
lond|(land-locked) haven (n)
lonn|(land-locked) haven (n)
lonnas|harbourage (n)
loss|snow (n)
los|snow (n)
lossen|snowy (adj)
lost|empty (adj)
loth|flower, single blossom; inflorescence, head of small flowers (n)
lotheg|single flower (n)
Lothron|May, *Flower-ness (n)
loven|echoing (adj)
luin|blue (adj)
lung|heavy (adj)
lûth|blossom, inflorescence (n)
lŷg|snake (n)
ma|good, excellent, that’s right (interj)
mâb|hand (n)
mad-|to eat (vb)
madha|mud (n)
madweg|gluttonous (adj)
mae|well; excellent, admirable (adv adj)
maecheneb|sharp-eye[d] (adj)
maed¹|shapely (adj)
maed²|handy, skillful (adj)
maeg|sharp, piercing (adj)
mael|well (adj)
maelig|wealth, abundance (n)
maen|a treasure (n)
maer|good, excellent, fair (adj)
maeron|artist (n)
maeth|management (n)
maetha-|to handle, wield, use, manage, treat, deal with (vb)
maew|gull (n)
mâf|pile or mass of rock or earth (n)
magor|swordsman (n)
main|prime, chief, pre-eminent (adj)
mallen|golden (adj)
mallorn|gold tree, yellow tree (n)
mallos|golden flower (n)
malt|gold (n)
man|*what, who (pron)
maw|hand (n)
mêd(h)|[Ilk.] wet (adj)
medui|end, final, last (adj)
megil|sword, longsword (n)
megr|sharp-pointed (adj)
mein|first (ordinal)
mel-|to love (vb)
mell|dear, beloved (adj)
mellon|friend (n)
melui|lovely, sweet (adj)
men-|to go (vb)
men¹|us (pron)
men²|road, way (n)
meneg|thousand (cardinal)
menel|the heavens, firmament, region of the stars (n)
mereth|feast (n)
meril|rose (n)
meth|last (adj)
methed|end (n)
mi|*in (prep)
vi|in (prep)
mîdh|dew (n)
milbar|dear home, beloved dwelling [place] (n)
mín|our (pron)
mîn|[thing] between; gap, space, barrier; anything intervening between two other things (n)
min¹|one (cardinal)
min²|peak (n)
minas|tower, fort, city (with a citadel and central watch tower) (n)
minib|eleven (cardinal)
minlamad|?alliteration, (lit.) first-echoing (n)
minna-|to go in, enter (vb)
minui|first (ordinal)
minuial|(dawn) twilight (n)
mîr|jewel, precious thing, treasure (n)
mírdan|jewel smith (n)
míria-|to sparkle like jewels (vb)
mirian|Gondorian coin (n)
míriel|sparkling like jewels, like a jewel (adj)
miruvor|a special wine or cordial (n)
Mîth|*Sinda, Grey-Elf (n)
Mithres|*Grey-Elf (f.) (n)
Mithron|*Grey-Elf (m.) (n)
mith|grey, light grey, pale grey (adj)
mithren|grey (adj)
mithril|Moria-silver, true-silver (n)
molif|wrist, (lit.) hand-link (n)
môr|dark(ness); †night (n)
morchant|shadow cast by light, (lit.) dark shape (n)
morgul|black arts, sorcery, necromancy (n)
morn|black, dark; night (adj n)
moth|dusk (n)
muil|drear[iness] (n adj)
mund|bull (n)
mŷl|gull (n)
na-|to be (vb)
na¹|to, towards, at (prep)
nadha|fetter (n)
naedh|wounding, wound (n)
naer|dreadful, horrible, unendurable (adj)
naergon|woeful lament (n)
naeth|woe (n)
nail|third (ordinal)
naith|spearhead, gore, wedge, narrow prominitory; angle (n)
nalla-|to cry (vb)
nallan|call (n)
nalla|call (n)
nallar|call (n)
nalloth|call (n)
na(n)|of; with, along with, accompanied by, provided with or by, associated with, marked with (prep)
na²|of; with, along with, accompanied by, provided with or by, associated with, marked with (prep)
nan|of (prep)
nan(d)|vale, valley (n)
Narbeleth|October, Sun-fading, Sun-waning (n)
narch|bitter-biting (adj)
narn|tale (n)
narthan|beacon (n)
Narwain|January, *(lit.) New Fire (n)
natha-|to bring help to, save, rescue (vb)
nathal|guest (n)
naub|thumb (n)
lebed|thumb (n)
naug|dwarf; dwarf(ed), stunted (n)
naur|fire (n)
naw|hollow (adj)
ned|first (n)
neder|nine (cardinal)
nedia-|to count (vb)
nedrui|ninth (ordinal)
nef|hither, on this (the speaker’s) side of; †beyond [loose translation] (prep)
negen|sharp, angular (adj)
neitha-|to wrong, deprive (vb)
neithan|one deprived, exile whose rights and goods have been confiscated (n)
nelchaenen|*thirtieth (ordinal)
neldor|beech (n)
neledh|three (cardinal)
nêl|three (cardinal)
nelui|third (ordinal)
nen|water; lake, pool; (lesser) river (n)
nerthui|ninth (ordinal)
ness|headland (n)
neth|(little) girl; sister (diminutive) (n)
nethel|sister (n)
nethig|sister, girl (diminutive) (n)
netheg|girl (diminutive) (n)
nîth|sister (n)
niben|petty (adj)
nidh-|to will (vb)
nîdh¹|juice (n)
nîdh²|full vigorous purpose, exertion of will (n)
nídha-|to be determined to (vb)
niged|little finger (n)
nim|white (adj)
nimp|pale, pallid, white (adj)
nin|me (pron)
nín|my (pron)
nîn¹|wet, *watery (adj)
nîn²|tear (n)
ninglor|golden water-flower (n)
ninniach|rainbow (n)
Nínui|February, *Watery (n)
niphred|pallor (n)
niphredil|white flower (similar to a snowdrop); *(lit.) pale point (n)
nirnaeth|tears (n)
nivol|phantom, a seeming (n)
nîf|phantom, a seeming (n)
nobad|thumb and index finger as a pair, *(lit.) pickers (n)
nod-|to count (vb)
Noegin|Petty Dwarf (n)
Nogoth|[Greater] Dwarf (n)
Nogon|[Greater] Dwarf (n)
Nogotheg|Dwarflet (n)
Noll|Noldo (n)
nor-|to run (or leap) of animals or men (vb)
nordh|oak (n)
north|riding, race (of people running), charge or gallop (n)
northa-|to make run (vb)
Nórui|June, *Fiery (n)
nos(s)|family, kindred, clan, house; race, tribe, people (n)
nost|house, family (n)
nothlir|folk, family (n)
-nt|past of transitive verbs (suf)
nu|under (prep)
nuitha-|to stunt, prevent from coming to completion, stop short, not allow to continue (vb)
-o|imperative (suf)
o|from, of (prep)
odog|seven (cardinal)
odo|seven (cardinal)
oel|cool (adj)
oer|nasty (adj)
oew|an evil deed (n)
-og|singular suffix (suf)
Ogol|?Elf (n)
ogol|bad, evil, wrong; gloom(y) (adj)
ogron|wicked or evil person (n)
-ol|continuative participle (suf)
-on¹|masculine suffix (suf)
-on²|augmentative suffix (suf)
oneth|*giving (n)
onna-|*to birth, give birth to (vb)
onnen|born (adj)
Onod|Ent (n)
-or|agental suffix (suf)
or-|-day (pref)
Oraeron|Sea-day, *Thursday (n)
Oranor|*(lit.) Sun-day, Sunday (n)
Orbelain|*Day of the Valar, Friday (n)
orch|Orc (n)
orchal|tall (adj)
Orgaladh|Day of the Tree, *Tuesday (n)
Orgaladhad|Day of the Two Trees, *Tuesday (n)
Orgilion|*Star-day, Saturday (n)
Orithil|*Moon-day, Monday (n)
Ormenel|*Heavens-day, Wednesday (n)
orn|(tall straight) tree (n)
orod|mountain (n)
orodben|mountaineer, one living in the mountains (n)
oroth|rage, anger (n)
ortha-|to raise (vb)
orthad|*raising (n)
os|*about (prep)
ost|fort, fortress, stronghold, citadel; fortified town; enclosure (n)
-oth|augmentative suffix (suf)
-os|augmentative suffix (suf)
oth-|[wrong] with a bad sense; unsuitable, bad, improper, useless, wrong (pref)
othgar(ed)|doing wrong, *wrong doing (n)
othgarn|misdeed (n)
othol|stranger, guest (n)
athal|stranger, guest (n)
othrond|underground stronghold (n)
othui|seventh (ordinal)
ochui|seventh (ordinal)
odothui|seventh (ordinal)
pad-|to step, walk (vb)
pâd|a step (action); track, road; ford (n)
padra-|to walk (vb)
pae|ten (cardinal)
caen|ten (cardinal)
paean|ten (cardinal)
paenui|tenth (ordinal)
caenui|tenth (ordinal)
paeth|speech (n)
palan|afar, abroad, far and wide (adv)
palan-díriel|far-gazer (n)
palan-tîriel|*far-gazer (n)
pân|all (adj)
pant|full (adj)
paran|bare, naked; smooth, shaven (adj)
parch|naked (of persons) (adj)
parth|field, enclosed grassland, sward (n)
paur|fist, closed hand (n)
ped-|to say, speak (vb)
pedh-|to fall in steep slant, incline, slope (vb)
pedui|*utterable, pronouncable, able to be spoken (adj)
pedweg|talkative, saying a lot (adj)
pel-|to fade, wane (vb)
pêl|*fenced field (n)
peleth|waning (n)
pen-|to have not (vb)
pen¹|without, lacking, -less (prep pref)
pen²|one, somebody, anybody (pron)
penbed|not pronouncable (adj)
pend|slope, steep incline, hill side; sloping (down), steeply inclined (n adj)
penedh|Elf (n)
pengolodh|teaching sage, doctor (of lore), teacher of lore (n)
penna-|to come down (in a slant), fall (vb)
pennod|without count (adj)
pennoediad|innumerable (adj)
per-|half (pref)
Perian|Halfling, Hobbit (n)
peth|word (n)
pethron|speaker, reciter (n)
pîn|little (adj)
pind|crest, ridge (n)
pirin|flower that opened and shut quickly with any change of light (n)
plad|palm, flat of the hand (n)
plada-|to feel with the hand, stroke (vb)
-ra|many Sindarin adverbs end in [this] (suf)
râd|path, pass (n)
raeda-|to catch in a net (vb)
raen¹|netted, enlaced (adj)
raen²|smiling, gracious, sweet-faced (adj)
raew|net (n)
raef|net (n)
rain|erratic wandering (n)
ram|wall (n)
rammas|great wall (n)
randir|wanderer, wandering man, pilgrim (n)
rant|course, water-channel; lode (n)
raph|?rope, strap (n)
rasg|wain, *wagon, cart (n)
rach|wain (n)
rass|horn (n)
ras(t)|cape, shore (n)
cast|cape, headland (n)
rath|street (n)
raud¹|noble, eminent; lofty, high, tall; excellent (adj)
raud²|metal (n)
raug|demon, powerful hostile and terrible creature (n)
graug|demon, powerful hostile and terrible creature (n)
Raun|Moon (n)
raw|wing (n)
rem|mesh, net (for catching) (n)
remmen|entangled, meshed, netted, woven (adj)
-ren|adjective suffix (suf)
rest|*cut (n)
reth|*climber (n)
reth-|to remain in same place (vb)
rhach|curse (n)
rhaed|peculiar hue, (special) fashion (n)
rhîd|peculiar hue, (special) fashion (n)
rhanc|awkward, hard (adj)
rhae|easy (adj)
rhaw¹|wild (adj)
rhaw²|flesh, body (n)
rhond|body (n)
rhîw|winter (n)
rhosc|russet (adj)
rhovan|wilderness; wild beast (n)
rhu-|evil- (pref)
rhû¹|evil, wicked (n adj)
rhû²|matter (n)
rhudol|unwelcome, coming with evil omen or intent (adj n)
rhugar|evil deed (n)
rhugarol|wicked, doing evil (adj)
rhûn|east (n)
rûn|east (n)
rhúnen|eastern (adj)
rî|wreath, garland (n)
rían|queen (n)
rîdh|sown field (n)
-riel|crowned maiden (suf)
rîf|bark (n)
-rim|collective or group plural (suf)
rim|host, great number, people (of one kind or origin) (n)
rîn|remembrance (n)
ring|cold, chill (adj)
riss|cleft; cleft, cloven, separate (n)
ritha-|to try, strive (vb)
raitha-|to try, strive (vb)
reitha-|to try, strive (vb)
ro-|*superlative (pref)
roch|horse (n)
rochben|rider (n)
rochon|rider (n)
rochir|knight, horse-lord (n)
rohir|knight (n)
rodel|lady, high lady (n)
Rodon|Vala (n)
Rodyn|alternate name of the last day of the Eldarin six-day week (n)
rom|horn, trumpet (n)
-(r)on|agental suffix (suf)
rond|(vaulted or arched) roof; vaulted chamber or cavern; heavens [as a roof of the world] (n)
ross¹|rain; spindrift, spray, foam (n)
ross²|red-haired, copper-coloured (adj)
rost|rainy (adj)
rovaed|[most] skillful (adj)
ravaed|skillful (adj)
roval|winged (adj n)
rûdh|bald (n)
ruin|red flame; fiery red (n adj)
ruist|fireplace, hearth (n)
ron|smoothed by polishing (adj)
rusc|fox (n)
rust|copper (n)
rustui|copper (adj)
rûth|wrath, anger (n)
ruthra-|to rage (vb)
sabar|delving (n)
sad|place, spot (n)
sâdh|sward, turf (n)
sador|steadfast, trusty, loyal (adj)
sadron|trusty follower, loyal companion (n)
sadar|trusty follower, loyal companion (n)
sael|wise (adj)
said|private, separate, not common, excluded (adj)
sam|chamber (n)
sammar|*neighbor (n)
ahamar|*neighbor (n)
san|that (pron)
sant|garden, field, yard (n)
sarch|grave (n)
sarn|(small) stone, pebble; stony (place) (n adj)
saur|bad (of food), putrid (adj)
sav-|to have (vb)
saw|filth, putrescence (n)
seidia-|to set aside, appropriate to a special purpose or owner (vb)
sell|*daughter (n)
sen|this (pron)
then|*this (pron)
send|?rest (n)
sennas|guesthouse (n)
sennui|?rather, instead (adv)
sereg|blood (n)
seregon|stonecrop, plant with red flowers, (lit.) blood of stone (n)
serni|shingle, pebble bank (n)
seron|lover (n)
sí|here, in this place (of speaker) (adv)
sigil|necklace (n)
síla-|*to shine (vb)
silef|crystal (white) (n adj)
silivren|(white) glittering, crystalline (adj)
silevren|like silef (crystal) (adj)
sír|*today, this day (n)
sîr|river, stream (n)
sirith|flowing (n)
sui|*as (prep)
suila-|to greet (vb)
suilad|greeting (n)
suilanna-|to greet, *give greeting (vb)
sûl|wind (n)
tachol|clasp, brooch (n)
tâd|two (cardinal)
tad-dal|two-legged (adj)
tadui|second (ordinal)
edwen|second (ordinal)
taeg|boundary, limit, boundary line (n)
taer|lofty (adj)
tagol|post, mark (n)
taid|supporting, second in command (adj)
taith|sign, symbol, mark (n)
tâl|foot; [lower] end (n)
talan|platform, flat space, flet [Middle English = ‘floor’] (n)
talath|flat lands, plain, vale (n)
dalath|plain, low lying/flat ground (n)
talf|wang, flat field, topographical flat area (n)
talraph|stirrup (n)
tân|builder, smith, wright, artificer (n)
tarch|stiff, rough (or tough) (adj)
tarlang|proud, (lit.) stiff-necked; stiff neck (a nickname applied to men of haughty carriage or mood); the stiff/tough passage (adj n)
tas|index finger (n)
tathar|willow (tree) (n)
tathren|of willow(s) (adj)
taug|firm, strong, (?withstand) (adj)
taur|forest, wood (n)
tauron|forester (n)
tavn|thing made by handicraft (n)
taw¹|wood as material (n)
taw²|thither (adv)
tawar|forest (n)
tawen|wood (of material), ?wooden (of make) (adj)
tewch|(?chip) (n)
tegil|pen (n)
teitha-|to write, draw, inscribe, make marks or signs (vb)
teleir|*Telerin (adj)
ten|*it, passive voice marker (pron)
têw|letter (n)
tîw|*letter (n)
-th|abstract noun (suf)
thalion|strong, dauntless (adj n)
thanc|forked (adj n)
thand|shield (n)
thang|oppression, pressure (n)
thangail|shield-fence, shield-wall (n)
thar|across, athwart, over (prep pref)
tharan|vigorous (adj)
thaur|abominable, horrible (adj)
thel-|to intend, mean, purpose, resolve, will (vb)
Thend|*Sinda, Grey-Elf (n)
Thenneth|*Grey-Elf (f.) (n)
Thennor|*Grey-Elf (m.) (n)
thent|short (adj)
thenn|short (adj)
theria-|to be vigorous, flourish (vb)
thind|grey (adj)
thinn|grey (adj)
thîr|face (n)
tho-|*will be (vb)
thôl|helmet, helm (n)
thôn|pine-tree (n)
thond|root (n)
thoniel|kindler (in the past) (adj)
thorn¹|steadfast (adj)
thoron|eagle (n)
thorn²|eagle (n)
thos|puff (of air) (n)
thoss|fear (n)
thû¹|horrible darkness, black mist (n)
thû²|movement of spirit (n)
thurin|secret, hidden (adj)
ti|*they (pron)
till|point, spike, (sharp) horn, tine, ending (n)
tîn¹|spark, sparkle, twinkle of stars (n)
tin|spark, sparkle, twinkle of stars (n)
tîn²|his (pron)
tinnu|*twilight (n)
tir-|to look (towards), watch (over), guard (vb)
tíra-|to see (vb)
tiria-|to watch, gaze; to ward, guard (vb)
tirith|watching, guarding, watch, ward, guard (n)
tirnen|guarded (adj)
tol-|to come (vb)
toleg|*sticker-up (n)
tolch|*sticker-up (n)
tol(l)|island, (high steep-sided) isle (n)
tollui|eighth (ordinal)
tolhui|eighth (ordinal)
tolothen|eighth (ordinal)
tolthui|eighth (ordinal)
tolodh|eight (cardinal)
tolod|eight (cardinal)
torech|lair, (secret) hole, excavation (n)
torn¹|burial mound (n)
tor|the Dead (n)
torn²|hidden, secret (adj)
Torog|Troll (n)
trann|shire, *county, adminitrative region (n)
trunc|great stake (n)
tuil|spring (n)
tum|valley, vale (n)
tûr|master (n)
-u|a person or being (suf)
ú-|no, not, negative; impossible (pref)
û|no, not (adv interj)
úbedui|not fit to say, unspeakable (adj)
úgarol|idling, not now doing or making (adj)
úgarth|trespass, *(lit.) misdeed (n)
-ui|-ful, having quality, adjective suffix; [as verbal suffix] possibility, suitability, *-able (suf)
ui|ever (adv)
ui-|twi- (pref)
uial|twilight, evendim (n)
uilos|white flower like a star (n)
uir|*fiery (adj)
úlan(n)|narrow, (lit.) not broad (adj)
úland|narrow, (lit.) not broad (adj)
ungol|spider (n)
únodui|countless (adj)
ûr|fire (n)
urug|bogey (n)
Úrui|August, *Hot-one (n)
úthaes|inducement to do wrong, *temptation (n)
úvelui|not amiable, unloveable (adj)
wanedhel|elven fair (adj)
vanedhel|elven fair (adj)
-we|person, being, individual (suf)
-weg²|*name suffix (suf)
-weg¹|active in doing (suf)
-wen|maiden, *female suffix (suf)
ylf|drinking-vessel, *cup (n)
ýneg|twelve (cardinal)
yneb|*twelve (cardinal)
inib|*twelve (cardinal)
