#separator:tab
#html:true
#guid column:1
#tags column:3
"B-N|kF-#aW"	(1) -(r)on; (2) -ir; (3) -or	agental suffix (suf)	
uVIG^v8O6c	(1) -as; (2) -eth; (3) -ith; (4) -os; (5) -ri; (6) -th	abstract noun (suf)	
"q#_D>%3v`d"	(1) -ath; (2) -rim	collective or group plural (suf)	
cR~9I.p{0m	(1) -dil; (2) -nil	friend, lover (suf)	
bAqWVOA|%g	(1) -(i)ol; (2) -iel; (3) -in; (4) -r(i)ol; (5) -ra; (6) -ren; (7) -thol; (8) -ui; (9) -wed	adjective suffix (suf)	
kz5yv)UUli	(1) -enc; (2) -engir	our (inclusive), 1st pl. incl. poss. suffix (suf)	
Bur$pWGRo6	(1) -eth; (2) -ien	feminine ending (suf)	
xgq2B%*x8T	(1) -ion; (2) -on(d) (Social Relations)	-region, -land (suf)	
EJ48R}>BAu	(1) -on; (2) -os; (3) -oth (Grammar)	augmentative suffix (suf)	
i@:yF0VZU	(1) Edhel; (2) Eledh; (3) Elen; (4) Ell; (5) penedh; (6) penn	Elf (n)	
k46YHinH>/	Eledhes	*Elf-maid (n)	
"O+P#vCjhqY"	(1) Ithil; (2) Raun; (3) Rân	Moon (n)	
ei%p!]X=`c	(1) Mithres; (2) Thenneth	*Grey-Elf (f.) (n)	
GiNT2:0.(A	(1) Mithron; (2) Thennor	*Grey-Elf (m.) (n)	
JJpmg1;acu	(1) Mîth; (2) Thend	*Sinda, Grey-Elf (n)	
M?VChargAH	Nogoth	[Greater] Dwarf (n)	
"PEisU7#!^s"	(1) a; (2) ae (interj)	O! (interj)	
y30$t9h5xj	adbannad(a)-	to refill (vb)	
j|Ca9`{cjU	(1) adh; (2) ah	and (conj)	
eCBrR&6u{A	(1) adu; (2) edaid	double (adj)	
t+m[/Vp3ge	(1) aer; (2) gaear; (3) oear; (4) saroth	sea (n)	
zlHQ^g=g15	ael	lake, pool (n)	
Hq$mBSWfH2	(1) aen; (2) ain	*should, could (adv)	
D(pK.$O!AD	sereg	blood (n)	
rBj5mcYmR)	sammar	*neighbor (n)	
C8c+R=5h&7	(1) amarth; (2) ammarth	fate, doom (n)	
EwK%v8*b}i	(1) and; (2) ann	long (adj)	
bSS7d&A/]d	ann (Possession and Trade)	gift (n)	
t1N8v=t$S=	anna- (Emotion)	to thank (vb)	
"y_Cpc#k#f="	annad	thanks (n)	
J>@u5Io6&{	aphad-	to follow (vb)	
"PwM=j$#//n"	(1) aphadon; (2) echil	follower (n)	
nIFoSUazWd	dambed- [nd-]	to answer (vb)	
s^:k_4[i^f	(1) archadhu; (2) archaf	throne, (lit.) high seat (n)	
c=kEZ5=UvW	arnad	*kingdom (n)	
Frdir8iBX1	(1) arben; (2) rohir	knight (n)	
Jw>dgUkd{_	(1) ardhon; (2) gardhon	province (n)	
E&x7I?G/Sq	(1) astor; (2) astorad	loyalty (n)	
NEmE:}1X@|	othol	stranger, guest (n)	
ILk>Flxp2Z	athragared	interaction (n)	
"t7NrC.G#Lv"	balaen	divine (adj)	
w5q9DE~hu;	balas	divinity, divine power (n)	
p~sOq,ncc.	maf	sheep (n)	
"D#.BvVaYwH"	(1) banath; (2) beinas; (3) gwanwen; (4) gwanweth	beauty (n)	
O?`0{i%.SA	(1) brand; (2) brann (adj)	towering, tall and massive, [N.] high; lofty, noble, fine (adj)	
obiE)YWKih	(1) pae; (2) paean; (3) sath	ten (cardinal)	
cL:LKFLnY|	paenui	tenth (ordinal)	
NnW]/wA`.8	caphaen	forty (cardinal)	
IPe:nR|E8>	(1) camm; (2) mab; (3) maw; (4) mâb	hand (n)	
e,ZdB/%p%S	paegan	fourteen (cardinal)	
G.yQ{*CdA)	canthui	fourth (ordinal)	
I8vY,54r-2	carth	deed (n)	
u~pEK|M&tt	(1) coll; (2) naw (adj, Spatial Relations)	hollow (adj)	
e.UfRCXelF	colron	bearer (n)	
fz_HwF1-dF	(1) corod; (2) rind; (3) ringorn	circle (n)	
K}(P>]6@2v	(1) cothren; (2) cuid	hostile (adj)	
G{gkCa(H~^	dammen- [nd-]	to return, go back (vb)	
n27,G,)CbX	(1) angos; (2) dael [nd-]; (3) del; (4) gorog; (5) goroth [ng-]	horror (n)	
s+]yWifOJ2	(1) dail; (2) deil	beautiful, fine, delicate, lovely (adj)	
EM;_8HL.AH	(1) dond; (2) donn; (3) paur	fist (n)	
"H*.V_2Ud{#"	(1) duwath; (2) dúath	night shadow, dark/black shadow, [N.] night-shade (n)	
HuX3Xf6pdO	(1) díhena-; (2) gohena-	*to forgive (vb)	
D,Pr}}I/<^	dínen	silent (adj)	
d$BVf9[9xh	echuiru-	to come to life (vb)	
Ag68Md_z.6	(1) edhelvein; (2) vanedhel	elven fair (adj)	
u&o?p3DRYs	tadui	second (ordinal)	
"xy2<oajq#T"	egelren	different, strange (adj)	
iI5=gO&tV8	egol	else, something else (adv n)	
I:-T=IJwVD	ethia-	to ease, assist (vb)	
d]?</8Xtpa	(1) el; (2) elen; (3) gail; (4) êl	star (n)	
w?jtCSnuFm	enaidh	central, middle (adj)	
PtxrEOEry:	enchui	sixth (ordinal)	
LK5,Iw%M-l	enephaen	sixty (cardinal)	
x~$,sUs731	paeneg	sixteen (cardinal)	
iAWw*.3$9i	(1) ath; (2) atha; (3) ent; (4) est; (5) idi(r); (6) ith	they, 3rd pl. pronoun (pron)	
NEb+<X0mET	eriab	badger (n)	
s>nn+Kh?EI	(1) est; (2) eth; (3) is	he, she, it, 3rd sg. pronoun (pron)	
Nu)-`7xz4a	(1) esten(t); (2) thenn; (3) thent	short (adj)	
"O*N$Ytb#<C"	(1) fanha-; (2) fanna-	to veil, cloak (vb)	
fj>Fl6|e/2	(1) faus(t); (2) luibri	thirst (n)	
iZatiqhc}B	(1) for; (2) fuir	north (adj)	
iw>@L!C=Pr	(1) glind; (2) glinn	*song (n)	
"o}b`#Y1k3Q"	(1) golas; (2) golass	foliage, collection of leaves (n)	
Eyz9@V9F|P	raug	demon, powerful hostile and terrible creature (n)	
PXO]MNWR3T	(1) grond; (2) gronn (adj)	weighty, ponderous (adj)	
O.q%C?K5]|	(1) gwabeth; (2) pethas	sentence, phrase (n)	
"F|ft[4])#_"	gwadoras	union, association, fellowship, society (n)	
Rj8|=`>mx<	(1) gwe; (2) pe	we (inclusive) (pron)	
w%sUa%q%(l	(1) gwem; (2) leweg; (3) terch	worm (n)	
vrBl~:AwOc	(1) gwen; (2) pen	us (inclusive) (pron)	
IL`<>L_mdC	(1) gwâw; (2) hwaewar; (3) hwâ; (4) wá(wa)	breeze[?] (n)	
jt1}^Oyc}b	(1) gwîn; (2) pîn (pron)	our (inclusive) (pron)	
taIV+1k[dU	(1) hadhma-; (2) hadhwa-	to seat (vb)	
f=d>8,rK`|	(1) hanar; (2) hawn; (3) muindor; (4) tôr	brother (n)	
B^4wHm,YwK	hav-	to pray (vb)	
yTsG/M8W,+	(1) brennil; (2) heruin; (3) heryn; (4) hiril; (5) híril	lady (n)	
g;o1NJ+eQ@	oel	cool (adj)	
FU3nYH=SAp	hí	now (adv)	
BvAT&H?v51	(1) hithren; (2) mith; (3) mithren; (4) musc; (5) thinn	grey (adj)	
wQIEn$nVY]	(1) honeg; (2) honig	brother (diminutive) (n)	
dp+DH~ga=(	porochuil	hen (n)	
Idb=rTehuX	(1) iath; (2) iâth	fence (n)	
ES_r`I*}}-	pista-	to suppose (vb)	
M$=;9}mM^y	inib	*twelve (cardinal)	
H&A20o;!-5	(1) gur; (2) laich; (3) leich	sweet (adj)	
Ny,p)Xvx27	loch	ringlet (n)	
wTCrllRs7d	(1) lebdas; (2) tas	index finger (n)	
MqvB,4~*lr	naub	thumb (n)	
ocDjP5+xLD	paeleben	fifteen (cardinal)	
j-LBNZjrd?	(1) lebig; (2) niged	little finger (n)	
K:*Yu<;,(V	ledil	key (n)	
jch>~<~Nkw	(1) lefnui; (2) levnui	fifth (ordinal)	
Q,%&7-m<2`	lhassa-	to hear (vb)	
>pqi|{OOC	(1) ging; (2) lhingril; (3) ungol	spider (n)	
yFZADe>XVf	loss (Physical World)	snow (n)	
Fj~J[(<NYq	maew	gull (n)	
wQrauKKp07	(1) mann; (2) math	food (n)	
z6K<-1c>*+	(1) mein; (2) minui	first (ordinal)	
"Jn{p#F0Atb"	(1) melethor; (2) melethril; (3) melethron; (4) seron	lover (n)	
fcmQmwIZSb	(1) mib-; (2) mítha-	to kiss (vb)	
iNBz2?be5w	miru	wine (n)	
l)fFAm_&y[	(1) nail; (2) nelui	third (ordinal)	
D=VU-z7,@_	(1) nalla; (2) nallan; (3) nallar; (4) nalloth	call (n)	
NFt/r4q)mn	paeneder	nineteen (cardinal)	
qJZ,1l{>_4	(1) nedia-; (2) nod-; (3) nœdia-	to count (vb)	
dr8.q~<AUP	nedrui	ninth (ordinal)	
m1H+tgST+H	paenel	thirteen (cardinal)	
wUy~.cgu/b	neledh	three (cardinal)	
dO`Dm:1/RE	(1) muinthel; (2) nethel; (3) nîth; (4) thêl	sister (n)	
nJ1LVy/<m4	(1) nivol; (2) nîf	phantom, a seeming (n)	
uqnWdjv!xm	nuru-	to growl, grumble (vb)	
cmW]2UHj6&	(1) nuir; (2) orvedui	yesterday (n)	
Cli8w(m!1x	(1) ochui; (2) odothui; (3) othui	seventh (ordinal)	
s&xC;&!H&l	(1) odo; (2) odog (cardinal)	seven (cardinal)	
l@r::dT]>r	(1) odinthos; (2) paenodog	seventeen (cardinal)	
z8?|!fYGg>	odophaen	seventy (cardinal)	
OwpN66%ndT	oreth	hour (n)	
j0fM28|cbu	paedolodh	eighteen (cardinal)	
IOg!,p(,h=	pechof	squirrel (n)	
m]25^)V.>~	pelu-	to fence, enclose (vb)	
zs;)1>/.x|	perna-	to turn (vb)	
kHg]02oj1C	pimp	tail (n)	
Dd5MA-]+!e	rach	danger (n)	
c^9)pjyQ@3	rachui	dangerous (adj)	
y?fQnJa[%d	(1) gwinn; (2) raef; (3) raew	net (n)	
GwQKNrA`4K	rhugaron	sinner (n)	
xVtD:q]~LK	(1) gog; (2) gwag; (3) rhaen	crooked (adj)	
fRc,+}:V92	(1) raitha-; (2) reitha-	to try, strive (vb)	
dg>O<{yxQp	(1) rhaed; (2) rhîd	peculiar hue, (special) fashion (n)	
jT9%s%p[sS	rhosc	(1) russet, [N.] brown; (2) russet, brown (adj)	
reg~uw<r*d	rhîf	brink, brim (n)	
z]^R0sq-t{	(1) rochben; (2) rochon	rider (n)	
D7{5(a47ii	rusc	fox (n)	
DH&hN-<[aR	rust (Physical Acts and Materials)	copper (n)	
yq(6v3?rP$	(1) sa; (2) san (pron)	that (pron)	
I,8!9$AgX|	sadron	trusty follower, loyal companion (n)	
Q;K){Rs4P.	(1) se; (2) sen; (3) then	this (pron)	
miwFP*![x/	suithlas	(1) tea; (2) tea, *(lit.) drink of leaf (n)	
v>ow~14Nf8	theinas	law, rule (n)	
v0@p@X*e/U	(1) thorn; (2) thoron	eagle (n)	
l2LG!I;h@:	(1) tin; (2) tîn (n)	spark, sparkle, twinkle of stars (n)	
qP_[zc_/qC	(1) tolch; (2) toleg	*sticker-up (n)	
pO8E[Y3gmM	(1) tolhui; (2) tollui	eighth (ordinal)	
OVim8HJT7x	tolodh	eight (cardinal)	
"m0?uHr#yAs"	tuilu-	to bud, open (of flowers and leaves) (vb)	
IB^&e][uqb	(1) úlan(n); (2) úland	narrow, (lit.) not broad (adj)	
Gvg%@(MCqZ	(a)moth	fen, marsh (n)	
Q2)($*;@Zz	-ad (Grammar)	(1) dual; (2) noun-suffix (suf)	
d<-v?5JZe$	-ad	gerund (suf)	
l?dV{1MnpE	-ant	(1) 3rd person past tense; (2) regular past tense (suf)	
"GMFop`u4#/"	-a	(1) [old] genitive suffix; (2) genitive suffix (suf)	
RhmX}041g?	-dor	*king, lord (suf)	
l/1dvkP1}V	-ed	(1) 3rd person singular possessive suffix; (2) gerund (suf)	
"b#mUGGFHSS"	-egir	2nd person plural familiar possessive suffix (suf)	
EbPO9D5Z!4	-eg (Grammar)	(1) 2nd person singular familiar possessive suffix; (2) diminutive/singular ending (suf)	
GQ4CnEIrl.	-elir	2nd person plural polite possessive suffix (suf)	
f[f@N(]US&	-el	2nd person singular polite possessive suffix (suf)	
O5d~;t]C=<	-emir	1st person plural exclusive possessive (suf)	
DmSYvt8NmC	-ent	their, 3rd pl. poss. suffix (suf)	
GzBd@Cny?s	-en	(1) adjective suffix; (2) my, 1st sg. poss. suffix (suf)	
DIK6x^kd//	-garn	-made (suf)	
i:4{.L!).w	-gon (Social Relations)	lord, prince; [N.] valour (suf)	
qwOsL-vl:]	-ian(d)	(1) -land; (2) -land, country (suf)	
yDL2:Q}tRi	-iel (Grammar)	perfective-participle (suf)	
xk)]CPy=46	-iel (Mankind)	(1) daughter; feminine suffix; (2) name suffix (suf)	
bc*n5a(3i3	-ig	diminutive/singular ending (suf)	
JDCJYo}iz2	-il	feminine suffix (suf)	
xBDVKcO9V;	-ion (Mankind)	(1) -son; (2) son (suf)	
v{_JQxxZ$`	-ir (Grammar)	past of intransitive verbs (suf)	
pPeYc8Ubrp	(1) -(i)on; (2) -eg; (3) -i	adjectival suffix (suf)	
y$h`U6;,l@	-nt	past of transitive verbs (suf)	
Oe;ESDV>}I	-og	singular suffix (suf)	
bNUklL;hC$	-ol	continuative [active] participle; adjective suffix (suf)	
Jbq0MN85/0	(1) -on; (2) -we (Mankind)	masculine suffix (suf)	
ni75KvX*?2	-o	imperative (suf)	
jh*L}-T)|:	-ra	many Sindarin adverbs end in [this] (suf)	
$<f/bUOv%	-riel	crowned maiden (suf)	
"BG56#7I^8;"	-ui	-ful, having quality, adjective suffix; [as verbal suffix] possibility, suitability, *-able (suf)	
I@Z=VoJe)Y	-u	a person or being (suf)	
H7NfZ>1De~	-weg	active in doing (suf)	
rlN.(h7$N%	-weg	active in doing (suf)	
y/hui8!gEd	-wen	maiden, *female suffix (suf)	
F3Mmd0GIO%	-we	person, being, individual; [N.] masculine suffix (suf)	
hI=nfCAdZ[	Adan	Man (as a species) (n)	
eYp1(^sN6d	Aeni	(female) angel (n)	
Qa4Au%IF,6	Aenu	(male) angel (n)	
pNuJNv147V	(1) Anaur; (2) Anor	Sun (n)	
eyM9^]lrc_	Balan	(1) Power, God; (2) Vala, [N.] Power (n)	
jITCmm^zu{	(1) Cerfeth; (2) Cerveth	July (n)	
k/x|kWH-RC	Eledhon	*Elf-man (n)	
MS1T}t?$97	Elleth	Elf-maid (n)	
dKAZFM!K~3	Ellon	Elf-man (n)	
ewh(=ZLGiC	Eru	God (n)	
HUET$OR~<[	Feir	Mortal, [N.] mortal man (n)	
sBS,z}s>=9	Firieth	(Female) Mortal (n)	
Dx32kyhA%7	Firion	(Male) Mortal (n)	
ryEbO5-!6M	Forchalad	aurora, (lit.) northern radiance (n)	
"em>1wxw#cI"	Fíreb	Mortal (n)	
j@n82jp6*0	Girithron	December, *Shuddering-one (n)	
f&rn=MDUF|	Golodh [ng-]	(1) Gnome, Deep-elf; (2) one of the wise folk, Gnome; (3) one of the wise folk, Noldo (n)	
pVkhG%Ha=C	Gwaeron	March, *Windy-one (n)	
E_*}Kk+P}7	Gwirith	April, *Freshness (n)	
E%rgaU9?AP	(1) Hadhod; (2) naug	Dwarf (n)	
E)Sf9jK,_V	Harchalad	aurora, (lit.) southern radiance (n)	
j0y-8SRSU<	Hithui	November, *Misty-one (n)	
qWT.AuF0},	Ivanneth	September, *Yavanna-ness (n)	
MW2?NPq*Lq	Lothron	May, *Flower-ness (n)	
j_wC^k^_-$	Narbeleth	(1) October; (2) October, Sun-fading, Sun-waning (n)	
B_&w2%v5S3	Narwain	January, *(lit.) New Fire (n)	
IA|lxJIpXp	Noegin	Petty Dwarf (n)	
EfS8e=YE_L	Nogotheg	Dwarflet (n)	
p_05ek,U27	Noll [ng-]	Noldo (n)	
O@O^zN~9wz	Nínui	February, *Watery (n)	
zc@:|1|MyT	Nórui	June, *Fiery (n)	
"H}j/#}$N0("	Ogol	?Elf (n)	
HWvA]kY>aT	Onod	Ent (n)	
vnK?d`CmTr	Oraeron	Sea-day, *Thursday (n)	
CWJt(2hHUa	Oranor	*(lit.) Sun-day, Sunday (n)	
c0%=tU+jtH	Orbelain	*Day of the Valar, Friday (n)	
cUG)=8tVhW	Orgaladhad	Day of the Two Trees, *Tuesday (n)	
B1{.]R[&+;	Orgaladh	Day of the Tree, *Tuesday (n)	
s~}9p^e}5Z	Orgilion	*Star-day, Saturday (n)	
EPQ^h}GM5C	Orithil	*Moon-day, Monday (n)	
UV<P;>`m0	Ormenel	*Heavens-day, Wednesday (n)	
enJsrP)AlE	Perian	(1) Halfling; (2) Halfling, Hobbit (n)	
lo8iD~sBkW	Rodon	Vala (n)	
"e71]2/#p={"	Rodyn	alternate name of the last day of the Eldarin six-day week (n)	
hk:smnj=Bp	Torog	Troll (n)	
MPjwCQ&sgH	a (conj)	(1) and; (2) and; †by, near, beside (conj)	
DZh[bgY8j3	abgen-	to foresee, expect (vb)	
"L4Q#L6vjb:"	ablad	prohibition, refusal (n)	
x(&)t/[ZtB	abor	tomorrow, (lit.) after-day (n)	
"xk#11K.upe"	ab	after (prep)	
CZN^;vtNbF	ach (conj)	*but (conj)	
DV9[@SPNj^	ach (n)	neck, *(upper) spine (n)	
jithFn@u_-	achad	rock ridge, neck (geographically) (n)	
fI)=oX/}43	achar-	to avenge, do back, react, requite (vb)	
y@,i]7Y:_G	achared	vengeance (n)	
sh^.XLd@P8	acharn	vengeance, (an act of) revenge (n)	
FLmLSRAxxR	ad-	back, again, re- (pref)	
"O6{#45z?,X"	adaba-	to build, erect, establish (vb)	
"QW8)%-#<qq"	adaneth	(mortal) woman (n)	
P)6wGM|iPW	(1) adar; (2) bâb; (3) nathon	father (n)	
eb?(m$adW(	adbed-	to rephrase (vb)	
z`c5?kMJ~7	adertha-	to reunite (vb)	
IKr4yr?0[U	aderthad	reuniting (n)	
FD/d3QNZ<!	adlanna-	to slope, slant (vb)	
o0zUc+z1BT	adlannas	downfall, ruin (n)	
e@T|ZI!+(L	adlant	oblique, slanted (adj)	
CB::R3[dAy	adlod	sloping, tilted (adj)	
F>,dZ+gl(4	aduial	(evening) twilight, *evening (n)	
H>|(DDU[<p	advir	heirloom (n)	
t,5StR@Rs|	(1) aebin; (2) aibios	cherry (tree) (n)	
Jb9Q{eP,s%	aeda-	to revere, worship (vb)	
i&f<>^/n1?	aedaith	reverence, worship, religion (n)	
s/.3koq5jD	aedh	nest (n)	
v$4bt[(EB4	aegas	mountain peak (n)	
Q;Hc(d_aP-	aeglir	line of peaks, [N.] range of mountain peaks (n)	
lQ9_/yD!=;	aeglos	icicle, (lit.) snow-point; snowthorn (a plant) (n)	
QVj@KQ*Lf|	aeg	sharp, [N.] pointed, piercing (adj)	
o|O(zXfeWr	(1) aemar; (2) aivin	rookery, colony of birds (n)	
l0no4$O4=;	aenor	god (n)	
vtq3AFmv0I	aerem	icon (n)	
DYIk^_s9<6	aerlinn	*hymn, (lit.) holy song (n)	
nc}cRpfI{?	aeron	saint (n)	
wD-~0rF|qL	aer (adj)	*hallowed, holy (adj)	
m|SoUd,LWR	aewen	of birds (adj)	
"g#t$JPIE_n"	aew	(small) bird (n)	
w/cPHqdQLD	agla-	to shine out, flash (vb)	
Hg*vv}0UIU	aglad	lightning (n)	
zT^Ge+Ff%{	aglann	ray of light (n)	
L}U~uE]h|;	aglar	(1) glory; (2) glory, brilliance, splendour, radiance; (3) glory, splendour (n)	
nf.Awe_5e(	(1) aglen; (2) agol	flash (n)	
z2x3Hc;k)Q	agrech	contempt (n)	
emg7Z|8Zcz	agreitha-	to despise, contemn (vb)	
e=uF@5b-5U	agreithannen	despised (adj)	
I>.,z<=u.(	agreitharol	despicable, contemptible (adj)	
t5G0n/jvk	ai (interj)	(1) cry of pain or woe; (2) hail; (3) oh! (interj)	
nacUL:uPA%	ai (pron)	*those who (pron)	
y3W<8>Sa2u	ain	same, identical (adj)	
hn.1QD$>T6	air	lonely (adj)	
Fm8te:4sE8	aith	spear-point, [ᴱN.] spear (n)	
y}=($)nky[	al-	no, not (pref)	
k:(Txwihv!	alae	?behold (interj)	
A,-1qwxz~<	alaf (Agriculture and Vegetation)	elm (n)	
w!mTCMLayP	albeth	(word of) good omen (n)	
eCiOh=;0=T	alfeg	cygnet, young swan (n)	
g!8$CR.pg]	alfirin	immortal, (lit.) not dying; a species of flower (adj n)	
J>e_f>,WhX	alfuil	large white sea-bird, albatross (n)	
KDuUt:pX5@	alhad	nowhere (pron)	
o[,X)J+@Xj	aliavren	barren (adj)	
G2V,%By4;D	allu	never (adv)	
"GQwyEPD#4A"	alnad	nothing (pron)	
I%:-~kM_kj	alphen	no one, nobody (pron)	
LR:6x6a*1;	(1) alf; (2) alfuil(in); (3) alph	swan (n)	
"s#HK>zMFp%"	alu	wholesome, *healthy (adj)	
J-wQ<JH=hi	alvar	(good) luck, fortune (n)	
sS]U4[d;ZL	alwed	prosperous, fortunate (adj)	
m88xz~/aNI	am (adv adj)	more (adv adj)	
b}aPXjON:K	am (adv)	(1) up; (2) up, [G.] upwards; (3) up, upwards, towards head of, above (adv)	
c=s{niHl-+	amartha-	to define, decree, destine (vb)	
i-0KM-Etrv	amarthannen	decreed, destined, ordained (adj)	
x+af61<>7Z	amar	(1) Earth; (2) world, the Earth, (lit.) settlement, the great habitation (n)	
H~1xBBZHa0	amdir	hope [based on reason], *expectation, (lit.) looking up (n)	
,$Q;uX4sq	amloth	helm crest, (orig.) uprising flower (n)	
cGzR}FftLT	ammal	(death) agony (n)	
Cp}T&z2pht	amman	why, (lit.) for what (adv)	
bjiz(LQn>+	ammatha-	to maul (vb)	
d5:M(r4e|P	ammos (Body Parts and Functions)	*breast, chest (n)	
Pf>^]kX|&B	ammuia-	to work (hard) for, to earn (vb)	
El+&ibLQXP	amon	(1) hill; (2) hill, (isolated) mountain; lump, clump, mass; (3) hill, mount, steep slope (n)	
NjT+qH~8:2	amorvad	breakfast (n)	
dUo1A}jrv2	amor	morning, early day (n)	
"o#r:JJ1<`j"	amosgarn	(1) robin; (2) robin, (lit.) red-breast (n)	
p_Jrk%yS~m	(1) amoth; (2) rôma (Body Parts and Functions)	shoulder (n)	
r`K]9`@RVC	(1) amrent; (2) amrint	lark (n)	
tjqK}RGW9n	amrûn (Time)	sunrise, east, (lit.) of the uprising (n)	
x+dmu_e0a/	an-	(1) intensive prefix; (2) with, by (pref)	
l*Xy!bfSfB	anann	(1) (for) long; (2) long (adv)	
oQA9h)esY7	andaith	long-mark (n)	
"E4,/!<Zt#>"	andrann	cycle, age, (lit.) long cycle (n)	
qjPP]Dj4ck	andrethui	patient, long suffering (adj)	
A),Q4a^dnN	andreth	long-suffering, patience (n)	
zBSvUBSCp-	angerthas	runic alphabetic, (lit.) long rune-rows (n)	
xK]]{0AEna	anglenna-	to approach (vb)	
C=V@o*hn`L	anglennol	approaching, coming (adj)	
tTJA|vDi=H	angren	of iron (adj)	
K=Huk>v9Ul	ang	iron (n)	
K_`y-7>4,j	anna- (Possession and Trade)	(1) to give; (2) to give, †add to (vb)	
PxM`hkqs,r	annas	length (n)	
b:M[>{?5;O	anneth	(act of) giving (n)	
IQ:Y*(18tE	annon	(great) gate, door (n)	
c=/q58]}D&	annui	west[ern] (adj)	
xIBW6JQFs|	annûn	(1) sunset, west; (lit.) going down; (2) west (n)	
CD5kc${J,z	anuir	forever, everlastingly, eternally, in eternity (adv)	
P,Xt*V?K&Q	anu	male (person or animal) (n adj)	
bwYAL{ya=a	anwar	awe (n)	
"Pg#pgK~[sT"	anwas	manhood, *manliness, masculinity (n)	
vKMp<Uu5mD	anwathren	manly, masculine (adj)	
A8[Z5;C,4h	an	(1) of; (2) to, for (prep)	
O5Y5N@WDH=	aníra-	to desire, *long for (vb)	
p7fGc!XJh3	anóren	sunny (adj)	
dbO-y.%-1Q	apha-	to touch (vb)	
B%QNTcwAKt	aphadol	following (adj)	
m2h`ZMXf@X	apharch	arid, very dry (adj)	
BuFOJr-`[v	aphas	(sence of) touch (n)	
zTn1|o&(=u	ar(a)-	(1) noble, royal; (2) noble, royal, high (pref)	
PJq%M00FTn	ar(an)eg	kinglet (n)	
"p_]M#pxb=g"	ar-	(1) [N.] outside; [S.] without; (2) beside, along with, compared with; (3) outside, beside; without (pref)	
"tCKBx#?@8H"	aranas	kingship (n)	
"CsX#4M^Gjj"	aran	(1) king, lord (of a specific region); (2) king, lord, chief, (lit.) high or noble person; [N.] lord (of a specific region) (n)	
mBJ}hyN/Aa	aras	deer, hart, *stag (n)	
"Nj#@A#_:|z"	arnediad	(1) unnumbered, [N.] without reckoning, numberless, innumerable, countless, endless; (2) without reckoning, numberless, innumerable, countless, endless (adj)	
i;z..=3Y%i	arnoediad	unnumbered, without reckoning (adj)	
"F#]f!-}(z}"	arod	noble (adj)	
O?R;sNg%Z!	arphen	noble, knight (n)	
F)&]SNcAGE	arthor	realm (n)	
jL.b0Ti)ee	asgath	skeleton (n)	
Jl~y9{$+)a	asgeb	bony (adj)	
w?3XDsG3(:	asgolui	equivalent, (lit.) beside-bear-able (adj)	
Gq$v(m7<]e	asg	(1) bone; (2) bone; stone of fruit (n)	
O;pZGf246o	ast (Sense Perception)	light or heat of the sun, *warmth (n)	
LY4jYMrcBz	ast	light or heat of the sun (n)	
I/18=@Tn@h	ath-	easy, easily (pref)	
d[YQRu9dTz	atha-	will (future) (vb)	
m1W,4_}q|~	athae	*healing herb, healing (n adj)	
FpXb+&GNsJ	atheg	[little] father; thumb (n)	
"D]G8j+~d#x"	athelas	(1) a healing herb; (2) a healing plant; (3) kingsfoil, a healing herb (n)	
HAxR_pGOzO	athgar	easy (easy to do) (adj)	
A^QEKrRNuO	athgen	easily seen (adj)	
K4N|e&*PDG	athor	doctor (n)	
zWFn2%hvt-	athra- (Body Parts and Functions)	to treat medically (vb)	
KAF${dg1Oi	athra- (Spatial Relations)	to cross (to and fro) (vb)	
"F#fLqcz90/"	athrabed-	to discuss, exchange words (vb)	
lcXkkk}k(H	athrabeth	conversation, debate, (lit.) interchange of words (n)	
P+nGGtHehX	athrad	ford, crossing (n)	
Qwbz}Q.od3	athren	dusty (adj)	
vBEpjtUWI[	aur	(1) (whole) day, sunlight, [N.] morning; (2) day, morning (n)	
cud0RnTgBk	auth (Religion and Beliefs)	dim shape, spectral or vague apparition (n)	
q.KNu,g(qm	ava-	will not, do not (vb)	
l4Yr$QT=)l	avad	refusal, reluctance (n)	
PV3}G%DST|	avautha-	to ravish, seize (forcibly) (vb)	
I.Pc5!O~<r	avauthron	seizer, ravisher (n)	
l~&&!QZ61P	avauth	ravishment; seizure (n)	
Nx/V7X+q{}	avnedhor	afternoon (n)	
H%?=HxQo%.	(1) avras; (2) rhass	precipice (n)	
e|2ad:$?ZF	bach	jacket, coat (n)	
g]~&iF3ZbW	bain	beautiful; good, wholesome, favorable (adj)	
B*$6D_i;|@	bal-	*to have power (vb)	
c^7yG7oi98	baladh	worth, importance (n)	
w_-Ke:&^i	balch	fierce, ferocious; [N.] cruel (adj)	
@y,EA,^@q	balf	excitement, emotion (n)	
K69qUzkHQ^	balla-	to matter; to be of significance, worth, moment (vb)	
j[$(yjk8lQ	ball	worthy, important (adj)	
Fou{|Gov}~	baltha-	to excite, rouse, stir up, agitate (vb)	
x]C8j8!9+G	balthannen	excited, agitated (adj)	
uVx|LR(3*L	balthol	exciting; excitable (vb)	
bmJ^&t!_t*	band [mb-] (Law and Judgment)	prison, custody, [N.] duress (n)	
q>`Xz$o]0F	bangad	trade, trading (n)	
nW`M`AZMFu	bangath	market (n)	
s12/Dfq|?;	bang	staff (n)	
pK!>^2Gp8`	banna- [mb-]	to imprison (vb)	
pJ(U7/0oEI	bannan [mb-]	prisoner, (lit.) imprisoned-one (n)	
k)grwm{Z`S	bar- [mb-]	to live, dwell, stay (vb)	
E~UMm9bQd`	barad	(1) fort, tower, fortress; (2) tower, great towering building, [N.] fort, fortress (n)	
Dnor+)v|Cy	baran	(1) brown, golden-brown; [N.] swart, dark brown; (2) brown, swart, dark brown (adj)	
pg^f0+c5N?	bardha-	to rule, reign (vb)	
xGcRH-8iaL	bardhon [mb-]	inhabitant, native (n)	
xhNfi+:-s;	bardhor [mb-]	habitable (adj)	
pv>%Swa0)B	bardh [mb-]	home (n)	
wOB;3:gJ0H	bardor [mb-]	home land, native land (n)	
h5%JFSI^fZ	barf	armour, armor (n)	
Fk)QiT5/,.	barna- [mb-]	to till (land), *cultivate; (orig.) to dwell in (a land) (vb)	
EBVLY2%!SZ	barn	safe, protected, secure (adj)	
/F<6>=e!w	(1) barn [mb-]; (2) baron [mb-]	tilled, inhabited (adj)	
J,]HT*`KT@	barthan [mb-]	dwelling-house, large building of masonry used as a dwelling (n)	
yMZD~R6,pQ	bar [mb-]	house, dwelling, home (n)	
u3D&lq3AU{	bas(t) [mb-]	bread (n)	
n/Dp1T~7ee	basoneth [mb-]	breadgiver (n)	
Ovc[SBFddx	basta- [mb-]	to bake (vb)	
F`<KD34.&r	bauch [mb-]	price, cost (n)	
"t#t2=6XS?."	bauda-	to ban, prohibit, refuse (vb)	
"G5#id$JHpu"	bauglir [mb-]	(1) constrainer; tyrant, oppressor; (2) tyrant, oppressor (n)	
BDhQVyPVQ^	baura- [mb-]	to need, require (vb)	
HR{/1YgmQ0	baw	no, do not! (interj)	
eW744Zf:UY	baw [mb-]	howling (n)	
pm+^Q`J0*c	bedhril	judge (f.) (n)	
H^<gqYMz>l	belaith [mb-]	mighty (adj)	
JUw/[?=x.w	beleg	(1) great, large; (2) great, large, huge; (3) great, mighty; large, big, [ᴱN.] huge; (4) mighty, great (adj)	
zc,~+E=y0j	beleitha- [mb-]	to extol, magnify (vb)	
m,g4+e[BJO	belen	expanded, unrolled, unfurled, set (of sails) (adj)	
m0U)*Ss4pq	belon	sail (n)	
HNt=iW)dT[	beltha-	to open out (transitive), expand, unroll, set sail (vb)	
k>V7ms9UF0	bened	chin (n)	
j((un:N>@z	bereth (n adj)	queen, spouse; supreme, sublime (n adj)	
J4$b?/JLVg	berthas	adventure, bold undertaking (n)	
bfAwptppb=	berthian	challenge; daring, audacity (n)	
6?-MZ|bk&	besain [mb-]	the Lady, breadgiver (n)	
D3bc:CR[9~	(1) herves; (2) hervess	wife (n)	
FX^}=XIz51	besta-	to wed, marry (vb)	
k;{^d|;_Wu	bestad	wedding, (lit.) a marrying (n)	
Nj5/qYlr()	bestannen	wedded, married (adj)	
e4hp[{A|u%	best	marriage, matrimony, wedlock (n)	
m74K0~Sjvs	bethren	brother in law, kinsman by marriage (n)	
M&?a/TK*(:	bethres	sister in law, *kinswoman by marriage (n)	
l+%yB:L4y2	bethril	spouse (f.) (n)	
z3!X@F{*L7	bethron	spouse (m.) (n)	
u}aL4d[iTj	be	as, like (prep)	
s$^9U]`GA8	(1) bilebra-; (2) felcha-	to equal (vb)	
xc-ZB*2vuh	bilebren	equable (adj)	
MPPJ-j[|K&	bileutha-	to make equal, equalize (vb)	
cn4dL(;/wY	biltha-	to resemble, seem like; to seem likely, be probable (vb)	
r?cjC_*PEg	bilthadren	probable (adj)	
K7:A]AHO`Y	blabed	flapping, beating (especially of wings) (n)	
FB2{ghVTAl	blaud	pride (n)	
AzGa8N71Cz	blodren	(1) arrogant; (2) arrogant, *proud (adj)	
e|^I[C!>KA	bloss [mb-]	wheat (n)	
tScI|H>HDV	blê	fat of meat; *fatty, oily, greasy (n adj)	
"m#ou>yrx??"	(1) bliw; (2) blîw	oil (n)	
D|A~,V;S41	boda-	to ban, prohibit, refuse, forbid (vb)	
b6,RiVE}&{	boe [mb-]	must (impersonal), (lit.) *[it] needs (vb)	
A3qG@-&*rI	bond [mb-]	snouted (adj)	
h`=]}$bRKt	born (adj)	[stead]fast (adj)	
H)-/Yi030<	born [mb-]	hot, red (adj)	
OeOV:=LZ1g	bothol [mb-]	oven (n)	
hHc^m@yx(a	both	fen, marsh; [N.] puddle, small pool (n)	
"fFAG#z@vee"	bo	*on (prep)	
Q7G)fC+X_d	brach	(1) shawl, plaid, wrap; (2) shawl, wrap (n)	
ooRQ=Vif4f	braetha-	to wrap, swathe (vb)	
cX<hIWd;l[	brand (n, Warfare and Hunting)	steeple (n)	
L>dW0tT+K.	(1) branna-; (2) tortha-	to scorch (vb)	
C+42b7>NxZ	(1) brant; (2) brant [mb-]	cooked, done; overdone (adj)	
"EJ&_#YEl}I"	brass (Physical World)	great cliff (n)	
D@]sVjI,4s	brasta-	to tower up, loom (vb)	
ey{t;4!?G.	brath-	to cook (vb)	
"E#|iSnl`qw"	bregol	(1) quick, sudden, [N.] violent, *fierce; (2) violent, sudden, *fierce (adj)	
n:8:8L*Rri	brethil (Agriculture and Vegetation)	(1) beech; (2) silver-birch (n)	
qkV>Y8h.~[	brethil (Social Relations)	princess, (lit.) queen-daughter (n)	
yi8Gjk$55j	bril	glass, crystal (n)	
x.8oQX.aWE	brithon	pebbly (adj)	
Bi6vt{_$(z	brith	gravel (n)	
Ol7zR(*BeS	bronad	survival (n)	
"hWTGm7[N`#"	brond	(1) firm; (2) firm, [G.] steadfast, *faithful, constant (adj)	
"p99s.h#,;!"	bronnas	steadfastness, constancy (n)	
j7,HI~>+K,	brui	(1) loud; (2) loud, *noisy (adj)	
MEM_y}n^YV	brêg	lively, sudden, quick (adj)	
nr%6eE~]e[	budhulug	dragonfly (n)	
EaaJ;?r6Zr	budhu	large fly (n)	
A6g3cx0zS`	bund [mb-]	snout, nose; cape [of land] (n)	
uwg0U9D`dW	bân	fair, good, wholesome, favorable (adj)	
f%TdhRxSoD	bída-	to compare, liken (vb)	
"QG#*kOJmne"	bíleb	equal (adj)	
on8pj!WpIk	bîl	likeness, similarity (n)	
zP0B^RU!]i	bŷl	(single) service or favour (n)	
jwc>Gz)-]C	bŷr	follower, vassal (n)	
w`Xz>FYfy9	cab-	(1) to jump, leap; (2) to leap, [G.] jump (vb)	
yk-uiO%gQS	cabed	leap (n)	
fcLHxpZK<6	cadudew	allomorph, (lit.) shaped sign (n)	
NQY$:HEke@	cadu	shaped, formed (adj)	
zE`ps(KX!)	cad	*after (adv)	
la55[UA$e^	caeda-	to lie; to lay (down) (vb)	
joR*FkwR{u	caer	(1) [N.] flat isle on a river; (2) flat isle on a river (n)	
B7ao8oDws_	caetha-	to make to do or be, cause, compel, induce, bring about (vb)	
j_4u+uKC.w	caethas	causation (n)	
"xVTSNal#<~"	caetheb	original (n)	
EddYqrbP2H	caeth	cause, reason, motive (n)	
vxy(Ja+,F/	cafor	flea (n)	
D^H(x(XHmQ	cail	fence, palisade of spikes or sharp stakes (n)	
o7IqO:+9|&	(1) cair; (2) cîr	ship (n)	
vx8}Z*4|6!	cai	hedge (n)	
l3nE_i0^^S	cal-	to shine (vb)	
B~,%X0=:x.	calad	(1) light; (2) light, brightness, shining (n)	
g]&,Jp`9Ut	calan	day(light) (n)	
B/ww^n<*uE	calardan	lampwright (n)	
th5[4]_>II	calar	(portable) lamp (n)	
tlR[7Qw*Z-	calen	(1) green, (orig.) bright-coloured; (2) green; †bright, [N.] bright-coloured (adj)	
B@va.|C2WZ	calph	(1) bucket; (2) water-vessel, [G.] bucket (n)	
"N6H$a#f(?"	(1) camlann; (2) dalv	palm of hand (n)	
mEa.Pu5g|<	camma-	to make fit, suit, accommodate, adapt (vb)	
iGWMQG*7T~	cammui	suitable, fitting, convenient (adj)	
m=&?Gt^ROm	cam	(1) (cupped) hand, holding hand; handful; (2) hand (n)	
PvIH23=oKM	can-	to cry out, shout, call (vb)	
mC?+b!KP8H	canad	four (cardinal)	
yz+jkZNU+w	canath	quarter (n)	
"fj$$=#n,D+"	canga-	(1) to tangle; (2) to tangle; *to go wrong (vb)	
IahOZH:Qiq	cang	tangled, confused, mixed up, awry; tangle, confusion, mêllay (adj n)	
p8UM1@)L!}	cannas	[abstract] shape (n)	
F:Od0iugF?	canthil	square (n)	
xIh08-E0[	cant	(1) outline; (2) shape; [N.] outline (n)	
k4Jm5a^ffY	car-	(1) *to make; (2) to do, make (vb)	
"#@Lox*}X$"	carach	(1) jaws; (2) jaws, rows of teeth (n)	
g%sG%Uw/jG	caraed	effective, productive, effectual, efficacious (adj)	
qPL|%yLscr	caralluin	*red-blue (adj)	
Pp/Et?/Z}s	caran	red (adj)	
w~Xl%L1cJf	caras	(1) a city (built above ground); (2) city, [N.] city (built above ground); [S.] (orig.) fort or dwelling surrounded by bulwarks, circular earthwall with dike (n)	
r)dvpMu%MV	carch (Body Parts and Functions)	fang (n)	
E%JxgDD5%T	cared	action, *doing, making (n)	
IJNlS;!U=7	carf	tool, implement, weapon (n)	
"sh#4I10Zf/"	carnen	done, made, finished (adj)	
ec`O)q=3xM	caron	actor, agent, doer, maker (n)	
r2;z/}~1qF	carthas	activity (n)	
zJkS4oF91a	carweg	active; busy (adj)	
QHwRy^dED{	castol	helmet (n)	
L<rxnq]5j6	cathrae	tressure, *headdress (n)	
gJ4Mr%FqpB	cauda-	to get flavour of, perceive, notice (vb)	
f%00nji0YL	caudol	tasteful, endowed with good taste; discreet, circumspect (adj)	
vDWG.tvJED	caul	(great) burden; affliction (n)	
k?0hBC*EKW	caun (Language and Music)	outcry, clamour (n)	
Ja|.`?ZMD}	caun (Social Relations)	prince, chief, head (n)	
KfDG27mg$h	caur	action, doing, making; verb (n)	
K]q)Vz.=[S	caust	savour, flavour (n)	
FbX3i(-R`K	cauth	deception, lie (n)	
qHXJS+mX.E	cav-	to receive, *accept (vb)	
y3;lVM{lO(	(1) cavren; (2) tuvriol	acceptable (adj)	
vR|aYUn[VO	caw-	to taste (vb)	
c%K6%|]S6s	caweth	sense of taste, taste, judgement (n)	
pDZ^e%j?w-	ceber (Spatial Relations)	stake, spike (n)	
"k-#Q5~e3vk"	ceiria-	to cause, bring about (vb)	
Kg9pWO0@2@	celair	brilliant, *shining (adj)	
KZA4+k_)wK	celebrin	(1) like silver (in hue or worth); (2) of silver (adj)	
Q9li/;ua1K	celeb	silver (n)	
q!8BTh4oLB	celef	deer, hind (n)	
fLu3;y[oI+	celeg	(1) hasty; [N.] agile, swift; (2) lambent; (3) swift, agile (adj)	
rVK9vi^KYh	celf	channel (n)	
n}Rja+V0D+	celia-	to illuminate, light up; to illustrate (vb)	
j_g}[AtiPf	celias	(artificial) light, illumination (n)	
F`l71^L)}U	cell	flowing (adj)	
sV8+iY~y+H	celu	spring, source (n)	
Nlt4YvEj3r	cen-	to see, perceive, look (vb)	
dItLvI+:7V	cened	looking, *seeing (n)	
rmN{~NY7)9	cenedril	mirror, looking-glass, (lit.) looking-crystal (n)	
PWDg`:LBuT	ceredis	crafter (f.) (n)	
heD=s?^a2S	cerf	knife (n)	
qLvJb?)u:e	cerin (Physical World)	circular mound, artificial hill; [N.] round enclosure (n)	
"nv<DUK=dQ#"	certhas	runes-rows, runic alphabet (n)	
"c+Hw#)w+,0"	certh	rune (n)	
if4|e7wsLI	cesta-	to seek, search for, look for (vb)	
K:&FjOjGV.	cestaedas	curiosity (n)	
nOB44j@M.T	cestaed	curious, seeking, inquisitive (adj)	
n18eWhX%Ig	ceth-	to examine, search, interrogate (vb)	
mfSu_{C}}:	cethaeg	horizon (n)	
o6-_Cw*%D.	cethia-	to cause interest, to interest (oneself) (vb)	
jA(v%H7B.J	cethiol	interesting (adj)	
L=[u9</Fvn	cevemphast	earth quake (n)	
CGb%be$Zj,	ceven	*earth; Earth (n)	
EQseKeRY6_	cevorf	potato, (lit.) earth-apple (n)	
POzs&RY{=}	ce	(1) *might, maybe; (2) may(be), might (adv)	
wdcN&DR^[w	cil-	to choose, select (vb)	
bu*)u`rn!<	cilith	choice, choosing, *selection (n)	
hY|gyq~)S5	cim	blade (n)	
IUt7y%kncv	cin	you (sg. fam.) (pron)	
xVfv;w=ebn	(1) cirbann; (2) lorn	haven (n)	
ES;b5Oh5kt	cirias	fleet (of ships) (n)	
MC,1d&.<4<	cirion	sailor, shipman (n)	
K_[.pTta!H	cirith	(1) cleft, pass; (2) cleft, ravine, defile, [N.] pass (n)	
K1+:-WP/B.	ci	thou (pron)	
C*idu~yTUA	codhon	idol (n)	
byM.y+u-2>	col-	to bear, carry, wear (vb)	
i+vUnU^t%/	colch	box, chest (n)	
C)1XjU%7+E	coleb	burdensome (adj)	
"Py2SxG#WGh"	coll (n)	cloak, mantle (n)	
kNF{K*U&3`	collorn	laburnum, *(lit.) orange-tree (n)	
uFNKV7Mj;]	colof	orange [fruit] (n)	
L^5VwE*U}J	coltha-	to bear up; to weigh, balance it on scales; to be worth, value or be equivalent to (vb)	
s@J83qz3NB	colui	light (to carry), not heavy, (lit.) carryable (adj)	
iFX,GIx6Tn	com	bellied (adj)	
EbOXkpoNDS	condir	mayor, *(lit.) chief-man (n)	
QA`cTPjG}!	conui	commanding (adj)	
e:d9+P%Q4J	cor-	to turn sour, curdle, congeal; to make cheese (vb)	
xY>Ll;dV-V	coranor	solar year, (lit.) sun-round (n)	
Gti@(y`u7+	cordh	sour (of milk), curdled (n)	
y_Y>2j9SSq	cordof	pippin, *a type of yellow and red apple (n)	
pcUZ.P}}_m	corf	ring (for fingers) (n)	
mFVOib=Q@5	corob	skull (n)	
kb~oDTScRH	corth	curd (n)	
"l)EgD+#Sbc"	coru	cunning, wily (adj)	
"G#fcZp@Q!y"	cor	ring, circle (n)	
rz_uJ(!dK;	cotha-	to startle (vb)	
ETQP|0J5/u	cov-	to bow (vb)	
zPP;9X-4J=	cova-	to come together, meet; to gather, assemble (vb)	
dS`dw~dw(g	covad(a)-	to bring together, make meet (vb)	
N6s$b-NZ64	covas	community (n)	
E@hBcBeyb-	covn	empty, void (n)	
P%@;&HF~|G	covra-	to empty (vb)	
B{=);b]qC2	craban	bird of crow-kind, *raven (n)	
"nrjFo1#$:Y"	cranna-	to accomplish, finish, complete, [G.] achieve (vb)	
m&y]q^Ktg(	crannen	perfect (adj)	
l:Rh?]Qmid	crech	spittle (n)	
H>/+5$kb[.	crig	elbow (n)	
ri5oE.E|+J	crisg	sharp [edged] (adj)	
Fe^6daiJV*	criss (Physical Acts and Materials)	cleft, [N.] cut, slash, [G.] gash (n)	
ux07R:`6?.	crista-	to slash, cut, slice (vb)	
jdL7Mki&;s	cruin	coloured (adj)	
qm3i?t`R+S	cruith (Sense Perception)	colour, complexion, appearance (n)	
nVN%sv0*^(	crui	colour (n)	
t;~mYq7Tt}	cui(w)	awake, alert (adj)	
zjgA*5)X/m	cuia-	to live (vb)	
PX:]O.rQ_$	cuida-	to bring to life, enliven, energize (vb)	
sVIE_(z)PF	cuileb	lively (adj)	
P)|5Q?P^q$	cuilvorn	lifetime (n)	
preA/a_~^@	cuina-	to be alive (vb)	
eU5&RIxz;o	cuinas	vitality, liveliness (n)	
Eck.Xs.sG;	cuithas	life (period of life); living, livelihood (n)	
K_DhQ}j_bL	cuith	(1) [biological process of] life, the vital principle; (2) life, the vital principle; living body (n)	
tU_<&sYUmX	culuin	golden-red, orange (in colour) (adj)	
OY(|:5$MPO	cum	belly (n)	
"EkbsmkO#@^"	cund	*prince (n)	
whvK%XR%q/	cungan(d)	viol(in), (lit.) bow-harp (n)	
kS{g&u/`w}	curunis	witch (n)	
"i3bvi7#i/="	curunír	wizard, [N.] man of craft (n)	
xFTr,!m5/]	curu (Physical Acts and Materials)	skill (of the hand), craft, magic; [N.] cunning (n)	
fkz+w]VkTR	círdan	shipbuilder, shipwright (n)	
epu5lgX8+K	cîn	your (sg. fam.) (pron)	
piZ8/V^vX{	(1) cîr; (2) cîw	fresh, new (adj)	
h*P9-ZrM5c	cúron	crescent moon (n)	
w8TZF_J7^^	cútha-	to deceive, lie (vb)	
fX`|03bb-R	cûd	foe (n)	
gIaS06CK*L	cûl	load (n)	
ciPfc4B6mv	cûr	cheese (n)	
BzAD$p&_a!	cû (Warfare and Hunting)	bow; [N.] arch, crescent (n)	
IQm!JH,sI_	cýra-	to renew (vb)	
zOk2RMOJTY	cýron	new-moon (n)	
e^^bb:fs~y	cŷl	*renewal (n)	
v+ckF-gdm|	cŷr	renewed (adj)	
c>[=3Mzg>l	dadhra- [nd-]	to face, oppose, stand in way; to resist, thwart (vb)	
"PRpg/#d]%V"	(1) agos; (2) dae; (3) odra	very (adv)	
k&;yVpws7	dae- [nd-]	dreadful, abominable, detestable (pref)	
A%I=2@yxdl	daebeth [nd-]	blasphemy (n)	
Aob!xaI]c_	daedelos [nd-]	horrible fear (n)	
hIp4G.yw;:	daer	great, large (adj)	
Nd]+ea49u.	daer [nd-]	bridegroom (n)	
P$N${S,-7D	dag- [nd-]	(1) to slay; (2) to slay, [ᴱN.] kill; (3) to slay, kill (vb)	
mB4sF!g42d	dagnir [nd-]	slayer, bane (n)	
"E&d&[V1Ip#"	dagnis [nd-]	slayer, bane (f.) (n)	
dc=vjNxd7K	dagor [nd-]	battle (n)	
fvTi/pG-^>	dagrassaeb	bloodthirsty, (lit.) slaughter-hungry (adj)	
o)F6-Sq|n(	dagrassaeg	bloodthirstiness, (lit.) slaughter-hunger (n)	
x/P<)_&Iw]	dagras [nd-]	slaughter (n)	
FF@vFG&_).	dananna- [nd-]	to give back, return [something] (vb)	
K*j4A3hKDx	dandol- [nd-]	to return, come back (vb)	
MaJ3gq`|9n	dangar- [nd-]	to undo (vb)	
dw8z7*l>l,	(1) dangen; (2) dangen [nd-]	slain (adj)	
h~,Qyo+oaA	dangweth [nd-]	answer, *(lit.) back-report (n)	
z-(pu<:&A/	danna-	to fall (vb)	
D?h)3s+m_(	dannad	falling (n)	
nt-PPjC/wp	dannen [nd-]	ebb, lowtide (n)	
e{D1EU][pE	dannod-	to untie, undo, unloose (vb)	
s26OlL8-IR	dant	*fall (n)	
?;OVt*:zg	danwedh [nd-]	ransom (n)	
C(RA<]h}`-	dan [nd-]	back to, (back in return) against, down upon, back on, back again (prep)	
j0gI_IIzv<	dar-	(1) [N.] to stop, halt; (2) to stop, halt (vb)	
dl|a=(Lm6{	daur	league; †stop, pause (n)	
O8*pl20RU;	dav-	to allow, yield, permit (vb)	
J%Su_/8v$;	degil [nd]	victor, winner (n)	
QKsfz]IzE%	deloth	(1) abhorrence, [N.] detestation, loathing; (2) abhorrence, detestation, loathing (n)	
l,$q/h[j@;	delu	hateful, deadly, fell (adj)	
svGJw_jL[,	dem	sad, gloomy (adj)	
GY&s;uULD!	dev- [nd-]	to try, *seek opportunity, experiment (vb)	
mS$r-s1>lF	dew-	to fail, miss (vb)	
dATYgk846:	de	you (pron)	
Cottr>-aqj	di [nd-]	(1) beneath, under; (2) in (prep)	
O~/3s!MFE*	dilith [nd-]	friendship (n)	
gj1KwQz|$7	dim (n, Dwelling and Furniture)	stair (n)	
e838h{3m]t	dim (n, Emotion)	gloom, sadness (n)	
Pv(8vQPI?{	dirbedui	hard to utter, difficult to pronounce (adj)	
IhN2P+Kq{l	dod-	(1) to drop; (2) to fall down, drop (vb)	
"g])Sq#nF~3"	dod	berry (n)	
o{[~[:z^F-	dol(l)	head, hill (n)	
bQ7BYUnEq8	dolen	(1) hidden, [N.] secret; (2) hidden, secret (adj)	
D13/PQaAli	dollon [nd-]	phoneme, underlying sound, (lit.) hidden-sound (n)	
FqWLX0o(2`	dolph [nd-]	mole (n)	
PP53!wS9R(	dorgannas [nd-]	shapes of the lands, *geography (n)	
Ii,>dfy?xp	dorgant [nd-]	landscape, scene, *(lit.) land-shape (n)	
x}]C<:q%Pj	dorn	tough, stiff, thrawn, obdurate (adj)	
DA1B6a3oT`	dov-	to lie heavy (vb)	
"Ii({[:t=>#"	(1) dovn; (2) dufui	gloomy (adj)	
A3A5%.iH+z	drab-	to labour, work; (impersonal) to irk, annoy (vb)	
NE?o(YD>mi	drabol	labouring (adj)	
N!6NP,?@06	drab	labour, toil, irksome work (n)	
u(D&ZbsbB0	(1) draug; (2) garaf [ng-]; (3) harw; (4) ulug	wolf (n)	
c@m{jbF]0F	drautha-	to weary, tire out (vb)	
d{7lt@DIQ%	drauthas	[wearisome] toil, weariness from labour (n)	
kLnxcWMpN!	drauthiel	arduous, labourious (adj)	
K1O}8|ORx/	drauth (adj)	[G.] weary, toilworn, tired (adj)	
d9tRw;UP=D	dravn	hewn log (n)	
ML.&X01y9j	drega-	to flee (vb)	
I4kSF@L:V|	dring	hammer, *beater (n)	
mg!n_c5YTy	drinna-	to turn, twist (vb)	
Yr}D|571p	drint	twist, wrench, turn (n)	
z2:ydi=3-3	duia- [nd-]	to descend, sink, set [of sun] (vb)	
"e#71DviJ9F"	duidhrad	canal (n)	
gYi4tm:f2N	duinen	flood, high tide (n)	
sR-3d1P~:9	duiniant	aqueduct (n)	
G?$Rl7lsL(	duin	(1) (large) river; (2) water, river (n)	
IToW9=OdKe	(1) dâd; (2) nâd	grandfather (n)	
DF=3`fotvp	dêl	disgust (n)	
IMnVQ&|W>2	dírnaith [nd-]	wedge-shaped battle-formation, (lit.) man-spearhead (n)	
"dOQ):@[#;a"	dîn (n adj)	silence; silent, quiet (n adj)	
NF:CQ{oQ}w	dîr (adj, Physical Acts and Materials)	hard, difficult (adj)	
cLVQnj:jjH	dîr [nd-]	man, [N.] adult male; agental suffix (n)	
k<as)w&ToT	dî [nd-]	(1) woman; (2) woman, bride, lady (n)	
y9Z&&xl.0V	dôr [nd-]	(1) land, [N.] region where certain people live, [ᴱN.] country; (2) land, country; (3) land, country (inhabited), people of the land; (4) land, dwelling-place, region where certain people live (n)	
Ilo]/Q(}9k	dúda- [nd-]	to lower [something] (vb)	
RxMyF2D{-	(1) duilin; (2) dúlin(n)	nightingale (n)	
KRZ7ip&kL0	dúnad	descent (n)	
Dt9P9nVtut	dúnen	western (adj)	
JJ!vQn2gUc	dúvad	supper, dinner (n)	
rAa.-do!9/	dûn [nd-]	west (n)	
PIB6-^V?$C	dûr [nd-]	dark (with evil implications), gloomy, hellish (adj)	
Lw+89D={Yz	dû	(1) night, dimness; [N.] night-fall, late evening; (2) night, night-fall, late evening (n)	
BV.N}A9{-u	dýgar	mistaken act; doing a wrong thing (n adj)	
CHb`-m12rr	dŷl	mistake (n)	
Q2`&+BTT{~	dŷr	mistaken, off point, not right (adj)	
IviDI.Oi90	eb (Grammar)	save, except (prep)	
n!)M&3!)PX	echad- (Spatial Relations)	to form, make, shape, cut out, [N.] fashion; [S.] (lit.) to shape out (vb)	
ymYUh<~dk,	echad	camp (n)	
iFtazw@LA}	echor	outer circle; encircling (n adj)	
v182D)S!mA	echuia-	to awaken, wake up (intr.) (vb)	
D50.5%W@b%	echuida-	to wake up (trans.), waken, rouse (vb)	
ltXN]4J1%*	echuir	early Spring, (lit.) stirring (n)	
jx8$`h):>o	echui(w)	awakening (n)	
yqp==GA&){	ech (pron)	?you, yourself (singular) (pron)	
b!$snht]Q|	ecthelorn	spruce, fir-tree (n)	
lH9JBY*OLp	ed (prep pref)	out, out of, [N.] forth (prep pref)	
NACY=d,){%	ed (pron)	*it (pron)	
xS?8y[Th`L	edanna-	to publish, (lit.) out-give (vb)	
w=%|9/=`pY	edhellen	elvish (adj)	
zZ)e3nDUu_	edinor	anniversary day (n)	
nnH]5r4[wM	edledhia-	to go into exile (vb)	
u4&x~(_/2/	edledhron	exile (n)	
D:k[Fwc`Xw	edlen(n)	exiled (adj)	
Gdm_|%LUCU	edlonui	foreign (adj)	
lYh>2OhDVY	edlon	outsider, stranger, *foreigner (n)	
qn?9IDgPlR	edol	ivy (n)	
x?D!28*W4^	edra-	(1) to open; (2) to open (out) (vb)	
pl!k9I(`e~	edrain	*(outer) border (n)	
Fbr~3KvS?K	edraith	rescue, saving (n)	
N=QWTeTf=V	edregol	in especial, *especially (adv)	
t?j^;?$bwC	edren	outer (adj)	
"v!n]#|J^a="	egel	other (adj)	
d`x`UaVg.~	eglan	forsaken (adj)	
yU-m-S.3,L	egleria-	to glorify (vb)	
r(P|fC6Q,0	egli(n)	needle (n)	
zqRjvA|4(`	egor	or (conj)	
CwGBFu%%_{	ego	be off! (interj)	
mn@H$Vt3BW	ein-	excellent, admirable (pref)	
MJj&M%{]xX	einior	elder (adj)	
mKJwjO7-!%	eirien	daisy (n)	
y@oMpb>pl!	eitha-	to prick with a sharp point, stab; to treat with scorn, insult (vb)	
ilMMHCFnc-	eithad	*insult (n)	
b3&W`_j(g?	eitheb	thorny, *(orig.) full of points (adj)	
k2D+A}3D]v	eithela-	to spring, well forth, *issue forth (vb)	
lz!{DoDx>D	eithel	(1) issue of water, spring, well, fountain; (2) source, spring, well, [N.] issue of water, fountain (n)	
oAVXv8`Q)B	eithos	thorn bush (n)	
MwYFw=[>~-	eithron	(1) *spearman; (2) warrior (n)	
c0`I&cOG2L	eithro	*also (adv)	
C/sB%1-*_/	elanor	(1) pimpernel, small golden star-shaped flower, (lit.) sun-star; (2) sun-star (n)	
u~x+GD?`pc	elchith	nebula, star cloud (n)	
wh;}iD0G5t	elia-	to cause to prosper, bless (a work), help one (vb)	
K42:AY?T7G	eliad	blessing (n)	
K-y;&;yhJ,	elias	blessedness (n)	
M?W}:/K>{8	elloth	single flower (n)	
"GHn+<b#oqT"	elo	behold! (interj)	
Pn[TT6jY4D	elui	starry (adj)	
"s9nO4i4E#X"	elu	(pale) blue (adj)	
zlLbDf:e}n	elva-	to marvel at, admire (vb)	
AerG0Q*.7P	elvain	wondrous, marvelous, wonderful (adj)	
AN-zYr[6{c	elven	wonder, wonderment (n)	
Q_,,TN0|n.	(1) amaith; (2) emel; (3) mabir; (4) naneth; (5) nanwin	mother (n)	
PmGRCm;>Xx	emig	[little] mother, *mommy (n)	
oX(BZEA+Vl	emma-	to paint, draw (something) (vb)	
rwUZUda9YG	emmas	painting, drawing (vb)	
pK1G0)6`m?	em	picture, image (n)	
mkUJc/ttMp	en (adv)	then, [G.] that past (adv)	
oGQ[^LLdT/	en (prep)	of the (prep)	
k:6lV1G{KF	en (pron)	(1) 1st sg pronoun; (2) that by you, that already mentioned (by you), that past (pron)	
dRS&<h8mtC	en-	*to name (vb)	
nSa;IolA=;	(1) enas; (2) enuith	title (n)	
!2_(ZfeBe	ened	moreover (adv)	
DTy8!7$mky	enedhren	central, essential (adj)	
N_|Rta=c&U	enedh	(1) centre, middle, core; (2) centre, middle; [N.] core (n)	
BYpP:L7Ofu	eneg	six (cardinal)	
HB^?;z:1!1	eneth	*name (n)	
Ba<OI:x4Zf	enia-	to be born, be generated, result (vb)	
P_Ig}+q>(k	ennais	signature, (lit.) name sign (n)	
BVlYUYjP/&	ennas	there (adv)	
ln4UsdLn7,	ennen	named (adj)	
If[{mf%o4r	eno	*still (adv)	
H7gJs_f-YB	enweria-	to revere (vb)	
g_<!lDHO;x	enwiol	nominal (adj)	
u&nO`c<g!0	ephed-	to say out (vb)	
NO^MHv$j3+	ephel	(1) outer fence; (2) outer fence, surrounding ring (n)	
Qn^`^u0&M.	ephola-	?to remember (vb)	
QX+I(d)+@8	erchion	orchish (adj)	
Kiu8/g:a2g	ereb	(1) isolated; (2) single, alone, lonely, [N.] isolated (adj)	
hx_G->.N75	ereg	(1) holly, [N.] holly-tree; (2) holly-tree (n)	
F3e,e$!:hR	ereth	solitude, oneness, loneliness (n)	
b}s>ro~H{K	eriad	rising (n)	
"eao#E:./X."	erlu	once, one time (adv)	
pwT%w^oN@x	ernil	prince (n)	
"x0#0G/a47W"	ero	*only, alone (adv)	
"ehmX&Z#|Je"	ertha-	to unite (vb)	
FVbm.G[UDV	erthad	union, uniting (n)	
cd0Epatc5X	eryn	wood, forest (of trees) (n)	
z$HKATr?U=	er	(1) one; (2) one, alone (adj)	
LEGj!cyKhM	esbin	thin thread (n)	
u{L@(DyT~x	escar	weapon (n)	
ism^4Apr6>	esgal	cast shadow, shade; screen, hiding (n)	
"y#NhFD@OZs"	esgia-	to smoke (intr.) (vb)	
KOA^,Nc*iF	esta-	to call, *name (vb)	
Lp-_2Q1eJU	estannen	named, called (adj)	
s%zEKaB*B3	estel	hope, trust, *faith [in] (n)	
mr:_4@viUs	estola-	to encamp, *erect tents (vb)	
"D#B}ukkDQj"	estolad	encampment (n)	
pq]99Aro|w	ethir (Physical World)	(1) mouth of a river; (2) mouth of a river, (lit.) outflow (n)	
"A6#vStsZw*"	ethir (Sense Perception)	spy (n)	
kf@9B]L;Y{	ethiria-	to flow out (vb)	
u/b>m15=m8	ethog-	to lead out, *bring out (vb)	
wW?|c5yJYu	etholtha-	to extract, make come out (vb)	
qo4nwIYPke	ethuil	spring [the season] (n)	
I?+g1:RTA8	eth	outside (adj adv)	
r9^(ZT8MBW	(1) e; (2) ho; (3) hon(o); (4) on	he (pron)	
e`?e>45UVv	faefelf	soul-feeling, *emotion (n)	
EH9LeM}aTs	faeg	mean, poor, bad (adj)	
F![Q*zKLg7	fael (adj)	fair-minded, just, generous (adj)	
yYkWR,_a&S	fael (n adj)	gleam of the sun; *gleaming (n adj)	
mRyG.eM5o;	faelas	fairness, equity (n)	
r&-0~F?uaJ	faen	vapour (n)	
"P#_k<U*R[5"	faergol	depression, grief, (lit.) spirit-burden (n)	
B7&6i0.k[-	faer	spirit (in general) (n)	
AI%S[q7h@=	fae	incarnate spirit, *soul (n)	
FL>[0l>-:s	fain	white, shimmering, shining, [N.] radiant; [S.] white and shining [thing] (adj n)	
rHE)gar2wk	fair	quick, ready, prompt (adj)	
n4^G4+X3]a	fair	quick, ready, prompt (adj)	
I,lIPJ^h58	falas	beach (n)	
Ad?WD)d4$]	falchon	great two-handed sword, twibill (n)	
vE%|U)Zolo	falch	(1) [ᴱN.] cleft, ravine; (2) cleft, ravine (n)	
"AztQD#z/`b"	faloth	large foamy wave (n)	
jbzT}C(01t	fang	(1) (long) beard; (2) beard (n)	
JQNbiWov}9	fanui	(1) cloudy; (2) cloudy, (lit.) having much cloud (adj)	
ElNQekQVBN	fanu	vapour, steam (n)	
A2sZHQ@:{j	fanwos	mind-picture (of apparition in dream) (n)	
nUpYTPJwvh	faran	rowan, *ash (n)	
rYFs%Z2>Sd	faroth	*hunting (n)	
CW0O6{,;<a	fartha- (Quantity and Number)	to sate, satisfy (vb)	
xQR.//b`ye	farthannen	sated, satisfied (adj)	
u[|tFb~:5e	farthas	satiety, satisfaction (n)	
csyR/:l~gp	fass	tassle (n)	
E._;%oD-(}	fastui	shaggy, hairy, hirsute (n)	
N9+eVU20qO	fathol	(tasselled) fringe (n)	
u$%=%hWKMG	fathren	tasselled (adj)	
tsa+U(-1fO	faug	(1) [N.] thirsty; (2) thirsty (adj)	
C&&cR6Njf`	faul	bladder, (orig.) inflated thing (n)	
"x}|i@#>r<<"	faw-	to puff, blow, pant (vb)	
zO|2ma0:AR	faw	*breath, puff of breath (n)	
l-(IO)dt9G	fel-	to feel (a sensation or emotion) (vb)	
L2!~]Lb{1A	felaich	splash (n)	
lII?PfH|rj	fela	(1) cave; (2) mine, boring, tunnel, underground dwelling (n)	
Mzq66oI.6?	felechia-	to splash (vb)	
!M29b_]0H	(1) feleg; (2) gorod; (3) grûda; (4) rond	cave (n)	
Gj?La:oe/k	felf	feeling, sensation (n)	
e(r.>L-/FT	(1) ann; (2) fen(n)	door (n)	
ct1f_wQ%1Z	fend	threshold (n)	
A.M@Y2vIGk	fennas	great door, doorway, gateway (n)	
qPt(MtT;bt	feredis	hunter (f.) (n)	
))r/I%?TI	fergar	soon done (adj)	
jx*k.3A,=g	fergenol	quick to see or perceive, sharp-sighted or witted (adj)	
r`0dKWTc-Y	feria-	to make ready (promptly) (vb)	
LaYQ&=/oC4	fern	(1) dead (of mortals); (2) dead person; [N.] dead (of mortals) (n adj)	
HboG2KxUoE	ferui	ready to hand, (quickly) available (adj)	
G3:N9Wf)[p	fesga-	to itch, irritate (vb)	
nm(Go6uloR	fesg	itching, irritating (adj)	
AHbdNh%T.c	fess	itch, itching (n)	
k,RHnKg;_,	fidhras	collective hair, *all hair on the body (n)	
ur.PM4oJsx	fidhren	having hair, -haired (adj)	
Hej;zenGyy	(1) filc; (2) fileb	fern (n)	
v2/$u3{[3N	fim	slender, slim (adj)	
"wu4vV#@R6R"	finc	trick (n)	
gr%2?n]|vA	(1) findel; (2) finnel (n adj)	head of hair, fax, mass of long hair; having fine or beautiful hair (n adj)	
N1h0BWsw<J	find	(1) hair; (2) tress, [ON.] lock of hair; [ᴱN.] hair (in general) (n)	
iG`Q!Qu~~	fineg	*lock of hair (n)	
iEmZ6YBrs}	(1) fing; (2) finn (Body Parts and Functions)	lock of hair (n)	
JPpUf8C{%?	fini(o)s	larch (n)	
npZ}i.suw|	finna-	to trick, deceive, cheat, take in (vb)	
mBz?(4.cJo	finn	(1) hair; (2) tress; single hair; [ᴱN.] hair; [G.] lock of hair (n)	
%@od(gJw7	fir-	to fade, *die (vb)	
OH-zV-~in8	firin	dying (adj)	
v~y>^[ghS?	firith	(1) autumn; (2) fading; [late] autumn (n)	
"ky4fVRu#/y"	flinc	finch (n)	
k9!/q&5FLR	flâd	skin (n)	
et*0AH{{/.	foen (n)	long sight (n)	
Iz0::]8QXj	fordúnen	northwestern (adj)	
uS{Q@e4j$w	fordûn	northwest (n)	
s^oPr=tWx?	forn	(1) north, [N.] right; (2) right or north (adj)	
"mu-M0Gmfv#"	forod	north (n)	
r<Js];2+!5	forrúnen	northeast (adj)	
l(u6iX+5yt	forrûn	northeast (n)	
b6P/JOU:HR	forvo	right hand, right side (n)	
K<LV?_t:&]	(1) fofru; (2) fovas	folly (n)	
Kp)PVPNE;b	(1) fofrin; (2) fovren	foolish (adj)	
rK{MTV4z)V	fuin	(1) night; (2) night, dead of night; (3) night, gloom, darkness, [N.] dead of night (n)	
o^;_u.oyv@	fuiol	disgusting (adj)	
"lxyH]#Oej("	fuir	[N.] right (hand) (adj)	
vo8Kp^|z)3	fyvril	moth (n)	
Lb]r_Ujtis	fân	(white) cloud; veil, curtain; form or vision of a spiritual being (n)	
hrx_E+/>PN	fíreb	mortal (adj)	
IDI;!ByRr*	fîn	(single) hair, filament (n)	
"twsFRp#?WI"	fôf	fool (n)	
gf4,cWFz&z	(1) bad; (2) fû; (3) lonn	path (n)	
M>=:0*;&sE	gach	(1) cow; (2) milch cow (n)	
f;mq!2ucGI	gadas	trap (n)	
n|a%)EInv!	gaearon	ocean, (lit.) great sea (n)	
JQU;&WAz.!	gaeda-	to astound, make aghast (& surprise, shock) (vb)	
Arkg/*lrn:	gaer	(1) awful, fearful, [N.] dreadful; (2) dreadful (adj)	
n<`v!sb1ok	(1) gaeruil; (2) uil	seaweed (n)	
CtN(o+YvVd	gaesen	of steel (adj)	
KqIW11g=Rq	gaessarn	pearl, (lit.) sea-pebble (n)	
w7K0AfLPu=	gaes	steel (n)	
ks>J<$6WpB	gaethren	like steel (adj)	
g+Er7Su-Iv	gaew	pregnant (adj)	
i-ga2w8z]Z	gal- [ng-]	to shine clear, [G.] shine golden as the Sun (vb)	
L4zol[pY~7	gala-	to grow (vb)	
"I0gFJ!#fKJ"	galadhremmen	tree-meshed (adj)	
P}e-X*7J(v	(1) galadh; (2) orn	tree (n)	
OVg2q[Zup[	galad [ng-]	radiance, glittering reflection (n)	
eQ+w1j-!Lr	galenas	(1) pipeweed; (2) pipeweed, nicotiana, *tobacco (n)	
P68-!6]l`U	galenathrod	(smoking) pipe (n)	
Jz8$(mJ6D$	galen	grown (esp. of plants) (adj)	
hs30<^(.eV	galf	back [of a body], shoulders [collectively] (n)	
KCX`CpdoB`	galtha-	to be glad (vb)	
zX4/o]e?vG	galu	increase, growth (n)	
C0aC.i0BFx	galvorn	type of dark metal devised by Eöl, *(lit.) shining-black (n)	
d%C/5%}{Sb	gamp	(1) hook, claw; (2) hook, crook; [N.] claw (n)	
IOX7qg=%F4	ganna-	to gain, profit, increase; to be profitable, bring in revenue (vb)	
EbOTv5H&AX	gannan	waxen, grown big, grown up, adult, [originally?] large (adj)	
Dx|d6;aM_d	gant (adv)	larger, greater, more, (lit.) increased (adv)	
upc3|b=USS	gardh	region (n)	
u7MiA<aEKO	garnen	own, held, possessed (adj)	
t1n-Zl@NX^	garob	(1) cloak, outer garment; (2) robe, [G.] cloak, outer garment; (3) robe, [G.] outer garment (n)	
K0%K8K?zq{	gartha- (Possession and Trade)	to defend (vb)	
DLhyt@3rA1	gauda-	to invent, originate, devise (vb)	
"Ejob!0^#2g"	gaug	clumsy (adj)	
GfF)_hsPx3	gaur [ng-]	werewolf (n)	
s+ea/Bat}v	ged- [ñg-]	to get, catch, obtain, take (vb)	
NO(|X7=W6p	gelia- [ng-]	to learn (vb)	
nyS-g!|+3=	(1) dairion; (2) gelir	merry (adj)	
h,!Y]@oOI@	gella-	to rejoice, delight (vb)	
gV/y}n(f!f	genedia-	to reckon (vb)	
ndjot`@|[k	genediad	reckoning (n)	
LFd/<AquVC	geria-	to ponder (vb)	
zUjF?RqFH|	gil- [ng-]	to gleam, shine pale and silver (as of the moon [or stars]) (vb)	
htSm!E!GOJ	gil [ng-]	star; (bright) spark, silver glint, twinkle of light (n)	
mhq~U6/i`/	gir-	to shudder (vb)	
d!7Tks&cf~	girith	(1) shuddering, horror; (2) shuddering; [N.] horror (n)	
M,LZwumtHy	gladh-	to laugh [at a joke], *guffaw (vb)	
M*qemOPD2s	gladhweg	cheerful, (lit.) apt to laugh (adj)	
Qyk&pcJwuc	glad	wood (n)	
LQq+i)fW%*	glae(gal)	light (as an ethereal substance), *photons (n)	
ko]kuD*<F_	glaenas	fair weather; serenity (n)	
"nI^.~y#iWg"	glaen	serene, clear, fair (espec. of weather) (adj)	
"ymf#l#*zJ~"	glaer	(1) [N.] long lay, narrative poem; (2) long lay, narrative poem (n)	
nlMKM~k.-N	(1) glae; (2) half	grass (n)	
E/%|6~f<R{	glaich	merry, joyous, happy (adj)	
zLG{p^8!Q0	glamog	orc (n)	
Lr$4K!dhb8	glam	din, uproar, bellowing of beasts, [N.] shouting, confused noise; barbarous speech (n)	
BD/9=yJJ0G	glan(n)	boundary (n)	
nOwwL)p;G5	glandagol	boundary mark (n)	
ITyI0I%^5!	glanna-	to cleanse, purify, purge, *to clear, make clear (vb)	
Mw2:mwqR%@	glannaith	cleanliness, purity (n)	
LBY||8i)i/	glannas	purification (n)	
CxWrM;aG&3	glannen	cleanly, pure (adj)	
E,.-R>5V^Q	glassui	joyful, happy (adj)	
cqo])4-2wF	glasta-	(1) to joke; (2) to make happy (vb)	
bgJ90l~_4w	glast	marble (n)	
Ocv?Cw}4_b	glathralvas	flashing glass/crystal, *heliograph (n)	
vYLbfh*R;s	glathren	[of or like] marble (adj)	
wnoYiDZK5v	(1) cagli; (2) glaudh	joke, jest (n)	
cHVmG@?pow	glaur (n adj)	gold [light or colour] (n adj)	
K*64sXwMi$	glavradeb	full of the din of voices (adj)	
zVsG?w}wip	glavradol	chattering, talkative (adj)	
HpNw70dhX:	glavradon	vain talker, *chatterbox (n)	
"ppy#^,(_pB"	glavras	babble, chatter, babel, din of voices (n)	
w*o<W}Oex5	glawar (Physical Acts and Materials)	gold (light or colour); [N.] sunlight, radiance (of Laurelin) (n)	
u3RIPji`2V	glaw (Physical World)	sunshine; [N.] radiance (n)	
"u_Y*#K||8!"	gleina-	to bound, enclose, limit (vb)	
fzgEUM:;K8	gleinannen	bounded, enclosed, limited (adj)	
n+qP$*BET~	glenna-	*to travel (vb)	
Gx5=V>fA7G	glidheb	like honey (adj)	
k-lp[1{i1%	glim (n)	voice, *utterance (n)	
Dsy80~:0WD	glintha-	to glance (at) (vb)	
pF<g5%&C[%	glinthad	look, glance, flash of the eye (n)	
fvNXx^[fB/	glist	sugar (n)	
zB=M5evKn6	glodhren	jocular (adj)	
o3?nf]eyR?	glorchadhu	lotus, (lit.) golden seat (n)	
u+=-z+mX@P	(1) fautha-; (2) fôtha-; (3) glosta-	to snow (vb)	
=Bg,78M+7	glosui	snow white (adj)	
J5XunxY3]T	glân (adj)	[bright shining] white; [N.] clear; [G.] pure, †bright (adj)	
"d43:#3TEg"	glân (n)	hem, border (n)	
mB^ss1zD=5	glîn(n)	gleam, glint (n)	
Jp4OI$q!yE	(1) cuilin; (2) gloriel; (3) glóriel; (4) glórin; (5) mallen	golden (adj)	
KxuYC1&.=[	gobel	(1) (walled) village, town (enclosure); [N.] walled house, *manor; (2) walled house or village, town (n)	
o*rcFQNb2[	(1) gobem; (2) gogel; (3) gogìl	mouth (n)	
BJS:Od|p*Q	gobeth	dictionary (n)	
g8A%lRE&q3	gochest	(1) brother and brother, brother and sister, etc.; (2) brother and brother, brother and sister, etc., *a set of siblings (n)	
"E#*#N6Pw^s"	godref	abreast; *together-through (adv)	
E1,|;Nne=$	goeol	*fell, terrible, dire (adj)	
CDO(UMt~j{	goe (Emotion)	terror, great fear, [N.] dread (n)	
oudd|cojDU	goianna-	to join with, add to (vb)	
ncrnl^|8*~	golain	connection, relation, context, (lit.) threadage (n)	
"O_$ax+#N(("	golbar [ng-]	school, university, (lit.) wisdom-house (n)	
r@Cw@&g6o.	golodh [ng-]	lore-master, sage (n)	
bJt-Wla{Fi	golof	consonant (n)	
yQAlV)PTar	goloth	inflorescence, *collection of flowers (n)	
wGB`U^qz;5	goltha- [ng-]	to teach, educate, tutor, (lit.) make knowledgable (vb)	
CC}:nry.ot	golthannen [ng-]	learned, educated (adj)	
QRjXa0KE0W	golthanneth [ng-]	teaching, lesson (n)	
Js|f&z9pF$	golthas [ng-]	education, erudition (n)	
"e8Km^#TWSp"	golthor	teacher (n)	
OR<(Q+qpYR	golu [ng-]	lore, *wisdom (n)	
CWLw(Z&q9x	gond (Physical World)	stone, rock, [N.] stone (as a material) (n)	
p[hWP/xxpL	gonneb	stony, rocky (adj)	
r?F*f9IWn=	gonnos	great rock (n)	
QyR/,ql9Vy	gonnoth	pillar, stele, memorial (n)	
v~MoWtR(W0	(1) gond; (2) gonn	stone, rock (n)	
IL+UrFD~J]	gonoded	counting, accounting (n)	
n>r&xf4li[	gor- (pref)	hard, difficult (pref)	
k/I.jEVb%L	gor- (vb)	to warn, urge (vb)	
u$t1qR`X?3	goras	advice (n)	
kWD-_le6_w	gorbedui	only to be said with horror or grief, lamentable to tell (adj)	
os69%:lu4&	gorchanui	complicated, enigmatic, cryptic, hard to understand (adj)	
t<D)Hx}^T]	gordh (adj)	difficult, laborious (adj)	
"yor-v#g[zZ"	gordh (n)	deep thought (n)	
d]YzMwXk}{	goredhin	sib, akin, [closely] related (adj)	
BTkh5t$!xg	gorgor [ng-] (n)	extreme horror, terror, haunting fear (n)	
do;QrtbfVd	gorn [ng-]	revered (adj)	
y~wh(N-G6d	gornod(ui)	hard to count (adj)	
p<Q|0`)yH2	goroth [ng-]	horror, dread (n)	
q?Jt7B,eS^	gorthad [ng-]	wraith, spirit of Dead (n)	
cy_/{5Sl<{	gorthob [ng-]	horrible (adj)	
LN`b~0cl/Y	gorth [ng-]	dead; dead (person) (adj n)	
x)8r*VHBVr	gor [ng-]	horror, dread, fear (n)	
g1;e^q7&wH	govaethas	government (n)	
wH0Dr&B?cu	govai	alike, similar (adj adv)	
wk2OlHy~Cu	goven	crossroads (n)	
r`iLE<?v]c	govod	companionship, living together; community, fellowship, *(orig.) eating-together (n)	
Ba|tzU7)Hj	gratha-	to rub, scratch, fray (vb)	
eyy*F~ZCZV	graw	dark, swart (adj)	
zyU!`B2R+n	gresta-	to aid, help, succour, support (vb)	
Joc}8A=r66	grest (Social Relations)	aid, support, help, succour (n)	
ikc3E[HaW0	grod	large excavation, delving, underground dwelling (n)	
F3?G3[Dl,0	groga-	to feel terror (vb)	
p.d:dk3dm;	groth	(1) cave, tunnel; (2) large excavation, delving, underground dwelling; [N.] cave, tunnel, [G.] grot (n)	
P~1,$V2gqP	gruitha-	to terrify (vb)	
NN^8;]8i7@	guir	slow (adj)	
r>Hg2Z7:,V	guldur [ng-]	black arts, sorcery (n)	
r<mjUidAzg	gurgof	traitor (n)	
pB6]b`ET^Q	(1) gurth [ng-]; (2) gurth(u) (Body Parts and Functions)	death (n)	
y(pK|4&Jp;	guruthos [ng-]	(1) dread of death, death-horror, shadow of death, [N.] fear of death; (2) fear of death (n)	
IBi3a5RjES	guru [ng-]	death (abstract) (n)	
AdO3wNe4GS	gu	(together) with (prep)	
blmwNZwR!^	(1) go-; (2) gwa-	(1) together; (2) together, co(n)-; (3) together, co-, com-; (4) together, in one; with (pref)	
mMXAAE(NEQ	gwachae	far away (adj)	
dk4?}-~6,6	gwae-	to go, depart (vb)	
MhMgHBZAZ]	gwaef	wrap, binding (n)	
HL,QODh/aE	(1) bail; (2) gwael	sheath, case, cover; pod (n)	
p1.94$Je[F	gwaelphilin	quiver, (lit.) case of arrows (n)	
n/L.^Vw!BT	gwaen	stained (adj)	
l.[_H>xjEA	(1) alagon; (2) gwaew	storm (n)	
"sw}c&p)9l#"	(1) gwae; (2) gwaew; (3) gwâ	wind (n)	
B:neb/Ofq[	gwain (Body Parts and Functions)	blond (adj)	
t3-4gtxU`$	gwain (Time)	young, *new (adj)	
i92,Qz<,zy	gwaith	(1) people; (2) people, [ᴱN.] men, folk; [N.] manhood; man-power, troop of able bodied men, host, regiment; [S.] region; (3) people, men, folk (n)	
uiWF]f15cO	gwalir (Language and Music)	rhyme, rime (the two actual rhyming words), rhyming poem (n)	
uSW{}*m2A3	gwall	excited (adj)	
D_ow,M`brL	gwana	fair (n adj)	
vxlp_+0@xq	gwanos	(1) family, birth, heredity; (2) family, birth, heredity, *lineage (n)	
KB7{lT7z0C	gwanunig	twin (n)	
CqJv@DVY[<	gwanuren	of same kindred, akin (adj)	
Ds0GN/k!Ln	(1) gwanath; (2) gwanu	death (act of dying) (n)	
La+BdEYFwd	(1) dimborn; (2) gwanwas	the past, past days, olden times (n)	
nh6$[N1/0n	gwanwen	departed, *gone, lost [to time], past (adj)	
"pVx>R4#!c7"	gwar- (n)	to yield, give way, surrender (n)	
Mo8sgX00Ye	gwaren (Mankind)	[nuclear] family (n)	
MWxJ7Ai`$?	gwathra-	to overshadow, dim, veil, obscure (vb)	
j4z-I+IEga	gwathren	shadowy, dim (adj)	
kT*~nmL-WJ	gwathui	*shadowy, of shadow (adj)	
"Ap<QqJ#*5E"	gwedhen	oath-bound, allied (adj)	
A7-gFiQ?ku	gwedhron	ally, one bound by oath (n)	
p([]zESxC6	gwef	louse (n)	
ND3@W?}DE;	gwel-	(1) to boil, bubble; (2) to boil; to bubble (intr.) (vb)	
ytDpH^4r?-	gwelch	bubble (n)	
"c#6:HV7,y0"	gweleb	cool, fresh (esp. of water) (adj)	
LzDP{[9bf*	gweleth	boil, bubble (n)	
y|_xQH>J(C	gweltha-	to squeeze, press (vb)	
m(pw:5~+`9	gwelu	air (as a substance) (n)	
g~MPX|0_.J	(1) gweml(i); (2) gwemmel	weevil (n)	
"gVA#4Rc8K!"	gwendren	maidenly, girlish (adj)	
dfJB_2{Qy~	gwend (Mankind)	maiden, *young woman (n)	
n$P4VcLW&c	gweneth	(1) maidenhood, [N.] virginity; (2) virginity (n)	
"j3tz{#n}s%"	gwennod	elder tree; elderberry, *(lit.) maiden berry (n)	
xKLsIt2UpC	gwenwi	past, past tense (n)	
h9!cZaN*_A	gwesg (adv adj)	weakly, *weak (adv adj)	
l;aZu:nkwv	gweth-	*to report (vb)	
B2_ZV|9w-M	gwidhren	adolescent, pre-adult (adj)	
fFr;@T^TZj	(1) duila-; (2) gwil-	to fly (vb)	
O`6_4nfW&?	gwiltha-	to air, expose to air (vb)	
jEaP:6MHg[	gwilwa-	to flutter, flit (vb)	
"l#q^|oEFNd"	gwilwist	weather (n)	
"uXHj3{t{l#"	gwimmaf	whale, (lit.) sheep of the waves (n)	
n*m:~GY1$R	gwineb	youthful (adj)	
OW.Zuhcz{&	gwingil	(1) foam maiden, mermaid; (2) mermaid, (lit.) foam maiden (n)	
eJXyb-uRfh	gwing	(1) foam, spindrift, [N.] flying spray; [G.] wave-crest; (2) spindrift, flying spray; (3) wave-crest, crest, foam (n)	
jA)$1so7$^	gwinig	little-one, baby (n)	
tN5:b]F1U^	gwir-	to weave (vb)	
j><:ZG>KdR	gwirfin	braid, pigtail, (lit.) woven-tress (n)	
m}<La]GBC(	gwiril	spindle (n)	
xqJU6g/PGC	gwirthar	shuttle, (lit.) weave-across (n)	
hI{G/<{hb&	gwista-	to change, alter, vary (vb)	
"x|{zQmHHV#"	gwistanneth	alteration, variation (n)	
O-V*}@Q6;|	gwistol	changing, varying, variable (adj)	
bb6G0<M2-f	gwist	change (n)	
M0e&tdb7sw	gwê	living creature, *living being (n)	
w=V9KpI!Uf	gwí	just, just now, only just, already (adv)	
wKWbdKPW|,	gwîb	penis (n)	
pPlbM7(TDE	(1) gwîn; (2) nîth (n)	youth (n)	
xEbqMGHVqQ	gythra-	to germinate, be conceived (vb)	
eb1C1o%$H^	gythren	embryonic (adj)	
dR/1oD(h+|	gûl [ng-] (Religion and Beliefs)	black arts, sorcery, (evil) knowledge, [N.] magic (n)	
h>-1s<ywYQ	gûr	heart (inner mind) (n)	
"yh$>g#Ft5."	gýda-	to impregnate, make pregant (vb)	
m=q~S4%=.E	(1) giwl; (2) giwol; (3) gŷl	fecund; conceiving, having conceived, just pregnant (adj)	
I56y@~Y{:R	(1) giwth; (2) gŷth	germ, foetus, embryon (n)	
xK+yr*U_,&	hach	the hams, buttocks (n)	
E>Qxm}jd3Y	hadang	javelin, (lit.) hurling iron (n)	
m&RG(/ZHb|	hadh- (Spatial Relations)	to sit (vb)	
couMU`geF|	hadhu	seat, *chair (n)	
qwa{IO5v<g	(1) hadlath; (2) tlaiw	sling (n)	
s/VrhUP7&B	haeda-	to remove, (lit.) make distant (vb)	
F)A!_MdS[%	haedh	fenced enclosure (n)	
J(EQ,0$FtJ	haena-	to leave, depart, (lit.) be(come) distant (vb)	
"hb!J]?Y0#^"	haered	remoteness, (remote) distance (n)	
MOl*@m!+5x	haeron	*distant (adj)	
L,FviGsiFY	haer	remote, *distant (adj)	
r6GH{)H~jM	hae	(1) *far; (2) far, (very) far away (adj adv)	
p],:W`d[;q	hair (n adj)	left (hand) (n adj)	
qWEo@@w=}]	hallas	height (n)	
C7}<ZBie!S	hammen	clothed, clad (adj)	
CFnb(ODx`+	hand	intelligent (adj)	
jV%6zXIobQ	hannen	seated (adj)	
vZdEZwO|3}	hant	throw, cast; turn or move in games (n)	
MEWBz*Dk$f	harad	south (n)	
k=c:|zfN]b	hardúnen	southwestern (adj)	
f+$Z1AKuBY	hardûn	southwest (n)	
"p}1b#=5P7Q"	harnas	harm, damage (n)	
MBIO/PKW>|	harn (Spatial Relations)	south, southern (adj)	
N@)K;pB}Uy	harrúnen	southeast (adj)	
"g/6Qyo:G#Y"	harrûn	southeast (n)	
G-S2k~@)x-	(1) haru; (2) harw	wound (n)	
t=k3CsP%va	harvo	left hand, left side (n)	
CVR4^%574i	(1) hathol; (2) peleg; (3) tael	axe (n)	
A>EJXP&05Z	haudha-	to lay in store; to hoard, save, record; to bury (vb)	
jgT%f:pmHg	haudh	(1) (funeral) mound, grave, [N.] tomb; [orig.] †heap, piled mound; (2) grave, tomb; (piled) mound, heap (n)	
Rh9O5UFr}C	haug	low (adj)	
rm~fBm7TYy	(1) hau-; (2) haw-	to lie (vb)	
"jP#*%LhLO)"	ha	there you are (interj)	
l19P[EP9A6	heb-	to keep (vb)	
DfKgImAA<Z	hebia-	to delay, retain, keep (temporarily) (vb)	
igiF=*YyRY	hedril	thrower (f.) (n)	
Bi)$FGFRR+	hel-	to freeze (vb)	
IV.1Ajz@db	heledhren	glassy, like glass, of glass (adj)	
Mxp{_QS1b5	(1) caileg; (2) heledh; (3) talp	glass (n)	
J}_%)ctJI9	hellen	frozen (adj)	
bW!]Rssu/B	hemp	(1) a band, bond; cord; (2) band, bond (n)	
Bqf]=N4^QX	(1) hen(d); (2) hen(n); (3) hên	eye (n)	
l0:0s,5O<j	hendelu	brow (n)	
sd4q-j|}]m	henna-	to read (vb)	
jj[v~5q)9+	henneth	window (n)	
lW^=[k%]mX	hent	(1) eyesight; (2) eyesight, *(sense of) sight (n)	
Cc3I|%p%Jb	herdir	master (n)	
G/Vyr$rl$T	herf	protection, lordship, sway (n)	
sWX,3d&RG%	hesg	withered (adj)	
q|r1pcB%m=	hest	(1) brother or sister, *sibling; †consanguinity; (2) sibling (n)	
}?(4JRWx{	hethu	foggy, obscure, vague (adj)	
HZdCVZ*o-W	hich-	to vomit (vb)	
CPav@wJW?s	hilf	posterity; one’s descendants, progeny, offspring (collective-noun)	
xXCR72-%%:	hilvias	inheritance, heritage (n)	
op4$S*[`E>	him	(1) enduring, continually; steadfast, abiding; (2) ever, [N.] enduring, continually; steadfast, abiding (adv adj)	
"cv#gzAhmyy"	hinia-	to stick to, adhere, cleave to, abide by (vb)	
gb&R`|nrzr	hir-	to find, *light on, chance on (vb)	
"P*6y>wr1m#"	hithlain	mist thread, grey elvish rope (n)	
J!=;w7H/fi	hithui	misty (adj)	
x85vD?II3z	hithu	fog (n)	
KY/=&CcP_*	hoda-	to lay, stretch out, lay flat on ground (vb)	
P`?st5`3%$	hogren	lowly, humble, mean (adj)	
u-dTyio!*^	hol-	to close, shut (vb)	
jn$)M:`$]s	hollen	closed, shut (adj)	
wUnTS*gU_3	holl	cock, cockerel, rooster (n)	
O`dwITfd9|	hora-	to await, expect (vb)	
GgLPh=@Wo)	hosta-	to gather, collect (vb)	
JbBN*3)7f_	hothron	captain (n)	
Iy%-ON<<0.	hoth	(1) folk, people, †army; (2) host, crowd; group plural; (3) host, folk; (4) host, horde (n)	
"wKY#8/f;dx"	huan	(1) great dog, hound; (2) hound (n)	
LVbzr6LH01	huar	wild dog (n)	
"I&pI#},a]"	huia-	to urge on (vb)	
k!&5!y*lA~	huil	(1) bitch, *female dog; (2) hen (n)	
HE?9E~T1n,	hunc	pig (n)	
tOL[geW}B8	huorn	?spirit tree (n)	
g5jG.D<PK+	(1) hwand; (2) hwann	sponge, fungus (n)	
pP43hGx$7R	hwegol	brush (n)	
y-(kSBbaa6	hwegra-	to sweep (vb)	
m%Cv_%bG3O	hweg	broom (n)	
fnCL@/3WGv	hwest	puff, breath, breeze (n)	
tyP(J,Al}<	hwiel	niece (n)	
Mu|./?j_)s	hwind	eddy (n)	
GE%@4LMyRB	hwinia-	to twirl, whirl, eddy (vb)	
f{aaA@bR*Q	hwiniol	whirling, giddy, mad, fantastic (adj)	
vRF%s9Fiys	hwinn	birch (n)	
qb87Q|%QN6	hwion	nephew (n)	
F1<EaFH&AQ	hwîn	giddyness, faintness (n)	
nt{niu/!m%	hên (Mankind)	child (n)	
d5;3$<=eE?	hída-	to (come to) pass, happen (vb)	
Mkm`4@F4]S	hîl	heir (n)	
u,?MU,M^?|	(1) heron; (2) hîr	lord, master (n)	
w^(V)c7sGt	hîth	mist (n)	
QhO>s6-l:8	húda-	to curse (vb)	
QUTTD}qQ?Y	hûn	(1) *heart; (2) heart (physical) (n)	
EsU5!+0[:8	i (article)	the (article)	
MX=BDTxhpy	i (pron)	who, that, [G.] indefinite indeclinable relative particle (pron)	
qV6Q.kDldQ	iach	ford (n)	
wua=+Z8Z|)	iaeda-	to mock, deride, make fun of, laugh at (vb)	
z%z1oJ~spF	iaewen	scornful (adj)	
q~YCuPgHh@	ialtha-	to yoke (vb)	
JW>WL3y*}6	ialt	yoke (n)	
o&8%w$aFaV	ianna-	to join, connect (vb)	
D:^lodp^a@	iannen	joined, connected (adj)	
FQP,VGOm$8	iant	bridge (n)	
"G!,5sINT*#"	iaun (adj)	wide, extensive, large, roomy, vast, huge (adj)	
rrXnU*cAhO	iaur	(1) ancient, old(en); (2) old; [N.] ancient, olden (adj)	
M/<GQQ.IQW	iaust	crop, *yield, produce (n)	
"iER>,J#[:p"	iav-	to produce, yield, bear fruit (vb)	
y8,L9B_,fJ	iavas	autumn, *harvest (time) (n)	
"p/!1#dS!)Y"	iavren	fertile (adj)	
r4G1r`|{I:	iaw	when (conj)	
"v6W9x*Zz#C"	idhor	thoughtfulness (adj)	
"g#PtR=uC5M"	idhrinn	year, *(lit.) year-circle (n)	
qArqG)60-C	iesta- (Emotion)	to wish (vb)	
w%?03A2>b<	iesta- (Time)	to begin (vb)	
Pj0$$gVT{R	iestor	first day of the new year (n)	
"A)[2#ImsDX"	ifant	*aged (adj)	
lzZX%wpUHD	ilaurui	*daily (adj)	
uq=w;.E]=.	ilhad	everywhere (pron)	
N~Ep]|<+T/	illadui	general (adj)	
B<fAU@su$Z	illad	everything (n)	
F~jI(Rod/O	ilnad	everything (pron)	
KLXGE}/<V!	ilphen	everyone (pron)	
q}M+.wZ6qJ	ilu	universe, the whole, cosmos (n)	
bM*7Bf^z|k	il	*all (adj)	
wAQupZZ1k1	im (n, Physical World)	valley; [N.] dell, deep vale (n)	
I!d&2X3ze%	im (prep)	between (prep)	
DUB4CZV=7=	im (pron)	(1) I; (2) I, I myself; reflexive, self(same) (pron)	
Lqap=D8/^N	imeneth	namesake, (lit.) same name (n)	
g2U*rbBez+	imladren	vale like, of the vale (adj)	
j4};6qc61_	imlad	(1) deep valley, narrow valley with steep sides, gap, gully, [N.] dell, glen; (2) dell, deep vale, glen (n)	
"qKxM#%3)m["	imrad	path or pass between mountains or trackless forest, *(lit.) valley path (n)	
P^jP[?QY^c	imrath	long narrow valley with road or watercourse running through it lengthwise, *(lit.) valley course (n)	
JnptLSg*iH	indram	shock, (lit.) mind-blow (n)	
L>~%AeXZfT	ind	(1) inner thought, meaning, heart; (2) some particular purpose or intention of an individual; heart [metaphorical], [N.] inner thought, meaning (n)	
z{_g[FW@tT	innas	*will (n)	
Kz_hif$9(6	inn	(1) house, abode; (2) inner thought, meaning, heart; (3) some particular purpose or intention of an individual (n)	
H}M@Z2@Ks@	inu	female (adj n)	
k?g-C`f~!*	inwas	feminity, womanhood (n)	
cx`{YG(sYF	inwathren	feminine (adj)	
DswFlL,!4p	ion(n)	son, *boy (n)	
J_T7|F>w!9	iorbeth	archaism, archaic word (n)	
jHuKQRBQ30	iphant	[N.] aged, having lived long, (lit.) year-full (adj)	
CF[)qSRa}@	irdh	entrails, bowels, innards (n)	
MB|:t}bq~}	irn	desired, wished for (adj)	
eacF8ouKlH	irtha-	to peck (vb)	
sNVFdlJv5R	irth	beak (n)	
zcPW7,urxa	ir (conj)	?when, while (conj)	
Kn6=)v1-Td	ithildin	(1) *moon-star; (2) magical alloy that glows in moonlight, (lit.) moon-star (n)	
LFxEVBjTcX	ithron	Wizard (n)	
vuG3(tfQ(|	ivil	inside (n)	
yRR3Tlv(k5	iâd	waist; isthmus (n)	
"qY[9#-HW?K"	iâf	fruit (n)	
tI1MO$=yY6	iâ	chasm, pit; void, abyss; [N.] gulf (n)	
i&mCSn^o^(	l(h)ô	flood, fenland (n)	
fz;YRio71L	laba-	to hop (vb)	
An6gOIPq7!	laboth	(1) a hare; (2) hare, *rabbit (n)	
zc8OhB_<Ia	lacha-	to flame (vb)	
L/u@9PK-=l	lach	(leaping) flame (n)	
wZw0}*K2S{	lad (Physical World)	plain (n)	
md_D*YKUBq	lad (Quantity and Number)	nothing, zero (n)	
Qd~u}fRfmm	lad-	to stretch, extend (in length) (vb)	
"x#53KZ$Sw"	laden (Spatial Relations)	flat, wide, *level; [N.] open, cleared; [G.] fair, equitable (adj)	
EDh,ru}T;$	ladog	(1) tin; (2) tin [metal] (n)	
"I((pM8(5q#"	laeda-	to refresh, revive (vb)	
u<`C+az@X]	laegas	verdure, greenness (n)	
"dJ<f]3}#Bg"	laeglin(n)	greenfinch (n)	
O^ZUuceGST	laeg	(1) green, viridis, green (of leaves/herbiage), fresh; (2) keen, sharp, acute (adj)	
"Na:6l.#vA7"	(1) golyn; (2) laer (Language and Music)	song (n)	
D0lDVcxu(Z	(1) aust; (2) laer; (3) safwen (Time)	summer (n)	
k|wbr|4$$L	laew (Quantity and Number)	frequent, many (adj)	
"LUYmucA#f|"	laew (Time)	fresh (adj)	
yS?gE1JKMQ	laeweth	freshness (n)	
P<nREPpltV	lae	great number (n)	
"B<]j#~&5;@"	lagor	swift, rapid (adj)	
HJf(<umfX:	laidh	horizontal, (lit.) lying flat (adj)	
t9>PY?W5?Q	lain (adj)	free(d), *liberated (adj)	
kz>jJx&uK.	lain (n)	thread, warp (n)	
fph.j(S@:o	(1) cancha-; (2) lala-	to laugh (vb)	
H%9sXR@qUN	lalaith	laughter (n)	
x_Q/_/CHXQ	lallen	funny, amusing (adj)	
K=*EN*JOOB	lall	laugh (n)	
y:lTT+DORs	laltha-	to amuse, make laugh (vb)	
PId[aS*4]|	lalweg	cheerful (adj)	
yx-_GhJ5q}	lam (Language and Music)	(1) (physical) tongue; language; (2) tongue, speech (n)	
cv&jak|<R)	lam (Sense Perception)	echo (n)	
M|5)6@U!{1	lamel	phonetics (n)	
D~O/Xn7b[X	lamengolu	linguistics (n)	
Bi`]+K[?E3	lamma-	to echo (vb)	
vnPm];y2nU	lammad	*echoing (n)	
bw+R5p%>)@	lammen	of tongue, spoken with tongue (adj)	
xVePOO5j[V	lanad	weft, woof (n)	
u|h9U/y.vD	(1) falin; (2) lanc; (3) umaith (adj)	naked (adj)	
EjqAuYer_6	lanc (n)	sharp edge (not of tools), sudden end (n)	
J]*,zX,z`d	land	(1) broad; (2) wide, broad; [N.] open space, level (adj)	
tJo6Urr;HO	lang (Body Parts and Functions)	passage; neck, *throat (n)	
ujFqJ/S*Q{	lang (Warfare and Hunting)	cutlass, sword (n)	
gr$V]y7=>@	langan(d)	stringed instrument with a neck (lute, guitar, etc.) (n)	
w8b$@{ICEE	lann (adj)	wide, broad (adj)	
P&(QL%lq:b	lann (n)	thin cloth, tissue (n)	
hd`%<JJGFK	(1) lanthir; (2) âch	waterfall (n)	
FAX:|{F_-6	lant	clearing in the forest (n)	
zBbkq3q<DL	lanu	loom (n)	
n`:PQY4rYM	(1) laf; (2) laph	loose-end, end of rope, hem of robe (n)	
klXitAvJTI	lasbelin (Time)	leaf-fall, autumn (n)	
uU{BEj%ea3	lasta-	(1) blink, wink; (2) to listen, give ear (vb)	
hO$%X2LfU@	lastadui	audible (adj)	
v`V^jhE=~n	lastad	listening, hearkening, attention (n)	
hTS2et(&*u	lasto	listen, *hark (interj)	
vH`B/qFX&u	last	(sense of) hearing (n)	
CMi=ZK::Ev	(1) las; (2) lhas	leaf (n)	
z+q_[tR/g	lathr(ad)a-	to listen in, eavesdrop (vb)	
Ck7t?)tbi!	lathron	hearer, listener, eavesdropper (n)	
I5E!e=+oNl	lath	thong (of leather) (n)	
"dLBX$1Pm~#"	laub	shirt (n)	
KkS3FyS^+p	laudh (Body Parts and Functions)	(1) gluttonous eating, [N.] †licking up (food or drink); (2) licking up (food or drink), gluttonous eating (n)	
rPuS!tPqfX	laudh	gluttonous eating (n)	
k~7b>Ze^AL	laug	warm (adj)	
Qx^wSfcgqn	lav-	to lick (vb)	
g-g-WshSI4	lavan	animal (n)	
QO>U0i;7W<	lavra-	to lap (of animals), suck up (vb)	
PP<q>VB[(a	(1) law; (2) lin	sound (n)	
z^B9.::$n;	leb-	to pick, pluck, take or feel or touch with fingers, cull (vb)	
N$Hd@rm3W>	lebenedh	middle finger (n)	
JE<Ac[Sf]o	lebent	fourth finger (n)	
C=HL]5o6]d	leben	five (cardinal)	
CJ]iH%/f8u	(1) leberen; (2) lepthindros	fingered, of fingers (adj)	
J,0!t-AafX	leber	finger (n)	
we54B7c3%=	lebethron	Gondorian hardwood, *(lit.) finger tree (n)	
LNS?:Rml[w	ledia-	to open; unlock (transitive) (vb)	
BIK{3d9O2=	legol	[Ilk.] nimble, active, running free (adj)	
w,kZ}fC&pD	leidhron	liberator, saviour (n)	
pk;&.)QMX!	leinas	freedom, liberty (n)	
GQ+!8raS%P	leithia- (Possession and Trade)	to release, [N.] set free (vb)	
E,Q(m:qAeL	leithian (Possession and Trade)	release from bondage, [N.] release, freeing (n)	
"wO6:Y#^j`V"	lembas	(1) waybread; (2) waybread, journey-bread (n)	
"z&Lj3<#OWY"	lemma-	to beckon, crook the finger (vb)	
mEmnz`(G&`	lend	tuneful, sweet (adj)	
s|P{JQyOjB	lenia-	to sound, make a noise (vb)	
ySxQ32t(@r	lephaen	fifty (cardinal)	
dP7Ca!Dk%Y	lest	girdle, *belt (n)	
o}EH*:)Q$m	lethril	hearer, listener, eavesdropper (f.) (n)	
H)*]Ev@hel	leutha-	to pick (up/out) (vb)	
QtzZa]M5a;	le (pron)	thee, you (polite) (pron)	
h(A4=RBCmM	lhab-	to sup, *sip (vb)	
j=)Lpoopn2	lhab	sip (n)	
Ey.f)ym+uv	lhaew	sickly, sick, ill (adj)	
l6VQ<n<8K-	lhain	lean, thin, meagre (adj)	
LO]2tog}YZ	lhaw	ears (of one person) (n)	
zbx[xYY]B(	lheweg	ear (n)	
FiqRZf[MVK	lhid-	to sort out, sift, sieve, discriminate (vb)	
duPleK%-+D	lhig-	to creep, sneak, do or go by stealth (vb)	
Q:GUtQfH1	lhim	sliding, gliding, slippery, sleek (adj)	
DDi2iqJB2+	(1) lhind; (2) thlind (adj)	fine, slender (adj)	
B:{B@/IT3@	lhing	spider’s web, cobweb (n)	
m*bCAg/qKS	lhinnas	slenderness, thinness (n)	
iRy9/TT]_7	lhoereb	venomous, poisonous (adj)	
M1=6d1M}2K	lhoer	venom, poison(ousness) (n)	
pcAG,g>s=j	lhoew	poison(ous substance) (n)	
qFigcuzjk%	lhongannas	phonology, (lit.) shapes of sounds (n)	
b05!<Nej|>	lhongant	allophone, surface sound, (lit.) sound-shape (n)	
"p]#{o3D264"	lhossa-	to whisper, rustle (vb)	
It;<WET?w9	lhunc	pharynx, gullet (n)	
LO6a/mT<aS	lhê	fine thread, spider filament (n)	
D|vx.0[kOe	lhîd	sieve (n)	
mn77I<UREw	lhîw	sickness, disease (n)	
BIW:z-cyYS	lhôn	noise; *phone (in linguistics), speech sound (n)	
I@B?8CVD:%	lhûg	reptile, snake, serpent, worm, *lizard; [N.] dragon (n)	
E:RV@+|1&}	lhýda-	to make sick, sicken (vb)	
GF!00;jt!y	liltha-	to dance (vb)	
q9{:U;!1>I	lilt	dance (n)	
-|-/&qjPS	lim (adj)	(1) *swift; (2) quick, swift (adj)	
"vO#5Wa.3*5"	(1) hâl; (2) lim	fish (n)	
9m`$Abt{S	limig	(1) [small] drop; (2) drop of water (n)	
f5syP_@SI_	limlug	fish-dragon, sea-serpent (n)	
"q@)#@=kp?["	limmeg	young fish, small fry (n)	
U=R.Iq}-~	limmid(a)-	to moisten (vb)	
tJ&V+m[!q?	limp (adj n)	clear, sparkling; (bright/clear/gleaming) liquid (adj n)	
Q!-w/Ki@>g	(1) lhim(p); (2) limp; (3) mesc; (4) mesg; (5) nenui (adj)	wet (adj)	
"y}Z/jw#{4e"	linna-	to sing, chant (vb)	
cS2|!,gh}=	linnas	music (n)	
F<7kzVWC&5	linnathren	musical (adj)	
lIjQ+!X5a6	linnod	type of poetic meter, (lit.) ?seven-chant (n)	
"Lo#|^:Xy2z"	linnor	singer (n)	
KL^r])AO&	linn	song, chant (n)	
Ckc3R-I3+d	lisg	(1) reed, [G.] sedge; (2) reed, sedge (n)	
mVj.q![u]G	lissuin	a fragrant flower (n)	
"MBh#y&C?vg"	liss	fragrant, sweet (adj)	
o$A~6(|lb3	lista-	to show grace, kindness (vb)	
NIr1b338AR	listo	please! (interj)	
Iajap)zpk7	list	grace, favour, kindness (n)	
yk&R@M5X5X	lithui	(1) ash[en]; (2) ashen, ashy, of ash, ash-coloured, dusty (adj)	
q2*exQ@Zf_	lith	(1) ash; [N.] sand; (2) sand (n)	
"cxy3{H[Nd#"	liv-	to drip (vb)	
wDr!`T%2_P	lob-	(1) to gallop, *lope; (2) to run, gallop (of animals) (vb)	
w>KUS+(b_0	lobrob	gallop; sound of horse’s feet (n)	
Ejv$<!.K;B	loda- (Motion and Transportation)	to float (vb)	
xLcUB87P(3	(1) eilin; (2) loeg	pool (n)	
E9CO*D8uu1	loen	soaking wet, swamped (adj)	
QA<&:M:,7^	loetha-	to curl, bend, wind, twine (vb)	
y6pl:NQz$L	loeth	twist, tendril, spiral, coil (n)	
r-=(QD=5=W	loew	moss (n)	
pr@VyXd+;K	log-	to haul, drag (vb)	
QW(8@cRk?.	logra-	to stoop, bow, cower; to submit (vb)	
rbOvs=T$8W	logren	curled, curly, *bending, looping (adj)	
Sh0x78M56	logweg	meandering, twisting, winding; intricate; (lit.) apt to bend (adj)	
"Pr#LsglcC)"	lom	weary, *tired (adj)	
C!&}$2C$mP	lonc	curl (n)	
B8/I&9>)0~	lond	(land-locked) haven; [N.] narrow path, strait, pass (n)	
E<JQArH.f4	(1) hobas; (2) lonnas	harbourage (n)	
"hW,#C7)USM"	lonn	(land-locked) haven; [N.] pass (n)	
dfyor3z]Dn	loph	nugget, (small) chunk, clump, tidbit (n)	
eR]$M=!jw	lor-	(1) to sleep deep, dream (tr.); (2) to sleep, slumber (vb)	
fmjUe?{^zi	lorn	asleep (adj)	
Jx-`1ct:zZ	lortha-	to put to sleep, send to sleep (vb)	
o!:UQ_FXHk	losbas	ryebread (n)	
P]E*VkGcXP	(1) losc; (2) losg	rye (n)	
L:x[SY@x18	lossen	snowy (adj)	
Dk<2{vb[D9	losta-	to bloom, blossom (vb)	
G2&C,eMVCx	lostad	blooming, florescence (n)	
lClK4C{AY(	(1) lost; (2) nil	empty (adj)	
Ho4qAcnyc:	lothalan	raft, (lit.) floating platform (n)	
L3rRn.MZKE	lotheg	single [small] flower, *floret (n)	
e)ek*_$yIs	loth	(1) flower, lily; (2) flower, single blossom; inflorescence, head of small flowers (n)	
OhV4.F;Vta	loven	echoing (adj)	
mV&q421Og4	lo (conj)	while (conj)	
VA5i.N;96	luig	minute, moment (n)	
D=B/q}%p,0	luin	blue (adj)	
AtSvg5B^E$	lui	(1) blueness, livor, livid mark; (2) blueness; livor, livid mark, *bruise (n)	
q{6pQd)~._	lummor	foul weather (n)	
PlBE?KE+F9	lumren	shady, [G.] overcast (n)	
CH36Qbf8^d	lum	(1) cloud; (2) shade, *a thing blocking light; [G.] [dark] cloud (n)	
P(nKkDJ;o2	lung (adj)	heavy; [G.] grave, serious (adj)	
P?<M=/:9,l	lunt	boat (n)	
B`.4olZA@+	lurlos	poppy, (lit.) flower of sleep (n)	
z]1eBnSO3T	lígu	candle (n)	
x97L_fWFk!	lín	*thy (pron)	
O?4R~hJc15	lítha-	to let slip, lose, mislay; (intr.) to be lost; forget (vb)	
e9WlvqA$Iu	lîdh	journey (n)	
nh9]]dsC!<	lîf	link, *joint (n)	
>r,+)yGMz	lîg	wax (n)	
b,;.JCWs}o	lîn	pool, mere (n)	
dmb<MNPOUf	lîr	line, [N.] row (n)	
r!K+D%.qEQ	lî	(1) folk, many people, ‘they’, a crowd of folk; (2) people (of one kind or origin) (n)	
uOLyOdE+Wj	lóran	seasonal year, (lit.) growth-cycle (n)	
Bnen&(ay%r	l(h)ô	flood, fenland (n)	
oSTQG&y5Um	lúda-	to pass (of time); to come to pass, occur, *happen (vb)	
kGQU@v)+|3	lútha-	to enchant (vb)	
CVHx;?jD!%	lúthad	enchantments, sorcery (n)	
P!&wqrY%6<	lûb	fat, (fat) flesh (n)	
O~,pTMiY?,	lûg	bend, loop, wind, twist; guile, deceit (n)	
"F#=HTHS1zR"	lûr	(1) sleep, slumber; (2) slumber (n)	
Dl{2iKF_n=	lûth (Agriculture and Vegetation)	blossom, inflorescence [on a single plant] (n)	
"D(#6`c|%>i"	lûth (Religion and Beliefs)	spell, charm, [ᴱN.] magic (n)	
BUddnm{_u8	lû	time, occasion (n)	
i~3/6u4fTV	lŷg	snake (n)	
FmCCUl[re(	mab-	to seize, *grasp, grab (vb)	
"Id)LFB{#<{"	mabed-	to ask [a question] (vb)	
uH6kwkc.!3	mablanthos	sycamore (n)	
l4Tv[z.W?z	mabrenas	dexterity (n)	
z]tuca*z,X	mabren	handed, having hands, dextrous (adj)	
iZIEy3umN`	mad-	to eat (vb)	
FguCpO(qg)	madha	mud (n)	
kFjH|L=q>/	madhren	muddy (adj)	
l]T>TJ<,(H	madui	edible (adj)	
Pcx@n8~1(5	madweg	gluttonous (adj)	
zvaj%s]wwQ	mae (adj)	soft, pliant (adj)	
KwOH]C4R2^	mae (adv adj)	well; excellent, admirable (adv adj)	
N-d[Km$)L?	maeas	dough (n)	
O&eon9?yPn	maecheneb	sharp-eye[d] (adj)	
GSEF=s_3y!	maed (Emotion)	shapely, *pretty (adj)	
"gY#/Y0uQrp"	maed (Physical Acts and Materials)	handy, skillful, [N.] skilled (adj)	
Rf_4}-JBDe	maedol	welcome (adj n)	
Km5p`]nr*W	(1) lectha-; (2) maegra-	to sharpen (vb)	
cV?,pva03U	maeg	piercing, sharp, *penetrating (adj)	
l1&ZH%Rvni	mael (adj)	well (adj)	
lUq{w@8:7J	mael (n adj)	stain; stained (n adj)	
M3[ee&h9(+	mael (n)	lust (n)	
I[^{wDk+<{	maeligeb	wealthy, rich (adj)	
u-@;l/]/FO	maelig	wealth, abundance (n)	
b0JI9B%Ct&	maelui	lustful (adj)	
p(X,}5?WH;	maenor	craftsman (n)	
G(SBJk.6&g	maen (n)	a treasure (n)	
lbXX|}z:W?	maeras	goodness (n)	
FhY~capdqk	maeron	artist (n)	
h4qLfqAJ+0	maer	(1) good, excellent, fair; [N.] useful, fit, good (of things); (2) useful, fit, good (of things) (adj)	
w4[^>O5=xC	maetha- (Physical Acts and Materials)	to handle, wield, use, manage, treat, deal with (vb)	
L$&@Yrjg^[	maethas	control, *authority (n)	
7^;.D{t-v	maetheb	having control or authority (adj)	
uAjZHNT7^I	maeth (Social Relations)	management (n)	
wU~FEDw|mc	maga-	to forge metal (vb)	
B-BPBqsC05	magor	swordsman (n)	
DOP-7a3Thc	main (adj)	prime, chief, pre-eminent (adj)	
H|X8.x&:?,	mair	precious (adj)	
Gzx1>H~<Ku	maith	goal, intention (n)	
"C#UGv{#1d7"	mallorn	(1) gold tree; (2) gold tree, yellow tree (n)	
jo3clnHMq.	mallos	golden flower (n)	
A|?WG$T-8`	mallú	when, (orig.) what time (adv)	
KBr]CDpaah	malthos	butter cup (n)	
McQ06DSsCT	malt	gold (as metal) (n)	
PY4e3<9mLY	malu	fallow, pale (adj)	
ceX5EF(uWb	mam	(1) grandmother; (2) grandmother, mother (n)	
}eV>2RU/P	manc	grip, grasp, hold (n)	
t,wQ`15[*c	mang	butter (n)	
v2qp&Fsq4i	man	*what, who (pron)	
QM]blk>P&N	masta-	(1) to [put to] feed, graze; (2) to feed, graze (vb)	
yUckQY?w&X	mast	(1) feed, food, nourishment; fodder; (2) fodder, feed (n)	
QsK=V4<~7=	mathad	handling, feeling, stroking, caressing; appraising, assay (n)	
JW)Gbk9sm4	maul (Food and Drink)	flour (n)	
NTgpU*^C&(	maus	pleasure; pleasant taste, pleasant (n adj)	
t1YoD*jq=.	mav-	to like (vb)	
tg`?hwioM3	mavor	appetite (n)	
Kqe6B*ujH^	(1) mavras; (2) mavros	desire, eager longing (n)	
Bi{_P.eiXg	(1) mavren; (2) mavrothwed	delectable, delightful, desireable (adj)	
"kr4fHSk#q8"	mavron	shepherd, herdsman (n)	
taJ0edpg0s	mawedh	glove (n)	
uLqXtQ0[=H	maw	soil, stain (n)	
ls6?;R{T<z	ma	good, excellent, that’s right (interj)	
yEexI!uIAz	(1) mechor; (2) naith	gore (n)	
B-&%.r:gO{	medhia-	to knead, soften (vb)	
B])OWkp]21	media-	to feed (vb)	
zbPCGJV)]`	medlin	*bear-like (adj)	
"dba#;h6F1*"	medlivorn	blackbear (n)	
Ap*LxOts63	medli	bear, (lit.) honey-eater (n)	
Ou$nW_=j7w	medui	end, final, last (adj)	
q.XNMyct3+	megil	(1) sword, longsword; (2) †sword (n)	
j%2gOaUKWi	megr	sharp-pointed (adj)	
tx!k|@}|0<	meiras	value, preciousness (n)	
FY.fkJ>|)j	meitha-	to aim at, *have as a goal (vb)	
MS&!XW/v3e	meithas	meaning (n)	
K)zSM:_*OP	(1) mel-; (2) mela-	to love (vb)	
BW|vz~1f4r	melethel	darling, sweetheart (n)	
y[J]%,S>L4	melillin	daffodil, (orig.) yellow song (n)	
Ez3>BR0jRg	melingarn	orange, tawny (adj)	
d9:Z[_R`NH	mellavan	pet, (lit.) love-animal (n)	
wMF>I9L&<!	mellon	friend (n)	
JUw`*E3jCr	mell	(1) dear; (2) dear, beloved (adj)	
n&k8:81;jQ	melui	lovely, sweet (adj)	
NITn$h)93/	men (n, Motion and Transportation)	road, way (n)	
G|jvoB`u1E	men (pron)	us (pron)	
k=<6ww.T|)	men-	to go (vb)	
"L.zCTn#Kt:"	meneg	thousand, *large in number (cardinal)	
"tyO:eIq#l;"	menel	(1) *the heavens; (2) the heavens, firmament, region of the stars (n)	
EI`e02c%,6	mengui	thousandth (ordinal)	
uO]rrB&Hbc	menna-	to send, (lit.) make go (vb)	
lY~;d-Yq/o	ment (Language and Music)	message (n)	
w;fjW^eFjO	mer-	to hope, wish, desire, want (vb)	
J$*u[SUoMp	meren	festive, gay, joyous (adj)	
p8SdY@{W[{	mereth	feast, [N.] festival (n)	
JL|;;S/.qM	merifind	Black-haired (adj)	
uPtOVaI)dR	meril	rose (n)	
N&7V5&=@3l	mertha-	to gladden, make happy (vb)	
w+;bi[.dsx	meru	valuable, worthy (adj)	
hG89Cd):a9	(1) meth; (2) methed (n)	end (n)	
LWe!A}+3_a	meth (adj)	last (adj)	
uvzY[E*[Q5	me	we (exclusive) (pron)	
qV-vc`{<j;	mib	(little) kiss, peck (n)	
CsYc{X)[H_	milbar	dear home, beloved dwelling [place] (n)	
"v#4rJbJV|c"	milf	greed (n)	
"n+HJd#($75"	milt	semen (n)	
K~AL=jJhiu	min (cardinal)	(1) one; (2) one, single (cardinal)	
y8iA=1Jnbg	min (n)	peak (n)	
PNGZa0J^&M	minai	distinct, unique, single (adj)	
t8jv{n$3zS	minas	tower, fort, city (with a citadel and central watch tower) (n)	
shJ_kcS6Z>	minib	eleven (cardinal)	
rYgN<5>^<Y	minlamad	?alliteration, (lit.) first-echoing (n)	
e~SVAu0Jag	minna-	(1) to enter; (2) to go in, enter (vb)	
Bo_JP4.RZG	minol	ingot (n)	
jT4NC1E[*d	minuial	(dawn) twilight (n)	
bQZA6Qar$p	mirian	Gondorian coin (n)	
QKh1!6Cxuc	mirith	jewelry (n)	
lDHpZZTG0%	mirtha-	to value, esteem, treasure, cherish (vb)	
i+b^<6tFA9	miruvor	a special wine or cordial (n)	
da./eJIAC/	mirwelthen	vintage, *(lit.) wine pressing (n)	
"n0RT=?Ddy#"	mirybin	grape, (lit.) wine-berry (n)	
cvq/^n)jFF	mithril	(1) *true-silver; (2) Moria-silver, true-silver (n)	
d=A~{m3V=B	mith	grey, light grey, pale grey (adj)	
"i.NJb|nX.#"	mivan	where, (lit.) in/at what (adv)	
j<7;O6)96E	mi	*in (prep)	
"mykBw.O<#k"	mol-	to grind, pulverize (vb)	
FkChI2Splg	molif	wrist, (lit.) hand-link (n)	
eg`?o%dTXB	molnel	molar (n)	
inyW;+}s~	molor	mill (n)	
sI/LGD]|9.	morchant	shadow cast by light, (lit.) dark shape (n)	
"w;?@bK@V#/"	morgul	(1) black arts, sorcery, necromancy; (2) sorcery (n)	
"Qdjw~[EL#["	mornechui	coffee (n)	
zvRq89n;A~	morn (adj n)	black, dark (adj n)	
IMaIXmls$K	mothren	dusk, dusky (adj)	
"y+y#Oi$G^2"	moth	dusk (n)	
C+`QHUeT$g	movan	how, (lit.) by means of what (adv)	
AR<?upIzm.	mo	by (agent of) (prep)	
NXx}<-/AKW	muia-	to whine, moan, whimper, caw, meow (vb)	
wIwDc;Cb$b	muig (adj)	soft, gentle (adj)	
F@tQM/w45t	(1) mui; (2) muig (n)	cat (n)	
"rAL*#$w)cr"	muil	drear[iness] (n adj)	
oBsjD6i;CG	muis	softness, tenderness, gentleness (n)	
h)r)-ol$ff	mund	bull (n)	
Nz<V$^eb_H	munneg	calf (n)	
u?am90^H1)	munnost	byre, cowhouse (n)	
bohB3%QWo2	mâd	meal (n)	
Fg7+QFibwQ	mâf	pile or mass of rock or earth (n)	
P),0~RpGK!	mâl	pollen, yellow powder (n)	
rO4i.]L~3d	mínem	movie, motion picture (n)	
H2pRekwn|V	mín	our (pron)	
cfPdEyzAz{	mírad	treasury, hoard (n)	
"KQdm##.Mnw"	mírdan	jewel smith (n)	
oED7ySK>eu	míria-	to sparkle like jewels (vb)	
K$tn]GiBN/	míriel	sparkling like jewels, like a jewel (adj)	
t^>5!JN:Ao	mîdh	(1) dew; (2) dew, *moisture, damp(ness) (n)	
qz@yJXJ_7r	mîg	among (prep)	
I^oL@a64^>	mîn (Motion and Transportation)	motion (n)	
OO9@75WyrQ	mîn (Spatial Relations)	[thing] between; gap, space, barrier; anything intervening between two other things (n)	
Qdg,$iY=/.	mîr	jewel, precious thing, treasure (n)	
KL?WI4co3K	mî	(to the) inside; into (adv prep)	
n)2B7*d5S+	môr (n)	dark(ness); †night (n)	
bTUPk[ua[V	mûg	dung (n)	
rAJ$&<M3KF	mûn	womb (n)	
"C#m[|w<^Ry"	na (Grammar)	(1) of; with, along with, accompanied by, provided with or by, associated with, marked with; [N.] by; (2) with, by; of (prep)	
enA:13hi<Q	na (Spatial Relations)	to, towards, at (prep)	
bcT!ec9e?	na(n)	of; provided with or by, associated with, marked with (prep)	
D[}2tJV|-A	na-	to be (vb)	
JA:!b]c9NR	nab-	to take, lay hold of (vb)	
IRXX=K/,(t	nabant	almost, (lit.) towards full (adv)	
eEaK_2z5Do	(1) nabas; (2) naboth	seizure (n)	
sT%|GC=~_f	(1) nabor; (2) naw	booty (n)	
"Du#q1=u`<s"	naden	until, up to, as far as (prep)	
AkiNB>@U%2	(1) nadh-; (2) nag-	to chew, gnaw (vb)	
L9tyohzx{;	nadha	fetter (n)	
jPtrum7~nB	nadren	real; possible (in sense possible to exist or think of) (adj)	
MD&R~~u^pf	naeag	goat (n)	
"L<6UtT#)8w"	naeda-	to oppress, cause great grief to (vb)	
g?=UE4o!08	naedh	wounding, wound (n)	
scn@x<1{@z	naed	true, real (adj)	
A>Fa>N.Ii!	naegos	anguish (n)	
c<DE[vj4*p	naegra-	to pain (vb)	
jeN/jE*Hk~	naena-	to lament, wail for, make moan for (vb)	
"xc6m#UCxVk"	naeras	sorrow, woe (n)	
z:Sdi~}EIL	naergon	woeful lament (n)	
lQ3!0`&%wg	naer	dreadful, horrible, unendurable; [N.] lamentable (adj)	
pHX-M]9=a@	naeth (Emotion)	woe; [N.] biting, gnashing of teeth (n)	
kr$:{YN.h7	nagnel	incisor (tooth) (n)	
iocyDdr5DD	naith	spearhead, gore, wedge, narrow prominitory; angle (n)	
BpJ}$f+:xu	nala	(yellow) lily (n)	
BY{*EyRWD4	nalla-	to cry (vb)	
j$B(NA8pUh	naman	how, (lit.) with what (adv)	
tu/$B5a+rR	nan(d)	vale, valley, [ᴱN.] dale; [N.] wide grassland (n)	
oHoh@KBR)2	nanc	bite (n)	
"QI#;o3=#/X"	nanu	truth (n)	
vvB,dM4i|`	nanwen	true (adj)	
EUyJ:A@:F1	(1) a; (2) na; (3) nan (prep)	of (prep)	
bN+P+Ay^$P	narch	bitter-biting (adj)	
t/SJyk*6%6	narn	(1) tale, [N.] saga; (2) tale, saga (n)	
n.~=COt|f-	narphen	character [in a story] (n)	
B=)<_E(:L3	narthan	beacon (n)	
n29*HayxU(	narth	list, (lit.) product of recitation (n)	
t-ILyz?f:K	narvaenas	firework (n)	
lDl_NdrkM%	nast	(1) being (abstract); being (creature); (2) being (used for both a creature and the state of existence) (n)	
iSn-:>K}Ka	natha-	to bring help to, save, rescue (vb)	
k+R`??l[JH	nathal	guest (n)	
lL2Mhg<`1C	nathla-	to welcome (vb)	
l3[27MZOZ4	nathol	affable, kindly, welcoming (adj)	
xS-S$bwB@2	nathren	welcome, acceptable, agreeable (adj)	
t]6ljiP8A`	naug	(1) dwarf; (2) dwarf; dwarf(ed), stunted (n)	
pH&xBSl{pD	navan	where, whither, to where, (lit.) at/to what (adv)	
J,c2b-x+R]	naw (interj)	yes (interj)	
bw^LPwj=iO	nederphaen	ninety (cardinal)	
zzf63*|sU%	neder	nine (cardinal)	
Jw9p(;&Zl@	nedhor	mid-day, noon (n)	
E[sB[aNt0J	(1) nedhu; (2) nef	bolster, cushion (n)	
beIYrWikf^	nedhwad	lunch, (lit.) middle-meal (n)	
pVc!OLG4>,	ned	*one more (n)	
"vwT15<(*x#"	nef	hither, on this (the speaker’s) side of; †beyond [loose translation]; *near (prep)	
wCUH[8:a^:	negen	sharp, angular (adj)	
v&:iZ6AHD)	neitha-	to wrong, deprive (vb)	
e3:8b]w[!{	neithan	one deprived, exile whose rights and goods have been confiscated (n)	
"EZ*66#*sZ}"	neldor	beech (n)	
mG45$:q=(3	nelio	buckwheat (n)	
l4amgp4Kyx	nellad	sound of bells, ringing (n)	
MQGLV!k5i?	nelluin	bluebell (n)	
eNj6s96[sY	nelphaen	thirty (cardinal)	
"j0ShlD#v?-"	nemmas	evidence (n)	
v(Tba1M}``	nem (adj)	seeming, evident, probably but not necessarily so (adj)	
m>Ii^WdHz}	nend	watery (adj)	
BFWwz{Y>Y+	nennibis	waterlily, (lit.) water snowflake (n)	
OO}/9Qcuc_	nen	(1) water; (2) water; lake, pool; (lesser) river, [ᴱN.] stream (n)	
O1Y,f,D{`F	nepheg	mid-point, (lit.) mid-spot (n)	
tMBwU[ZGl<	ness	(1) *headland; [G.] (water) meadow; long grass; (2) water meadow; long grass (n)	
vYT~Oq,<P_	nethan-	to inspire, kindle inside (vb)	
mONN[s]s$}	nethia-	to entertain, (orig.) to make welcome (vb)	
"hH#d578yPU"	(1) gwest; (2) gwîs; (3) nethias	entertainment (n)	
EJV.nIb6VV	nethig	sister, girl (diminutive) (n)	
QfI2FF+_6%	nethor	herd, flock (n)	
"f=_(K^#K{>"	neth	(little) girl (n)	
Cj.:A.D,Ot	nev-	to seem, appear (vb)	
kR%9^i&q$$	nevia-	to localize, bring close, translate (into your own language), translate (into another language when used with the dative case) (vb)	
B>&EZ|_`3c	nevra-	to face, go forward (vb)	
qKhhoO-c67	nevui	nearly (adj)	
J};>7uepf5	niben	petty, *small (adj)	
s:`Bk8z*pN	nibis	snowflake (n)	
e6Aj.5+f|i	nich	frost (n)	
u<FLTlO0Nl	nidh-	to will (vb)	
odjIKq{la5	nigol	mouse, (lit.) small one (n)	
q=$SUC%v+F	nigren	stealthy, (orig.) mouse-like (adj)	
rX%Yv|N^0g	nimmas	whiteness (n)	
E2$$^o4^K:	nimp	(1) pale, pallid, white; small and frail, [ᴱN.] wan, sickly; (2) pallid; (3) wan, pale, sickly (adj)	
MaJ~i>}e!I	nim	white (adj)	
wByjDXyyGl	(1) gledhrin; (2) nind	slender (adj)	
oxMk>FM-}f	ninglor	golden water-flower, *yellow iris (n)	
fOAeIf10BA	ninna-	(1) to weep; (2) to weep, *cry (tears) (vb)	
DC@DB}i~]P	(1) ilvrant; (2) ninniach	rainbow (n)	
P(a0l4GK<I	nin	me (pron)	
mCf``3SUP;	niphredil	white flower (similar to a snowdrop); *(lit.) pale point (n)	
cNlB;1d=nA	niphred	pallor; [N.] fear (n)	
s!t$Uh.bS6	nirnaeth	tears, [N.] lamentation (n)	
v$4<7@3VHc	nista-	to press, thrust, force (in a given direction) (vb)	
vnkq+c%5c;	niwrim	swarm (n)	
f)GCQ(>Hfe	ni (pron)	I (pron)	
i=0S,e|)@8	nobad	thumb and index finger as a pair, *(lit.) pickers (n)	
cYuep;[7X)	(1) govron; (2) gronoch; (3) noch	acorn (n)	
n7pn6Ah0C+	noden	prone, face down (adj)	
c/AWc,V|WS	nodui	some, few, several (adj)	
Cu(=5K4iF9	nogen	boy, lad, urchin; *(orig.) short (of persons) (n)	
xO>|Hk$[V1	nor-	(1) *to run; (2) to run (or leap) of animals or men; [G.] to roll [of vehicles]; (3) to run, roll (vb)	
nC/8{&b]45	norna-	to complain of (vb)	
sQ@kYC]x~;	nornad	complaint (n)	
"uy$ps%J#Zn"	northa-	(1) to make run, *ride; [G.] to send rolling [as a vehicle], speed; (2) to send rolling, speed (vb)	
bqUEe>%(W_	north	riding, race (of people running), charge or gallop (n)	
"L.ccuKt#mY"	norweg	often running (adj)	
ya+bB:[T<:	nos(s)	family, kindred, clan, house; race, tribe, people (n)	
GYzW[j:{yZ	nosta-	to smell (vb)	
Jd/MgDsp=D	nothlir	folk, family (n)	
O1GoXp&w[q	novaer	goodbye, farewell, (lit.) be well (interj)	
KNpXXv1=T2	nuicha-	to take notice, perceive; *(orig.) to smell [something] (vb)	
Qz8bFqslN<	nuitha-	to stunt, prevent from coming to completion, stop short, not allow to continue (vb)	
jp~;pGu-C=	nui	before (of time) (prep adv)	
N4CBx_`E]{	nunna-	to incline head, bend face down, *nod; to assent, *agree (vb)	
j1V7-FuL=U	nu	under (prep)	
Mwgx;fR~gy	nída-	to weep, cry (tears) (vb)	
KFy,_WqMI-	nídha-	to be determined to (vb)	
"ej9#FN|?M+"	nín	my (pron)	
B8.XB!HwEz	nírol	sad, sorrowing, *sorrowful (adj)	
sPSx@n1v}}	nítha- (Physical World)	to snow, hail (vb)	
kEwb?9]iT:	nítha- (Spatial Relations)	to reduce, make small (vb)	
gZZnSLql:_	níthannen	reduced, minor (vb)	
GgK742l!vU	níwost	hive (n)	
z,:Ioie4:w	nî-	was (vb)	
q{lRIw`se&	nîdh (Food and Drink)	(1) [N.] honeycomb; (2) honeycomb (n)	
yYX64+@KNy	nîdh (Mind and Thought)	full vigorous purpose, exertion of will (n)	
n=|2OEmqMW	nîn (adj)	wet, *watery (adj)	
NM}%E+0|2N	nîn (n)	(1) tear; (2) weeping (n)	
"wDhe7i#fFv"	nîw	bee (n)	
RaA9y^gGbW	nî	once, at one time; was (adv)	
kh^]YHQ-hl	nŷw	noose, snare (n)	
n?0962T7Hn	och	egg (n)	
ewi}mE.Lc^	(1) odlad; (2) oglad	week (n)	
dq7M[x`*OS	oer	nasty (adj)	
Eg)(%UH5o:	oetha-	to lay eggs, nest (vb)	
"IU[uZf<#r@"	oew	an evil deed (n)	
KbTBN85&R0	oglas	wickedness, *evil (n)	
!lB,jItI}	ogod	knee (n)	
"vaZ*Y:p_R#"	ogol	bad, evil, wrong; gloom(y) (adj)	
L@EOU/$aK/	ogron	wicked or evil person (n)	
vXh%<mB2>%	ol-	to pour (vb)	
B%LAnZK:qa	ola-	to become (vb)	
"im&#/t4r:L"	olf	jar, flagon, *pitcher (n)	
"f`#y52[z)g"	olla-	to ooze, *trickle (vb)	
pG8A7Nbz-C	olost	drowsy, dreamy, lazy (adj)	
njtKrO;eq%	olui	dreamy (adj)	
uE)A3J*f[5	oman	whence, from where, (lit.) from what (adv)	
qZl[$-VjA)	omlos	(1) (horse) chestnut tree; (2) chestnut tree, *chestnut (n)	
Hi<uJn`4@)	oneth	*giving (n)	
EP!BH>@RMI	onna-	(1) *to birth, give birth to; (2) ?to beget, make born (vb)	
siHRHy|Vh_	onnad	birth (n)	
Oq;S}FJ?qd	onnen	born (adj)	
EDhwNIAf%K	ont	no, none (adj adv)	
bAD_P^sF6N	or- (Time)	-day (pref)	
FwDzJX=9Xt	ora-	to heat up (vb)	
P{>9MQzao(	orchal	(1) superior, eminent, lofty; (2) tall; [N.] superior, eminent, lofty (adj)	
fkvp,>)3@a	orchen	dandelion, (lit.) day-eye (n)	
jmY]-~wqu8	orch	(1) Orc, [N.] goblin; (2) goblin; (3) orc, goblin (n)	
i8XFv;:oN<	(1) hunn; (2) ordh	boil, pus (n)	
pii[i(N*1j	orfing	(1) pear; (2) pear, *(lit.) hair-apple (n)	
yt9&(%yf?y	orf	apple (n)	
HLph)U+z3o	orna-	to burn (tr. and intr.) (vb)	
Dh4Q*D=R>-	orn	(tall straight) tree (n)	
po$qpuaid=	orodben	mountaineer, one living in the mountains (n)	
o)zZ>.7$&L	orod	mountain (n)	
qR@J;WG1Mn	(1) noss; (2) oronnad	birthday (n)	
jsMH<Z~_Rz	oroth (Emotion)	rage, anger (n)	
B0+mFcGLPe	ortha-	to raise (vb)	
tFHl5DVHkz	orthad	*raising (n)	
kgw7TW^YM{	orth	upper (adj)	
"G#6=!lqSbd"	orvel-	to favour, *(lit.) love above (vb)	
xC-q*YXdF:	osgaef	surroundings, environs, milieu (n)	
g_32AC46)o	osta-	to surround with walls, build up, fortify, protect; to surround (vb)	
KZ]-u$OR46	ostol-	to circumnavigate, come around (vb)	
w~Pg=vPR08	ostor	(1) enclosure, circuit of walls; (2) enclosure, circuit of walls, *town wall (n)	
zQj&SoPPWy	os	(1) *about; (2) *around (prep)	
J;S8mvgddY	oth-	[wrong] with a bad sense; unsuitable, bad, improper, useless, wrong (pref)	
qV?zc8}~Qa	othas	warfare (n)	
NqTAK^xRVL	othestannen	infamous, of evil name, (lit.) ill-named (adj)	
KlssNy1}-;	othgar(ed)	doing wrong, *wrong doing (n)	
k>A`-FZl*+	othgarn	misdeed, *sin (n)	
caVr(;KbF`	othidh	armistice (n)	
y15h.B;oBj	othlonn	paved way (n)	
n[C=cX+%5K	othovor	too much, (lit.) abundant in a bad way (adj)	
hV,fWS&e/A	othra-	to get away, escape (vb)	
cEgHy6TcUW	othrad	street (n)	
KwPM(<~;C<	othren	strange, weird, odd (adj)	
gWlBXSku[6	(1) hothrim; (2) othrim	army (n)	
u4:08K/[oG	othrol	warlike (n)	
xTIKk2.LKM	othrond	(1) underground city, fortress; (2) underground stronghold, [N.] underground city, fortress (n)	
c_P`QA)?od	(1) gothnir; (2) othwen	amazon (n)	
KErkkHeAD&	o	(1) *than; of; (2) about, concerning; (3) from, of (prep)	
irq3BkpTQM	pad-	to step, walk (vb)	
FzCaR[73UE	padra-	to walk (vb)	
H0[02,Ri0g	paetha-	to utter, speak, talk (vb)	
g8/JnvzA>M	paethad	oratory (n)	
fv<MiOEL@O	paethas	grammar, speech-system (n)	
E`4,k><w}S	paethron	orator (n)	
K=Bsq$n,e2	paeth	speech (n)	
b&XBm_aq`H	paich	juice, syrup, *sap (n)	
QZlDMg!l3E	palan-díriel	far-gazer (n)	
F/5C8A2R*a	palan-hinnen	famous, *(lit.) widely-known (adj)	
x2Z&p^]0b$	palan-tîriel	*far-gazer (n)	
w1G7cIS{%L	palan	afar, abroad, far and wide (adv)	
B)UFaPcW-A	palt	wide flat leaf; page of book (n)	
q1%Ndz)&8R	pan-	to arrange, order, settle; to set, put, place; to write a book (vb)	
nA[WIJ{G/y	pand	courtyard (n)	
G1*e5~SM{|	(1) pannen; (2) sam	arranged, settled, done (adj)	
BogUV3N`yk	pant (adj)	(1) full; (2) full; [G.] (with article) the whole, all the (adj)	
PXH/>aK-i^	pant (n, Possession and Trade)	money (n)	
H7QmIa`q|K	panu	arrangement, plan; structure, ordering; (musical) theme (n)	
y`&u:eR=bp	pan (Quantity and Number)	arrangement, settlement, *grouping (n)	
~luY)kqAl	paran	bare, naked; smooth, shaven (adj)	
oj6,J!~M>(	parchol	towel (n)	
"A.(w658#:|"	parlas	parchment, document (n)	
KitwZ^fxu~	paron	full-moon (n)	
Qs[I^@Ux,F	partha-	to arrange, compose (vb)	
g:i1S%Jwol	partham	library (n)	
n1QVzf(arJ	parth	field, enclosed grassland, sward (n)	
JfFsor[m*N	pasta-	to shake, wag, nod, flap (vb)	
Mk)Ul/z=vj	past	shaking (adj)	
eq+uYe5W_h	path-	to smooth (vb)	
oP@qzEPqGe	patha-	to reveal, show (vb)	
t=9x0=p7tO	pathu	level space, sward (n)	
Nf{.bjln4_	paur	fist, closed hand (n)	
"wnj/#_W@uS"	pavra-	to ail, be ill (vb)	
"c&.vM#g-s9"	pechol	hazel (n)	
uzQ+XE?P37	(1) cod; (2) pech	nut (n)	
v}P<.ZK8S{	ped-	(1) to say; (2) to say, speak; (3) to speak (vb)	
hta5QSQA;c	pedh-	to incline, slope (vb)	
vWut{X9eYO	pedui	*utterable, pronouncable, able to be spoken (adj)	
o?9!GV8@i=	pedweg	talkative, saying a lot (adj)	
Dy,>ZU`L$(	pel-	to fade, wane (vb)	
NG!qoi{I-j	pela(h)	along, (lit.) by the boundary of (prep)	
rwwg@XI}w0	peleth	waning, *fading (n)	
O{wLFIJe50	pell	still, quiet, hushed (adj)	
MBRV7-H+Ij	pemp	lip (n)	
z6F&S+02<E	pen (prep pref)	without, lacking, -less (prep pref)	
ms9(vr)2B`	pen (pron)	one, somebody, anybody (pron)	
h=tPpYefz^	pen-channas	stupid, idiotic, *(lit.) lack-wit (adj)	
Au}H>x,IBx	pen-ind	insane, heartless, crazy (adj)	
pVYf;z28g	pen-	to have not (vb)	
faIwYtc+J^	penbed	not pronouncable (adj)	
Or*8qaaJ<%	pend	slope, steep incline, hill side, [N.] declivity; [S.] sloping (down), steeply inclined (n adj)	
d6aU!i9GO4	penestel	hopelessness, despair, desperation; hopeless, despairing, desperate (n adj)	
h3Tan%X-96	pengas	archery (n)	
C0mCEZV>L+	pengolodh	teaching sage, doctor (of lore), *professor (n)	
n.A2oBKmO(	pengron	archer (n)	
PJmKqI4K{%	penna-	to come down (in a slant), fall (vb)	
CB!quC~+z5	pennig	coin (n)	
"jF:WMd#Xjr"	penninor	full year (last day of year), *new year’s eve (n)	
fa=kc}Qk=S	pennod	without count (adj)	
r>,jVJK+rc	(1) inathadren; (2) pennoediad	innumerable (adj)	
u?zvr};*Ao	per-	half (pref)	
LjayNtvO.W	perol	jar (n)	
"P7EF#Al}X1"	perthol	peninsula (n)	
oIO0Q4}@.t	pesgannas	syntax, study of syntactical structures, (lit.) shapes of phrases (n)	
Ae/gY@^g:i	pesgant	syntax, syntactical structure, (lit.) phrase-shape (n)	
tt5$Qg@X{K	pess (Body Parts and Functions)	feather (n)	
O6y<DFCW5?	pess (Language and Music)	(1) saying, [G.] proverb; (2) saying, to say, a saying, [sic.] saw (n)	
b;go@)YE}{	pesson	plume, (great) feather (n)	
s!!Sp`>4^W	pethgannas	morphology, (lit.) shapes of words (n)	
fG`QIyNwvA	pethgant	surface representation (of a word), (lit.) word-shape (n)	
kl1nt{TEh$	pethlongannas	morphophonology (n)	
gx;p(SJ`X[	pethron	(1) narrator, reciter, minstrel; (2) speaker, reciter, [N.] narrator, minstrel (n)	
"xM,&ZHWa#]"	peth	word (n)	
e5Wwr?jRkx	pibin	small berry, haw (n)	
G`A,t+(!y.	pil-	to steal, rob, thieve (vb)	
k8J?C5}DKB	pilimbes	arrow feathering (n)	
KN9V(R3=yR	pilin(d)	arrow, [G.] dart (n)	
QFQ_Z7!z~E	pilinoth	arrow of war, arrow sent as a summons to war (n)	
A=>?;EyJz@	pillor	bat (animal) (n)	
j5}8z,4jsZ	pilu	stealing, robbery, theft (n)	
"Ce#NoXt!2_"	pind	crest, ridge (n)	
D.@N_(M$bh	pir-	to stir, stir round, make spin (vb)	
k&&M2CN7ND	piren	spun, rounded, cylindrical (adj)	
"lf24~5|j#L"	pirin	flower that opened and shut quickly with any change of light (n)	
dMHT6ru/G6	piruin	spinning wheel (n)	
M~@//niotn	pi	if (adv)	
g7OvN`WFt	plada-	to feel with the hand, stroke (vb)	
kdr!w>@.~-	(1) plador; (2) plados	oar (n)	
nMRAvt5;g{	plad	palm, flat of the hand (n)	
i?$zp;n9qD	plant	flat, open, expansive; candid, blunt (of words) (adj)	
,A@py+0Cx	pog-	futuere, *to copulate, have sex (vb)	
n>aCM)Xhlz	(1) hygion; (2) pogron	fututor, *one who copulates (n)	
2NDhQb2:]	pol-	can, to be (physically) able to (vb)	
i]43lu0kQn	polch	trunk, torso (n)	
Ox%T(oi-8`	poll	ram (n)	
CS4sVrwM9i	polodhren	mighty, *powerful (politically) (adj)	
waZ}?v3$@t	(1) polod; (2) polodh	power, might, authority (n)	
Hqk>X,nfaf	poltha-	to (physically) enable (vb)	
Vh@>RzU?Q	porogog	the clucking and noise of fowls (n)	
sG5j2arV&$	porog	(1) fowl (domestic); (2) fowl (domestic), *chicken (n)	
zfg)BtQz!3	posta-	to stop, cease, leave off (vb)	
JJ:n]QZ^hb	postad	stopping, cessation, leaving off (n)	
hhx}2R%({/	potha-	to tremble, quiver (vb)	
xC?dv|w:]C	press	trouble, disturbance (n)	
PL[|riytjT	pruin	charcoal (n)	
JOm&l*!w[a	puch	cunnus, vagina (n)	
yn6R6p]**M	puida-	to clean, tidy, cleanse (vb)	
M3kI`7yx|0	puidad	(act of) cleaning, cleansing (n)	
jG0b5L>HI/	puidh	wash, cleaning (n)	
udaB&=dvA.	puitha-	*to have sex (with) (vb)	
oz}pN%X^<^	puith	coitus, *sex (n)	
"J<>^ndQ#UJ"	pâd	(1) ?way; (2) a step (action); track, road; ford; [N.] way (n)	
CTGv&|+[G`	pân (adj)	all, *complete, entire, full, the whole (adj)	
m*|2V`1i$>	pêl	(1) [N.] fenced field; (2) fenced field (n)	
wC8-uy4acJ	píeg	mosquito (n)	
I2s^uVy$yl	pítha-	to shoot (vb)	
O?=V{@*;9x	pîl	robber, thief (n)	
Lzo:{!ZPS(	pîn	little (adj)	
L*y{qFt]Ln	pîr	cream (n)	
Mu}fi5d{;M	pôg	bag (n)	
by{^9IvzGm	rach	danger (n)	
y)C*$IHW$I	radh-	to return (intransitive) (vb)	
i]R-$ncjO]	(1) raebroch; (2) ribrog	zebra (n)	
eoK/+Q1@:y	raeb	scored, striped (adj)	
Nf$OA!?0mC	raeda- (Emotion)	to smile (vb)	
Cd,U):QX/}	raeda- (Motion and Transportation)	to catch in a net (vb)	
s-`7R/{J)/	raeg	wrong, [G.] awry, twisted, distorted, perverse, leering (of face) (adj)	
"s&$}^#dM//"	raen (Emotion)	smiling, gracious, sweet-faced (adj)	
stFA;5]vk-	raen (Motion and Transportation)	netted, enlaced (adj)	
opRO{/,z=@	(1) raeth; (2) raith (Motion and Transportation)	extent, reach; region, sphere, district, scope (n)	
i5ez-D|nc%	raeth (Physical Acts and Materials)	breach, *burst (n)	
q3~/ZY+22a	raetha-	to reach at, reach for; to reach, extend (intr.) (vb)	
cIw550TK(A	raew	fathom (n)	
Ak;7k6qWQi	rae	smile (n)	
e^_nk+nzWJ	rag-	to break (asunder), burst (vb)	
Og9K5PwnL^	ragui	fragile, breakable (adj)	
cHIl)4@~wz	rain (adj)	free, *unconstrained (adj)	
rQc6p`NH4n	rain (n, Motion and Transportation)	erratic wandering (n)	
cx:B.*>a7l	rain (n, Social Relations)	border (n)	
q2oG{APoHH	rammas	great wall (n)	
xESoV|fd,W	ram	wall (n)	
kJ{fg`yV2P	ran-	to wander (vb)	
g<.sn}lb?K	ranc	arm (n)	
i=JZ:YYu9C	randir	wanderer, wandering man, pilgrim (n)	
"s>*pKazMt#"	randis	wanderer (f.) (n)	
AA~A!Mvzcp	rand	cycle (n)	
IMZzM!D4|b	ranoth	month (n)	
*d~$:.|&n	rant	(1) course, water-channel; lode, [N.] vein; (2) lode, vein (n)	
"#&WvOZvb^"	raph-	to snatch, seize, steal (vb)	
JP`U06jTaf	raph	rope, strap (n)	
Quq{3p[pjX	ras(t)	cape, shore (n)	
ehq8Zdb1YX	rasg	wain, *wagon, cart (n)	
nw0^2V%@r}	rass	horn [of both animals and mountains] (n)	
ez0<z0:=Z[	raud	noble, eminent; lofty, high, tall; excellent (adj)	
G23@j<RW8,	raudh	hollow, cavernous (adj)	
E*yv15^d2{	raun	errant (adj)	
xhzOq<Bd?o	ravaed	skillful (adj)	
M/3&lCmoh`	ravn	wing (horn), extended point at side (n)	
wtjK-&3;Ds	raw (Animals)	lion (n)	
nI11(zyqrp	raw (Body Parts and Functions)	wing (n)	
cn!lR[B/nL	raw (Physical World)	bank (especially of a river) (n)	
lr$5e|F~+L	red-	to climb (vb)	
kkP[SNg[@*	redh-	to sow (vb)	
wCh?XjBkt6	redhia-	*to return (transitive) (vb)	
jbatsulg|%	redhin	related (adj)	
d)*xDp2[NI	redhor	farmer (n)	
e7=;L5I[(I	(1) broch; (2) brois; (3) regil	mare (n)	
LIW,1SM]C[	rein	slot, spoor, track, footprint (n)	
i5VmNtEP?g	reitha- (Possession and Trade)	to rescue, save (from ruin, peril, loss) (vb)	
z$/f-?fN}>	reithron	rescuer, saviour (n)	
DC!,A]oRK=	rem (adj)	frequent, numerous (adj)	
pVmNP$(f%3	rem (n)	mesh, net (for catching) (n)	
Aty,CxClW{	remmen	entangled, meshed, netted, woven (adj)	
k.5J1lzP9<	ren-	to remember (vb)	
"A!Ya-,?m#V"	(1) crithiol; (2) rend	circular (adj)	
NCc?F2N}N)	rend	male cousin, relative (n)	
MIq|imika9	renia-	(1) to sail, fly; (2) to stray, wander (vb)	
r4^hd8^2bY	renna-	to remind (vb)	
iQ6A`3RK?;	rennas	kinship, relation (n)	
tp8.H*zJ~R	ress (adj)	cleft, cloven, separate (adj)	
zf.y!lN]3@	ress (n)	(1) cousin (f.), relative; (2) female cousin, relative (n)	
E?O<:=lWPQ	rest	[N.] cut (n)	
l)fWas.b0;	reth	*climber (n)	
K$B&r,aN^0	(1) bronwe; (2) reth	endurance (n)	
b$bWm>oyLG	reth-	to remain in same place (vb)	
cKc$:hO9Yq	rhach	curse (n)	
"x_pG|n!##~"	rhanc	awkward, hard (adj)	
QPMxkV<nk!	rhaw (adj)	(1) wild, [N.] untamed; (2) wild, untamed (adj)	
PTb>>(-P$x	rhaw (n)	flesh (n)	
KZsa-8+)(_	rhib-	to scratch (vb)	
q;i4^TX*X.	rhofelf	body-feeling, [physical] sensation (n)	
wCjNkX<8K)	rhond	body (n)	
z-@doI%dtj	rhovan	wilderness; wild beast (n)	
z@*Jvydy=j	rhu-	evil- (pref)	
b](Makc,?o	rhudol	unwelcome, coming with evil omen or intent (adj n)	
F2k:$U`!$s	rhufaug	drunken (adj)	
v9]sZKH)o2	rhugarol	wicked, doing evil (adj)	
LUE+lo~fNn	rhugar	evil deed, *sin (n)	
GEw|Su)XN9	(1) rhíw; (2) rhîw	winter (n)	
P{(l_KBwC$	rhúnen	eastern (adj)	
Kui/q)fJEf	rhû (n adj)	evil, wicked (n adj)	
"kOMc}IS#~9"	rhû (n)	matter (n)	
B:.FjGJHxJ	rhûn	(1) east, [N.] eastern; †rising; (2) east, eastern; †rising (n)	
kvx:@nz}k(	(1) rhimma-; (2) rib-	to flow like a (?torrent) (vb)	
xtjcfw=<gv	(1) ribin; (2) rimin	striped, edged (adj)	
Od7?S.3<o;	rib	(1) shore; stripe, line; border, fringe; (2) stripe, line (n)	
Mj+G.dvrm?	rig-	(1) to twist, contort; (2) to twist, contort; *to confuse, disarrange, upset (vb)	
sjl`f!4A.r	rim (n, Physical World)	cold pool or lake (in mountains) (n)	
HSLk?KGvs$	rim (n, Quantity and Number)	host, great number, people (of one kind or origin), [N.] crowd (n)	
GHz?/6)+[*	rimp	shred, slice, sliver (n)	
Jq~<aZI[5,	rin-	(1) to revolve; (2) to revolve, return, come back; to do again (vb)	
CH+_LuezR_	rinc	twitch, jerk, sudden move (n)	
tt=jU-}dAv	ring	(1) cold, chill, [G.] cool; (2) cool, cold (adj)	
q*%k)&u+.5	riss	cleft, [N.] ravine (n)	
k:4-@R!9`u	rista-	(1) to cut; to rend, rip; (2) to rend, rip (vb)	
H8h5^/ndpV	ritha-	(1) to jerk, twitch, snatch; (2) to try, strive (vb)	
z.1$D.2|h<	ro-	*superlative (pref)	
E^P~@Od_I9	rochir	knight, horse-lord (n)	
A`+@Mr/~hU	brog	horse (n)	
O9;-,/R)[1	rodel	lady, high lady (n)	
KwYEF][Y<i	rodol	little pipe (especially musical) (n)	
pA3[[yqbj8	rod	(1) tube, stem; (2) tube, stem, *pipe (n)	
nrZ[u)D(sO	rogol	saddle (n)	
"hI4c:B#Ss<"	romru	sound of horns (n)	
D}HTi;xI!{	rom	horn, trumpet (n)	
C+,Q7ZN!(0	rond	(vaulted or arched) roof; vaulted chamber or cavern; heavens [as a roof of the world] (n)	
kyv4P`(`mD	ronga-	to hasten (vb)	
ik~9t}(P`]	rong	soon (adv)	
yw48mzF65F	ross (adj)	red-haired, copper-coloured (adj)	
I6{RQot6QL	rostaur	rainforest (n)	
CJ;h8O8i3B	rost	rainy (adj)	
cB&D}S_e,i	rothron	polisher (n)	
F~R>~^Cbxw	(1) rov-; (2) ruf-	to tear (vb)	
x*sKUwsS-P	rovaed	[most] skillful (adj)	
uouJ_@gF+5	roval	winged; [N.] pinion, great wing (of an eagle) (adj n)	
eUm}TjJeEc	ruida-	to pursue, chase (vb)	
dY;}AG,g-R	ruin	red flame; fiery red (n adj)	
Lawkca]<RO	ruist	fireplace, hearth (n)	
Mb`>FKA5+$	rui	hunt, hunting, *chase (n)	
bJ}WGg.C<H	run-	to rub, grind (vb)	
cpWS(NH&5^	runna-	to polish, burnish (vb)	
B+nQuyk>6d	rustui	copper, *of copper, like copper (adj)	
eE)6*6h9y1	ruthra-	to rage (vb)	
Nl7(,)qlax	râd	(1) path, pass, [N.] track; (2) path, track (n)	
h/R:!ul;gQ	rían	queen, *(lit.) crowned-lady (n)	
C|)Oe~Bz=m	rídhas	the country, countryside, farmland (n)	
"eohjQ#OQe>"	rídhathren	rustic, rural (adj)	
jjv7z>H]Sz	rínada-	to crown, coronate (vb)	
xNynQ8iY%Z	rîdh	(1) sown field, [N.] acre; (2) ‘sown’, sown field, acre (n)	
"Ol[{D#U|t6"	(1) dâf; (2) gwath; (3) rîf	bark (n)	
I|;U_|mxi(	rîn (adj)	crowned (adj)	
iXo$BJDva6	rîn (n)	remembrance (n)	
o~<[PXns<F	rîth	effort, endeavour (n)	
Nb;MvP5rHM	rî (Clothing and Adornment)	wreath, garland; [N.] crown (n)	
q]}~197p&$	rôn (Body Parts and Functions)	liver (n)	
taj,Bm}&-R	rúthui	angry, wrathful (adj)	
C~fg+*hgz8	rûdh	bald (n)	
A.>o<uy.a9	rûn	polished, burnished, smoothed by polishing (adj)	
wmOD/g&}GD	rûth	wrath, anger (n)	
A4}2%.ZSt=	rû (Physical Acts and Materials)	loud sound, trumpet-sound (n)	
A/<`zBBM;|	rŷn	chaser, hound of chase (n)	
A&=BKtqXLS	sa (prep adv)	beside, alongside, next (to) (prep adv)	
>>Ak)Ex:/	sab-	to dig (vb)	
GTxIqXBgUy	sabar	delving (n)	
BMg[mz:E*?	sador	steadfast, trusty, loyal (adj)	
"oMUY]tDh`#"	sad	place, spot (n)	
l{+Iv_HfRc	saeb (adj)	hungry (adj)	
mVff0*Z6}M	saeb (n)	boot (n)	
h,^0R_}{f@	saeda-	to teach, *train, (lit.) make wise (vb)	
"p@2jp-g#Js"	saegon	famine, (great) hunger (n)	
"Q=jDe*#?p1"	saeg	hunger (n)	
"G#c>raE=(f"	(1) gûl [ng-]; (2) saelas (Mind and Thought)	wisdom (n)	
cIfX:pm8<A	saelor	advisor (n)	
hcrx5Um.+M	(1) goll [ng-]; (2) sael	wise (adj)	
J,sLu5@Ha;	saera-	to urinate (vb)	
Dy9oA6C<2L	saerlin	urine (n)	
"e#zK!8IbEi"	saetha-	to cause hunger (vb)	
MH/^z|:+-j	said	private, separate, not common, excluded (adj)	
"etwD#$6i,{"	sain	new (adj)	
LLuS0vb3;2	sai	those (pron)	
o%[k(deDQM	salcha-	to scythe or mow (vb)	
Bs(qPy244*	salch	green cut grass, ensilage (n)	
G2:$*j58$(	salph	broth (n)	
opr9|N_5_F	samp	spade, shovel (n)	
"p|:5.hr(#q"	sam	chamber, [G.] room (n)	
e0je[!ft4>	sant	garden, field, yard (n)	
"z3w</E#F3#"	sarch	grave (n)	
p{+15Es?uI	sardh	table (n)	
"qOP#l^s5(X"	sarneg	pebble (n)	
viNMniy7o	sarth	note, jot, scribbling (n)	
"dedMb#ujG0"	sath	part (n)	
r?33^=6}Dv	saur	bad (of food), putrid (adj)	
F*xIt<[k:u	sav- (Mind and Thought)	to believe in, accept as fact (vb)	
gu2SE~8yOK	sav- (Possession and Trade)	to have (vb)	
BIU/uep+~2	saw (Sense Perception)	filth, putrescence (n)	
FDU[cVkvw~	sedh-	to rest (vb)	
fvD.,ZI7x]	seidia-	to set aside, appropriate to a special purpose or owner (vb)	
e$5}rv0I_X	sein	usual (adj)	
"o>5j>J`W+#"	sell	(1) daughter; [N.] †girl, maid; (2) girl, maid (n)	
g3R7ig4=V!	senc	mineral-like, flinty; flint (adj n)	
L~^}004P7=	send	?rest (n)	
sgUVk>0`H-	sennas	guesthouse (n)	
ES+[Xe||G@	sennui	?rather, instead (adv)	
gMHjWzSNh{	seregon	stonecrop, plant with red flowers, (lit.) blood of stone (n)	
bwUkK0FMF3	serni	shingle, pebble bank (n)	
q|q7z-XOHY	sesta-	to set, (lit.) to make rest (on) (vb)	
FW{PN21^,[	sibra-	(1) to weep, whimper; (2) to whimper (vb)	
g5A{//@,Fe	(1) niel; (2) siel	granddaughter (n)	
n7_&I]sRHJ	sigil (Clothing and Adornment)	necklace (n)	
u!Lwn_]gS$	silef (n adj)	(white) crystal (n adj)	
tg$~5j~47n	silevren	like silef (crystal) (adj)	
"y}0]_gL?,#"	silivren	(white) glittering, crystalline (adj)	
"PD#XlK3wkN"	sinc (Physical World)	*mineral (n)	
o}&5`Bi,;s	singil	mirror (n)	
PU}M[XktY;	singren	salt, *salty (adj)	
jpcw_f&HU.	sing	salt (n)	
"jt#Bo>B6;H"	sinnen	known (adj)	
A;DJ:2Zg6r	sin	these (pron)	
nRJEdtI>=_	sion	grandson (n)	
I^>`LiG;X{	siriol	flowing, fluent, liquid, melliflous (adj)	
EnV]/I8GdY	sirith	flowing (n)	
"iC:,Mk#0L{"	sith	affair, matter (n)	
JXM4yUqd9Y	soethor	drinking-horn (n)	
"p0Ew&y;9#7"	solph	soup (n)	
k~}r0}uen	somma-	to dive, duck (vb)	
nVaJIss8y|	sommor	duck, waterfowl (n)	
C/=(77hblR	sov-	to wash clean, bathe (vb)	
NTo.&;Kbcg	suilad	greeting (n)	
F5tNtmuQ6d	suilanna-	to greet, *give greeting (vb)	
Iypp<%zmP0	suith	(1) draught, [G.] a drink; (2) drink, draught (n)	
vL_l~0uYCC	sui	*as (prep)	
"r0#%U*[l&t"	sunt	nostrils (n)	
lB>$d>5c)0	sâdh	sward, turf (n)	
"xeH/#<mTA]"	sídheb	peaceful, full of peace (adj)	
vW:m/f_2]E	síla-	*to shine (vb)	
g+?mzm8unZ	sír	*today, this day (n)	
CL_P,h?[Y(	sí	here, in this place (of speaker) (adv)	
kTl?RWZ7&`	sîr	stream (n)	
e{;s[gDno[	sî (adv)	yet, hither(to), hereto (adv)	
z0L/R8oJw6	súda-	to blow (of wind) (vb)	
cO/m9;-!9g	sûl (Physical World)	[strong] wind, *gust (n)	
gxI}i~>t6s	sûn	bath (n)	
INa}SX|-8g	sû	noise of wind (n)	
f[FgxOAwxI	tab-	to stop, block, close (vb)	
O]ASxO<dQL	tachol	(1) brooch, clasp, [N.] pin; (2) brooch, clasp, pin (n)	
cX,<5gOEoK	tad-dal	two-legged, *biped (adj)	
r@_)DNWN3(	(1) pibinaith(ros); (2) pinaithros; (3) tadhos	hawthorn (n)	
wtV(lr~X&*	taeg	boundary, limit, boundary line (n)	
np{8UGuW0X	taer	(1) lofty, *high; (2) straight (adj)	
K:(,XO,x4O	tag-	(1) to fix, make firm, *fasten; (2) to fix, make firm, construct (vb)	
v!]HRDXZSH	tagol	post, mark (n)	
"K#={z{:XR_"	(1) taglos; (2) tagron; (3) ŷr	smith (n)	
zZDg?.Fcm.	taid	supporting, second in command (adj)	
bb^Gw6L.]]	taig	marking (a boundary) (adj)	
"NPQB#eW<O1"	tain	letter, epistle, missive (n)	
Oz^_{t=zU;	tair (adj)	vertical, (lit.) standing (adj)	
x[H|~[m=l/	taith	(1) a letter, mark, sign; (2) sign, symbol; mark, [N.] stroke (n)	
"mns##ySx*/"	talagan	harper (n)	
lsBa*{8ega	talan	(1) flet; (2) platform, flat space, flet [Middle English = ‘floor’] (n)	
EP,.=)BnPz	talath	flat lands, plain, vale (n)	
pz9g{`e{,j	talf	wang, flat field, topographical flat area (n)	
urAMgv:y<S	tallam	conlang (n)	
QzmK6oq/]]	tallen	playful, fun(ny) (adj)	
p2=4o*4xWE	tallif	ankle (n)	
E>blW[.O=;	talphressui	mischievous (adj)	
oW(vB(^}wt	talphres	mischief, (lit.) play(ful)-trouble/disturbance (n)	
h%z/[rqZwb	talraph	stirrup (n)	
F8}{WkMCD*	taltha-	to slip (down), collapse, fall in ruin (vb)	
Cuc@Xlnm`R	talvad	footpath (n)	
KP5mTeN::a	tammos	cauldron (n)	
r{qWG{Zj]g	tana-	to show, indicate, point out (vb)	
wBLyNm&}!H	taphaen	twenty (cardinal)	
F`daJXrhjv	tar-	to stand (vb)	
tZ2sE4lj;,	tarchas	roughness, ruggedness, rudeness (n)	
tU7P2P-W_U	tarch	stiff, rough (or tough) (adj)	
eZu]p]>-(5	tarlang	proud, [N.] obstinate, [S.] (lit.) stiff-necked; stiff neck (a nickname applied to men of haughty carriage or mood) (adj n)	
tW[nPJw$qk	tarph	dry [esp. of foods], [G.] stale (adj)	
onBy)DKdgQ	tasta-	to (put to the) test, *verify (vb)	
z>iTT}7wrQ	tastaith	test (n)	
I=r>`>;~s[	tast (Spatial Relations)	border, fringe (n)	
w}k/]TSQ)l	tathar	willow (tree) (n)	
j|(7JEKYr4	tathren	of willow(s) (adj)	
vKmh_!|Nxs	taugla-	to resist (vb)	
M@,BtL)kv`	taug	firm, strong, (?withstand) (adj)	
LT_~HX]nbo	tauron	forester (n)	
b[>0aEEHT<	tavnen	made (by craft of hand), wrought, fashioned (adj)	
jsGPx7ry$.	tavn	thing made by handicraft (n)	
Bpi+Pz*%VT	taw (adv)	thither (adv)	
B,Gv[fco2U	taw (n)	wood as material (n)	
f3:rW_5Z^D	tawen	wood (of material), wooden (of make) (adj)	
mDVeB2$.sC	techu	chip (n)	
jRdo@BFB]F	tegil	pen (n)	
x?m]U|%yyL	tehar	brick (n)	
Q+[F/__sc)	teitha-	(1) to write, draw; (2) to write, draw, inscribe, make marks or signs (vb)	
jE?BenTJ:0	tel-	to end, finish, be done (vb)	
tV^TZy:iKv	teleg	leg (n)	
oGY>ptnZu6	teleir	*Telerin (adj)	
iUaQS7exH(	telf	conclusion, ending, anything used to finish off a work or affair (n)	
wzq}W:~E*h	tellyn	sole of foot (n)	
"uhtn5.+gD#"	tell	last, final (in a series) (adj)	
bRvO.Q!([-	telt	lid (n)	
B)nH1MXzWH	telum (Agriculture and Vegetation)	mushroom (n)	
nD[ZG(c`ux	tengolu	semantics (n)	
yE-(@}+FrF	tent	toe (n)	
f|5k<34T[X	ten	*it, passive voice marker (pron)	
BAm1b(f1||	tertha-	(1) to destroy, *ruin, †(orig.) to make pierced; (2) to devour, destroy (vb)	
u&>GPX+J+_	terthaith	waste, ruin, destruction (n)	
A<Vkjxp^CK	tev-	to detest, hate (vb)	
xJ4&YR<7]v	(1) glam(m) [ng-]; (2) tevas	hatred (n)	
"zK#<7gUPe]"	tevren	hateful (adj)	
h9-7W7[FLt	tewig	morpheme (n)	
y6H{Y43XzX	thaes	attraction, temptation (n)	
mo,|.NNSEc	thaetha-	to split (vb)	
vR|b~cwq]E	thag-	to draw, pull (vb)	
KTG&k*-:$;	thagel	pulling, luring (adj)	
Cf:U}UwcKV	thain (Law and Judgment)	law-abiding, regular, normal, *lawful, formal, according to custom (adj)	
FJKJH$ow{x	thalas	valour, courage (n)	
bWwbk!);)M	thalieth	heroine, dauntless woman (n)	
AM@:lB1UbE	thalion (adj n)	strong, dauntless; [N.] hero, dauntless man (adj n)	
cZWo6KD<{M	thall	steep, falling steeply (of river) (adj)	
GxX9.qFpZb	(1) thalos; (2) thórod	torrent (n)	
CIPOWiF^s-	thalph	grease (n)	
z^DngTxCUL	thanc	(1) cleft, divided, split, cloven, forked, bifurcated; cleft, break, breach; (2) cleft, split; (3) forked, [N.] cleft, split, [ᴱN.] divided, cloven, bifurcated; [ᴱN.] cleft, break, breach (adj n)	
cQ7{%[UV5s	thand (adj)	firm, true, abiding (adj)	
"Os#|>uqO<g"	thand (n)	shield (n)	
lD3F>aSwIt	thangail	shield-fence, shield-wall (n)	
d~eh1gV4lq	thar-	to saw (up) (vb)	
"ERQ;U+k#d_"	tharan	vigorous (adj)	
eQELISM2Uf	tharchol-	to translate, (lit.) carry-across (vb)	
B~DSYC?Dw/	(1) tharf; (2) thram	saw (n)	
"p#JwI8cs9$"	thar	(1) across, athwart, over; (2) across, beyond (prep pref)	
"Hm67e#ZJi#"	thas-	to shave (vb)	
h3XhBHLx{o	thasgim	(1) *razor, (lit.) shave-blade; (2) razor, (lit.) shave-blade (n)	
syo`dS)hfN	thasg	shaven (adj)	
s3$U3ry.PM	thast	shaving(s) (n)	
n*I&}3!@dK	thaur	abominable, horrible (adj)	
lodDuC5yCs	thavn	post, wooden pillar (n)	
xf.;D[t!QM	theinweg	lawman, lawyer (n)	
BU|C$AfL9U	thel-	to intend, mean, purpose, resolve, will (vb)	
L%^IudmA<5	thennas	shortness (n)	
l2(cIO4vB?	ther-	to sew (vb)	
INx+>)?Sif	theres	(1) ribbon; (2) tie, ribbon (n)	
rB7RS5*)qg	theria-	to be vigorous, flourish (vb)	
A@7PS;)Io,	theriol	flourishing (adj)	
N@?j`-E|]x	thibinor	piper (n)	
g^95n?iKEI	thibin	flute (n)	
M|vSE(p}pV	thimma-	to play a flute or whistle (vb)	
Pn*>Ar`d!)	thimp	the stop on a flute (n)	
IZ.WS0R~:n	thim	milk (after separation) (n)	
J(ASY(U};~	thind	grey, [N.] pale (adj)	
x)SP8@D!v:	thirph	straw (n)	
x/OM1oc)$G	thisin	(1) parched, withered; (2) parched, withered, *desiccated (adj)	
qx|H<5.Js1	thista-	(1) to dry up; (2) to dry up (tr.) (vb)	
mo^8~_aRr~	(1) thinta-; (2) thiv-	to skim (vb)	
ob]b5D{L1H	thivol	whistle, piccolo (n)	
voBihQ105y	tho-	*will be (vb)	
w*qE9c7KG1	thond	root, [N.] base (n)	
Ba5q7ZJP*O	thoniel	kindler (in the past) (adj)	
CXC@qsZ!w!	thorn (adj)	steadfast (adj)	
P@1M*0dliD	thornang	steel, (lit.) hard-iron (n)	
owS[@X%[V;	thorombar	eagle’s nest, eyrie (n)	
D6eH0zaHK;	thossui	fearful, afraid (adj)	
iw*i9C@*q@	(1) pant; (2) thoss (n, Emotion)	fear (n)	
cv?Q^w[0Wg	(1) golbh; (2) goluidh; (3) golw; (4) thostol	stinking (adj)	
M+8$HhWF1$	thos	puff (of air) (n)	
F[H(Jk;VnA	thriben	lean (adj)	
J|F}m@o.Td	thrimp	stalk (n)	
F9E``MBi[^	(1) thuif; (2) thuis	resinous juice; any adhesive substance (n)	
"q|+9S#-?Z+"	thurin	secret, hidden (adj)	
CZ(gt^AphS	(1) thaf; (2) thâf	hay (n)	
Q@7*rA-*V<	thôl	helmet, helm (n)	
EGV7]E4O&y	(1) aigos; (2) thôn	pine-tree (n)	
yi4ad.MZU`	thúna-	to be spiritually affected, inspired (vb)	
s+Ip;zyJ/F	thúnas	inspiration (n)	
k!hlC}Uq-a	thû (Emotion)	movement of spirit (n)	
"ArT^5#.j6-"	thû (Sense Perception)	[N.] stench; [S.] black mist, horrible darkness (n)	
B{v1^5vC=@	thûg	resin (n)	
Cmfbq$_EjC	till (Spatial Relations)	point, spike, (sharp) horn, tine, ending (n)	
i9&KF6V;H~	timp	hoot, note of a flute (n)	
j[]BVH8%+?	tin (pron)	them (pron)	
N~mnaaUl$4	tingen	metallic (adj)	
PiiAT|=A7	tiniath	group of stars, star-cluster, constellation (n)	
GKAI<ypGAe	tinnu	(1) (starry) twilight, dusk, early night (without moon); (2) [N.] (starry) twilight, dusk, early night (without moon) (n)	
NAW4R?LC4}	tinthiltha-	to twinkle, *sparkle (vb)	
"O0?#X^!OM."	tinthilthad	sparkling, twinkling, scintillation (n)	
wA&IlQPB-B	(1) tif-; (2) tiph-	to whistle (vb)	
FWatolDe+I	(1) tifin; (2) tiphin	small flute (n)	
G75<)C^I8M	tir-	(1) to look (out) for, watch for, await, expect; (2) to look (towards), watch (over), guard; (3) to watch (vb)	
p5(T1KSlOI	tiria-	(1) to watch; (2) to watch, gaze; to ward, guard (vb)	
oQd3AX^-Y9	tirith	(1) watch, guard; (2) watching, guarding, watch, ward, guard (n)	
fSkCeYjLD~	tirnen	guarded (adj)	
d}]V6Bw:xz	tisga-	to tickle (vb)	
G3=zJZ,}=A	tisg	ticklish (adj)	
(N;!H|M,E	tith	(1) breast [of a woman], teat; (2) breast, teat (n)	
G:+9{sVw_U	ti	*they (pron)	
H!Pas&:C&9	tobla-	to hide (vb)	
"Az#w)FxrMF"	toch	cud (n)	
l*m5HVD_L+	tol(l)	island, (high steep-sided) isle (n)	
F5Xjq.Q9bz	tol-	to come (vb)	
bNKu?,W,1I	tolcha-	to support, *steady, comfort (vb)	
e}i$@x*faz	(1) lendri; (2) toled	coming, arrival (n)	
Gm?BWM.IoS	tolf	mast (n)	
Ax_-.i=Ku$	tolophaen	eighty (cardinal)	
AgN9D}n$Ia	tolpheg	spoon (n)	
lkh_ym0Nf2	tolph	bowl, basin (n)	
n%9s<x*Q!V	tomp	humped, bulging (adj)	
NK*COmt>_c	tond (adj)	tall (adj)	
lG-%q)eW+:	tor-	to win, have victory (vb)	
CH`VKv,8Fb	torchal	shark or other large predatory fish (n)	
yS>i(DGN_|	torech	lair, (secret) hole, excavation (n)	
bS_99)u~)g	torn	burial mound (n)	
jb9dYQVdX.	tor	the Dead (n)	
t4s0t_u]8I	tosta-	to cough (vb)	
nT&^~k-U:*	tovn	lowlying, deep, low (adj)	
s:K,fx|Hjq	trannail	regional, local (n)	
eubU:wD3Na	trann	shire, *county, adminitrative region (n)	
dQ;|1FZfQ_	trastadweg	annoying (adj)	
h^cU/tQW5p	trog	easy to handle; convenient, tractable, docile (adj)	
d}evvP%7N`	trunc	great stake (n)	
kXR(4dBJ7o	tudheg	match (n)	
rA-%gT]tIf	tudh	tinder (n)	
g/zf)27!d.	tuig	(1) shoot, sapling; (2) shoot, sapling, sprout (n)	
x)3!4/7|GR	tuilas	petal, (lit.) bud-leaf (n)	
P1&L;!~zWI	tump (Dwelling and Furniture)	shed (n)	
bg).e7Mv~H	tum	(1) (deep) valley; (2) (deep) valley, vale (n)	
KgAL=tR)JF	tunc	(1) chance, occurrence; (2) chance; occurrence; arrival; hit at shooting; luck (n)	
JH;@rmagM[	tund	(1) log for the fire; (2) log for the fire, *firewood, fuel; (3) mound, hill (n)	
i*I[GfxHrc	tâd	two (cardinal)	
hWj1}^/0IN	tâl	(1) foot; (lower) end; (2) foot; [lower] end (n)	
"kd{ufU#*)f"	tân	(1) builder, smith; (2) builder, smith, wright, artificer (n)	
AkXDj)?3+n	(1) tew; (2) têw; (3) tîw	letter (n)	
hdguujq0$M	(1) gwinta-; (2) tíra-	to see (vb)	
FZQeh|qF6j	tírad(a)-	to correct, straighten, rectify (n)	
wSI-GL36EY	tírad	vision, seeing (n)	
iR0Lla),Nh	tîf	resentment, ill feeling, bitterness (n)	
Mcx1^x<WV3	tîl	(1) cicatrice, scab, healing of a wound; (2) scab, cicatrice, healing of a wound (n)	
lSlQnL>7Ko	tîn (adj)	silent, quiet (adj)	
neb$L-;,o%	(1) ontha; (2) tîn	his (pron)	
nso7B??~q]	(1) tódhi; (2) tôdhi	paddock (n)	
ilkYUxnDKW	tô	(1) fleece, wool; (2) wool; (3) wool, fleece (n)	
"yQiQiqhV#."	túgomui	corpulent, (lit.) having a fat belly (adj)	
bp4$`biSw:	túgom	fat-bellied (adj)	
O/zq42sn$T	túliel	come, arrived (adj)	
JhOoZ4?c*9	tûr (Social Relations)	[N.] mastery, victory, [ᴱN.] power [over others] (n)	
EZ>:Svt2:a	tŷg	thigh (n)	
n.sSn`XuW.	ui-	twi- (pref)	
O/IoZ4&IxY	uial	(1) twilight; (2) twilight, evendim (n)	
"J$KMO#WVhh"	uil-	to rain (vb)	
Ji~;qq+Ib0	uilos	white flower like a star (n)	
hZKFczSfO	uir (adj)	*fiery (adj)	
C2A]TUH[>{	uitha-	to smoke (trans.) (vb)	
DP0Q5}KP^6	ui (adv)	ever (adv)	
uu&Ht1x`kz	ulunn	monster, deformed and hideous creature (n)	
m^2?f/VmTC	(1) unath; (2) unt	nothing (n)	
q]4%[4Yx]!	urnui	inflammable; touchy, irritable (adj)	
H-Olo?d=0g	urug	bogey (n)	
d,z$DaNp~z	uru	brazier, grate (n)	
kay(G3e?<i	uthwen	escape, way out, exit (n)	
Pn`O?sbXlB	uwedhen	outlaw, outcast (adj)	
me,H<33FgA	uwedhron	outlaw, outcast (n)	
ZWgB>V;Cz	vi	in (prep)	
lE7AnBi9ZR	ylf	drinking-vessel, *cup (n)	
"t35V#&uR4J"	ylin	liquid (adj n)	
w_)+vEo`{J	ylvon	chalice (n)	
P@+McFAYHh	Úrui	August, *Hot-one (n)	
"d/lh#gvaY?"	ínias	annals (n)	
K:1yIx8&Le	íphathred	yearfullness, age of person (n)	
dcx=k0LN}y	írui	desirable, lovely (adj)	
B[V.o+dBn:	î(r)	impersonal plural pronoun (pron)	
NfqkPcwz@I	îdh	rest, repose, peace, tranquility (n)	
cDxdEs6[NG	îf	cliff, sheer descent (n)	
"r#Zes~-@B~"	în (n)	year (n)	
Mb[&$~g+xn	în (pron)	his, *reflexive possessive = his own (pron)	
Hh6RMrF=pr	î	indeed (interj)	
wRhhyR`Riu	ôf	hood (n)	
pyBpis+1M_	ú-	(1) no, not, negative; impossible; (2) un, bad- (pref)	
K}Anx_T$y[	úbedui	not fit to say, unspeakable (adj)	
g4k{A~iDFO	úben	nobody, no one (n)	
Kh5Q9`LaK~	úgan(n)	gutless, faint-hearted, diffident (adj)	
v$B-Yr{6pw	úgarol	idling, not now doing or making (adj)	
iWc501T|~7	úgarth	trespass, *(lit.) misdeed (n)	
rIbN0|:@Nu	úgethiol	boring, (lit.) not interesting (adj)	
B?V3?9B64h	úlam	dumb, unable to speak, (lit.) untongued (adj)	
sF[K_AKfyC	úlren	odorous (adj)	
x]j:X$8yZ$	únodui	countless (adj)	
hMVH=YM*Ky	úthaes	inducement to do wrong, *temptation (n)	
q)>i=sDE_@	úthúlui	breathless (adj)	
GXi`1J7vvx	úvae	vowel; vocalic (n adj)	
u~!,BTsc<^	úvelui	not amiable, unloveable (adj)	
LmW`<kbuc^	û (adv interj)	no, not, [G.] nor (adv interj)	
n0Q41@j{e5	ýda-	to hint; *to wink (vb)	
;8:L<X+Oy	ýneg	twelve (cardinal)	
te2m9k$oz0	ŷl	lamb (n)	
izBzS~-peB	(1) delch; (2) delch [nd-]	dense (adj)	
p:hW!b14,?	dom	blind (adj)	
hK@A8:-OOm	gwaeren	windy (adj)	
"c.s#*gn~3u"	dadhren [nd-]	opposing, facing, opposite (adj)	
QmA7}78vR;	(1) buir; (2) ûr	fire (n)	
mX^w:1J;_P	hû	(1) dog; (2) hound, [N.] dog (n)	
rD4@rKj$}m	lind	song, chant, singing (n)	
qdV/<2[Inz	ross (n)	rain; spray (n)	
NH727oV;Jd	(1) -(r)il; (2) -dis	feminine agent (suf)	
o|j6NeDaa3	(1) -drin; (2) -grin	suffix in the name of languages (suf)	
M.2x/4:6/g	(1) -i; (2) -r	dative suffix (suf)	
"c[7#^djym/"	(1) -iant(ha); (2) -iont(ha)	*superlative (suf)	
Go.bP=}J]F	(1) -li; (2) -st; (3) -thi; (4) -wen; (5) -weth; (6) -wi	noun suffix (suf)	
pxFBiF*|v(	(1) -ra; (2) -sta	verb suffix (suf)	
MLzuL,&<MZ	(1) -tt; (2) -ui; (3) -wi	dual (suf)	
E&DHRm8B_c	(1) -wein; (2) -wig	*female suffix (suf)	
C1V]j-=Zt%	(1) Cwedhrin; (2) Cweneglin	*Elvish (Qenya) (n)	
wK<Sz9vaYm	(1) Dantilais; (2) lasbelin	autumn (n)	
wXx|e<@2T(	(1) Egol; (2) Idhel; (3) Ileth; (4) Uidhol; (5) Uigol	elf (n)	
mW.da0[,hb	(1) Gold [ng-]; (2) Goltha [ng-]; (3) Gul [ng-]	Gnome (n)	
u]FA~Acy)9	(1) Gwalion; (2) Gwalon	male god (n)	
lm]G55H03a	(1) Gwalir; (2) Gwalthir	female god (n)	
v_%eiGvIGz	(1) a(n); (2) na	of (the) (prep)	
H:YTQNiKw~	(1) ada; (2) adi	daddy (n)	
kH^L2LOzk@	(1) adhin; (2) dîn (adv)	once (up a time), long ago, formerly (adv)	
tGJM~5GFom	(1) adrum; (2) dam [nd-]; (3) dring	hammer (n)	
lJKUm>v~bz	(1) aidlan; (2) aina; (3) ainan	today (n)	
s/tS`uu:%7	(1) aina; (2) ineg; (3) lhigin; (4) ligen (adj)	small (adj)	
HQk-*y]WjL	(1) aithi; (2) aithwen; (3) maethon; (4) megil; (5) segeth	sword (n)	
F:rOK8iLHh	(1) aithl; (2) ethuil; (3) tuil	spring (n)	
g9(DkF`LV,	(1) am(m)arth; (2) umrod	fate (n)	
dfYz3k}:ki	(1) ambend; (2) ambenn	uphill (adv)	
"E)Tn#|<nl;"	(1) amlug; (2) cunn; (3) lhûg	dragon (n)	
qeUP1W~PQA	(1) amrost; (2) aurost; (3) galad	dawn (n)	
bgIwh8O_eu	(1) angol; (2) golu; (3) ongol; (4) thû	stench (n)	
MZ7w5fIphr	(1) arn; (2) ionn	son (n)	
P[eiz?po&,	(1) ascar; (2) asgar	violent, rushing, impetuous (adj)	
tvrF}mjB4t	(1) athwi; (2) uith	both (adj)	
cU+_^BA-S1	(1) badhor [mb-]; (2) badhron [mb-]; (3) pridwir	judge (n)	
"JGlI`l#0zC"	(1) baith; (2) hamp	garment (n)	
sT+wbjt2b$	(1) balch [mb-]; (2) faig	cruel (adj)	
nwB+xYwWhp	(1) band; (2) band [mb-] (Religion and Beliefs)	hell (n)	
HUZ,1DWl[Z	(1) barant [mb-]; (2) barod [mb-]	homewards, home (adv)	
xZV^XW>=5J	(1) bon-; (2) gon-	son of (pref)	
d^zS_!n]Mu	(1) branc; (2) branta; (3) peng	bow (for shooting) (n)	
yD.!KoA~OK	(1) brand; (2) tham (n)	hall (n)	
OCw^eiJ[5o	(1) brannon; (2) hîr	lord (n)	
iZq&IlLTu^	(1) cennan; (2) cevnor	potter (n)	
KFRI]rFq*N	(1) ciloba-; (2) ciloptha-	to twitter, chirp, chirrup (vb)	
hpP8IdWw/W	(1) codiavol; (2) codiof; (3) codwed	nutbearing (adj)	
dgOKzm1}AK	(1) codorn; (2) codron	*nut tree (n)	
bVn>p&c*DP	(1) corch; (2) crunc	crow (n)	
y%3<}Hc9[B	(1) craitho-; (2) puia-	to spit (vb)	
w2Nz5cHh-E	(1) cucthol; (2) cunghol	painstaking (adj)	
"jfnD&-3I;#"	(1) cunnas; (2) gonnas	dragon’s lair (n)	
C=4H]a1S@u	(1) curin; (2) thairiniol; (3) thairinwed	magical (adj)	
eo:ozk]rBS	(1) curu; (2) curw; (3) gûl [ng-]	magic (n)	
dP2-V[nT3+	(1) cusc; (2) susc	hushed, quiet; abashed (adj)	
jO:./lnCMi	(1) cî; (2) sî	here (adv)	
tM%Sd2c>$7	(1) dai; (2) ell	sky (n)	
f}8-l.nqAL	(1) daira-; (2) telia-	to play (vb)	
"De5iUUf^Q#"	(1) dairion; (2) de(i)rion (n)	lord, chief (n)	
bAk@di39o!	(1) dalech; (2) daleg	(upright) stone (n)	
FN/XN,)*C5	(1) dathanc; (2) iltanc	unsteady (adj)	
Ch:5JxQl8:	(1) deil(i)an; (2) delwen	beech tree (n)	
uPyWJR+%]A	(1) deldrin grontholas [nd-]; (2) deldron grondolas [nd-]; (3) gronthos deldrinwed	oakleaved beech (n)	
l2-X2`ZY<}	(1) delia-; (2) doltha-	to conceal (vb)	
Kcm@e6iA5&	(1) dineth [nd-]; (2) dîs [nd-]	bride (n)	
n?`t1rV{=J	(1) diradhim; (2) diradhin	once upon a time (adv)	
wF>(spX{U<	(1) doron; (2) gorw	oak (n)	
bK@HMxw]_X	(1) drogol; (2) drogwed	servile, slavish; base, mean (adj)	
"tEP$;J.i9#"	(1) dumgort; (2) dungort	(evil) idol (n)	
KZWJVtc/K0	(1) eithlios; (2) ethlios	fountain (n)	
AND*vyI8-y	(1) eithog; (2) eithweg	ancestor, †father, sire (n)	
Bv1B/Ci&7&	(1) elirdhi; (2) faigri	cruelty (n)	
r7$.RYJ3QL	(1) ercha-; (2) tigla-	to prick (vb)	
r-pT>Y.7rR	(1) fadhw; (2) paglos	parchment (n)	
t5g42ELmnL	(1) faron; (2) feredir	hunter (n)	
z8E@Uq0QR*	(1) fauglas; (2) fuglos	tobacco (n)	
P&jwq`KC+^	(1) fech; (2) olch; (3) ulch	bad (adj)	
E-2dJ*Tgna	(1) fegla; (2) feigien	worse (adj)	
rr]:ocbW5C	(1) felweg; (2) gofelweg	one’s fellow or equal, rival (n)	
prNY73!T^J	(1) fien; (2) fuin	worse (adv)	
cOC1?Zdc[D	(1) findel; (2) finnil	tress (n)	
z]ejNd+c3s	(1) flind; (2) flinn	fleet-footed, swift (adj)	
qq4pf+8&S-	(1) gae; (2) goe	dread (n)	
F~}AKq&d[V	(1) gairwen; (2) gerwen	mirth, fun (adj)	
m@KHFqqnVJ	(1) galad; (2) gaul	light (n)	
D-0+wl^eMv	(1) gawlas; (2) goloth [ng-]; (3) taur	forest (n)	
"LW@2FWuX#X"	(1) glab-; (2) glavra-	to babble (vb)	
rG0=JQVy|$	(1) glann; (2) puig	clean (adj)	
parX06m&,0	(1) glarosta-; (2) glartha-	to dazzle (vb)	
O+dh;an9gp	(1) glaur; (2) glôr (n)	gold (n)	
Bu]a;DSIWI	(1) gledhrinios; (2) glen(d)rinios	slenderness (n)	
xms<+uR)TU	(1) glí; (2) glî	honey (n)	
J2zEYLmc.a	(1) gobennas; (2) pennas	history (n)	
E:vg2pnSha	(1) gochestri; (2) gochethri; (3) hestri; (4) hethri	consanguinity (n)	
ijJ;/,M(Qc	(1) gofil; (2) gwafel	exactly alike (adj adv)	
t7LO-u(ujS	(1) golwin; (2) gulwin	*Gnomish woman (n)	
rLB2itjX~c	(1) govin(d)riol; (2) govinra; (3) nochinra	long-acorned (adj)	
KU**O,=yd{	(1) grondolas; (2) grontholas	oakleaved (adj)	
Gk0pjub)F`	(1) grondos; (2) gronthorn; (3) gronthos	oaktree (n)	
k)qaKx6Tb_	(1) guin; (2) gwein	*woman (n)	
j/;w!zRjB0	(1) guireb; (2) uireb	eternal (adj)	
QDyoGq|>^8	(1) gwanod; (2) nath	number (n)	
mM$nn19m<H	(1) gwass; (2) gwath (Sense Perception)	stain (n)	
M5K~^!~V=y	(1) gwedh; (2) nûd	bond (n)	
HFAu!xW~d+	(1) gwilvrin; (2) gwilwileth	butterfly (n)	
GQIT/X[2,S	(1) gwiog; (2) gwion; (3) neth	young (adj)	
w.+K=bG:cf	(1) hador; (2) hadron	thrower (of spears and darts) (n)	
kcQg<$Ki+L	(1) haradren; (2) harn	southern (adj)	
bRlyI@tKw*	(1) hartha-; (2) ûna-	to hope (vb)	
CFiS|n>;Ve	(1) has-; (2) hath-	close to, by, beside, touching (pref)	
Mt_V.vo>C*	(1) he; (2) hen(e)	she (pron)	
KkvPckLE},	(1) heleg; (2) lhinc	ice (n)	
(1~p59HDv	(1) herven; (2) hervenn	husband (n)	
p]bdmmez+Q	(1) hin; (2) mu; (3) o	from (prep)	
q6,-9H1AcV	(1) humethla; (2) humloth	(red) poppy (n)	
B^%{y>`HK@	(1) iell; (2) sui	daughter (n)	
ck(*&VnGqf	(1) inna; (2) int	in home, to its house/its right place (adv)	
PY}wUbdQho	(1) ith; (2) itheg	anything (n)	
oi;`yyH0,	(1) ithrin; (2) ithriol	of any kind (adj)	
QpcS4J4(CB	(1) ithweg; (2) ithwin	anyone (n)	
OwiLp/a?V6	(1) ivangod; (2) ivongod	walnut (n)	
Pt?aspUPV!	(1) lann; (2) lhann	broad (adj)	
"d:I#-zr%m,"	(1) lhui; (2) nimp	pale (adj)	
t,sBZwu&}E	(1) logrifidhrin; (2) logrifindel	curly haired (adj)	
G.;>ZAr,wE	(1) maien; (2) mairien	better (adj)	
q_+d}nHYjk	(1) maudrin; (2) maurin	early, betimes, up early; premature (adj)	
GK]B<K4G@j	(1) mavuin; (2) mavwen; (3) mavwin	ancestress, †mother (n)	
hmH].Axq+K	(1) mawr; (2) môr (adj)	good (adj)	
E|e$I$>0i3	(1) men; (2) sad (n, Spatial Relations)	*place (n)	
H`jkmhkAX<	(1) migligen; (2) tidig	little (of amount) (adj)	
pV`[;_$}(~	(1) modrog; (2) modron	rich man (adj)	
BS1B/sR%Jd	(1) morn; (2) môr (adj, Sense Perception)	black (adj)	
Hkx$Do>+1a	(1) mu; (2) mutha	will, am going to, am about to (prep)	
tor,&;&YtS	(1) muir; (2) muthli	heifer (n)	
ob,n^.2D?&	(1) mul-; (2) mum-	to low, bellow (vb)	
J*nM^4!1q6	(1) môna; (2) môni	spirits of the air (n)	
"z{#WM4_I;`"	(1) nadhor; (2) nadhras	pasture (n)	
PVsNW}?1co	(1) nafa; (2) nôf	suspicion, inkling (n)	
vtyIg5Wo`q	(1) nand; (2) nann (Agriculture and Vegetation)	field acre (n)	
Hl_||+Bh53	(1) neleg; (2) nêl	tooth (n)	
"oaY#Ax*+sv"	(1) nendil; (2) nennil	waterfay (n)	
mA^O`N$FWQ	(1) nest; (2) nesta; (3) nethra	?heart, core (n)	
Anb[7_YS2`	(1) nilta-; (2) niltha-	to empty (tr.) (vb)	
k>]n8Q$w*L	(1) nind; (2) ninn	blue stone, turquoise (n)	
naNPcS%}t8	(1) nobromath; (2) nuimoth	‘second twilight’, first signs of dawn (n)	
p--ne/=Uc^	(1) nufleg; (2) nuthleg	keen-nosed (adj)	
MsBZMb<I=-	(1) nufli; (2) nufri	sense of smell (n)	
iXT_gOwx_N	(1) od; (2) og	sharp corner (n)	
"hDf$!$6#AI"	(1) odrog; (2) odron	dour, mighty, stout, brave; a brave man (adj n)	
wENQ1;rdiL	(1) ol; (2) ôla	cliff, seaward precipice (n)	
"J#BPo]@ze0"	(1) orhaud; (2) orhod	seatless (adj)	
GPLp%6ct:M	(1) pigwed; (2) saer	bitter (adj)	
n[DMF+o>q4	(1) podra-; (2) ponta-	to turn round, turn back, retrace (vb)	
b%|.,m>_FF	(1) rôs; (2) rôtha-	embrace (n)	
cDd?x52$D4	(1) sarothod; (2) sarothwad	voyager, seafarer, (lit.) foreigner from overseas (n)	
IAf9GG20-e	(1) sinc; (2) tinc (Physical Acts and Materials)	metal (n)	
Eyy>QOO1E;	(1) tail; (2) tâl	foot (n)	
h:SNBNUR*Q	(1) teflarol; (2) tefra	abject, mean (adj)	
yVJvtO8w/|	(1) telthion; (2) telwed	roofed in, sheltered, protected (adj)	
y*tr&AtPM8	(1) tiglas; (2) tiglath	remorse (n)	
mSqMp.`O-S	(1) tlais; (2) tlass	splashing, flapping noise (n)	
x+U(fcQD92	(1) tol; (2) toll	island, isle (n)	
z40UH`rGqL	(1) tond; (2) tonn	(bored) hole, perforation (n)	
v;5;)Toonr	(1) tundeb; (2) tunneb; (3) tunnen	full of holes, riddles (adj)	
GE}Jn)`oj1	(1) uchuil; (2) urguil	lifeless (adj)	
u%~ZBF/FXd	(1) uluchnir; (2) ulugwin	she-dragon (n)	
kE`lEw78UD	(1) um; (2) umin	we (pron)	
QT@*N1*L~R	(1) ungathos; (2) unthos	eighteen (n)	
"uzA#ypKac/"	(1) usb; (2) usg	fog, mist (n)	
e%z2;evg71	(be)bilfir	conscience (n)	
Drz+x}K>Zu	(m)bara-	to dwell (vb)	
hV(q:&ErTm	(n)adi	father, daddy (n)	
dOw,[cf_bv	-(i)ol	active participle; adjective suffix (suf)	
uVzGoCLX{T	-(u)m	?indefinite suffix (suf)	
D3KOEq?W}A	-bar	dweller; home, -ham (suf)	
hwV!Ud^~VK	-carn	*-made (suf)	
Cm7ft3}!oV	-c	noun or adjective suffix (suf)	
N!@?+_dPP7	-eb	(1) adjectival suffix; (2) adjective suffix (suf)	
CRA8$ObTr+	-gen	*earth (suf)	
Dl?)x&pK0O	-gon (Emotion)	valour (suf)	
y$Di4wfZa(	-iad	comparative ending (suf)	
vk@2KC{_TK	-iant	superlative ending (suf)	
gW!)?OE|TS	-in (Grammar)	(1) adjective ending; (2) plural suffix (suf)	
mOjGWO?nf]	-iof	-bearing (suf)	
K{$nz9BgdE	-ion (Grammar)	*agental suffix (suf)	
x]NRoL{wNo	-la	(1) noun suffix; (2) verbal suffix (suf)	
F:<{;wJ+bc	-lim	many (suf)	
ymgrswmUtz	-liont	*tendril (suf)	
I6LeH7d2FC	-loth	-grown (suf)	
j_emP,`Z6b	-n	genitive suffix (suf)	
x`$b]):WZt	-oglo(n)	augmentative (suf)	
gG.Zo>VSS	-onta	superlative (suf)	
Jnf-}cRR(b	-rim (Grammar)	group plural (suf)	
twv>BA>KdQ	-rim	*many (suf)	
i{T%1aZ:-A	-rod	abstract nom[inals] (suf)	
i/((Bn!MvN	-r	plural in verbs (suf)	
Nk?e~nntmA	-tha	(1) causative suffix; (2) noun or adjective suffix; (3) verb suffix (suf)	
"O/od^By<y#"	-thi	*diminutive suffix (suf)	
h9C-m+1KDZ	-thlib	-ly or -like (suf)	
zxK)U(rIBh	-thlim	race, folk (suf)	
e|S%Uf6>T5	-uin	*noun suffix (suf)	
KAX/h4WN5+	-vron	dwelling (suf)	
jEDy=Pe0EF	Dân [nd-]	Green-elf (n)	
Q;{O?<sOz8	Eledh	Star-folk, Elf (n)	
I]<16qQNzv	Goldogrin	Language of the Gnomes (n)	
BYLnC?.J<W	Goldrin	Gnome (adj)	
yxbWD=qSQ]	Golt	gnome (n)	
Im|Mk4y9;C	Thilim	*Moon (n)	
uM}4|M3Uh(	a- (pref)	(1) ?; (2) intensive prefix (pref)	
Ddx956yS9t	a- (pron)	it, they; 3rd-person pronoun (pron)	
Ep6+C&}lz>	abont	back; backwards (adv)	
u]NRs^qOz;	ach (adv)	too, *excessively (adv)	
"eg<NB:#zj<"	ada (Mankind)	father (hypocoristic), [G.] daddy (n)	
M<T5ZI.z{C	adab	building (n)	
JGmZy)jUxP	adel	behind, in rear (of) (prep)	
BN!tO{B};q	adengion	builder (n)	
py7h|eqI3_	adhwen	approach, avenue (n)	
LcMz>4v6$2	aes	cooked food, meat (n)	
NH]+xVJ$8K	aglareb (adj)	(1) glorious; (2) glorious, brilliant, *radiant (adj)	
D64fZMLWU1	aglareb (n)	glorious (n)	
"LA#NMa).J+"	aglath	glory (n)	
g5se=dxVRw	agor	narrow (adj)	
n[||ld~w:.	agra	extreme, vehement, excessive (adj)	
eTwtj0<)ja	agros	excessively, too; excess (adv)	
j^yt(mrvvA	aidra-	to expiate (vb)	
P=PXd7E[M-	aidros	expiation (n)	
w2}Sa.Oj~-	ainog	*(male) god (n)	
JPM}%3@r>P	ainuil	*(female) god (n)	
y/CN=V:XBX	aithr	thorn, †sword (n)	
yG+y}[]6D>	alaf	broad of the back (n)	
c?$58>I_1n	alagos	storm (of wind) (n)	
mw8.u]e22r	alag	rushing, impetuous (adj)	
j|?jP%;F;)	alaith	shielding, warding off, protect(ion) (n)	
q|}>6xjKsA	alanc	*shielded, protected (adj)	
vN1.y,$b|1	alch(ar)	shrine, temple (n)	
Iyzs_qGGHY	alcharn	of wood, wooden (adj)	
K]7.&B7bnz	alm	back (from shoulder to shoulder), shoulders (n)	
K)IHRz||_<	altha-	to shoot up, grow (high) (vb)	
ki+t_d8?Yk	am-	snake (pref)	
k0WgY=p~U0	amben	uphill; [ᴱN.] arduous, difficult, tiresome (adj)	
s16zE@{Us4	ami	mummy (n)	
J{dBU0z+eZ	ammos (Warfare and Hunting)	byrne, hauberk, cuirass (n)	
FgArI$W2Wh	amoth	breast (n)	
yn3-?Pu&.j	amra-	to go up and down, live in the mountains, wander (vb)	
B~Je7&!}7_	amrad	nomand, wanderer (f.) (n)	
Craa?n!I7t	amrod	wandering, living in wilds (adj)	
i3lJ>Owl31	amrog-dorn	brown wanderer, gipsy (n)	
e9?P~k^+V1	amrosta-	*to rise (vb)	
tIhP?HR{fS	amrûn (Spatial Relations)	uprising, sunrise, Orient, east (n)	
Ch:)LG57MN	anc	jaw, row of teeth (n)	
J@=]-,>]Qa	angeb	like iron (adj)	
d^(mLT}@?H	angol (Religion and Beliefs)	deep lore, magic (n)	
Kk)/w/V2P}	angwedh	chain, fetter, (lit.) iron-bond (n)	
u4|th1PV)Q	annabon	elephant (n)	
to4of~ImS.	annuir	lofty (adj)	
E]-IvT8uVM	anos	man (fullgrown), warrior (n)	
vA~I:_`B06	anthum	upwards, cg. onto (prep)	
t$cSp^]C>%	ant	cheek; face (n)	
o$V0!Fhfy1	ar (conj)	*and (conj)	
sOTP`27k;*	ar (conj, Spatial Relations)	(1) and; (2) and, too, besides (conj)	
QNxOTm7q]B	ar (prep)	at; to, towards (prep)	
fl2-`MNdqy	archos	savagery, evil temper (n)	
k1J5V-EmHN	archuis	evil temper (n)	
IXNx$i(R3@	arch	fierce, harsh; awkward, difficult (adj)	
pjX`6DPJd*	arf	barren, dry, desert (adj)	
B+N=8od;eK	argen-	?to search over (vb)	
y>Ia&=?).-	arin(g)	kiln (n)	
-YG^F4Qt(	arnen	?royal (n)	
y&3@W6coZ=	arnœdiad	innumerable, countless, endless (adj)	
zF1`3`i~-N	arog	swift, rushing, torrential (adj)	
"D#${s/b7M["	arwad	apple tree (n)	
goI(>j:_l~	asc	bone; stone of fruit (n)	
A[wto[5~}v	ast (Physical World)	dust (n)	
f3:)%+vn`-	athan	beyond (prep)	
gh)t<M?qOC	athla	twice (adv)	
"n#)1hoX?+c"	athrada-	to cross, traverse (vb)	
A[Ry]e(GIf	athron	second, other (adj)	
"g<{#|Aknn("	athru	secondly, once more, again (adj)	
EFJn$GhE@S	auba	shout (n)	
DNR8f6q.>.	auglos	bright sunshine (n)	
tb-d1yJG8T	aul	ill, badly (adv)	
z4h,8HcHqf	aus(s)aith	avarice (n)	
h4EMW{hQnY	auth (Warfare and Hunting)	war, battle (n)	
yU?pTRm&qR	avasaith	avarice, greed of gold (n)	
L[q}Bn2lPh	avas	wealth; luck (n)	
xi&Z%ik9sy	avosaith	gloomy places (n)	
nFpZumRi@8	awartha-	to forsake (vb)	
q,GyGS.Hny	awarth	abandonment (n)	
"ud5O#SenkW"	awl	*lofty (adj)	
xaol$YNq~9	baba	mummy, mamma (n)	
pO,u?+W4vv	bach [mb-]	article (for exchange), ware, thing (n)	
kCf(3g^~g=	bachor [mb-]	pedlar, *trader, merchant (n)	
"r=0Gt#>bR,"	bad (Motion and Transportation)	way (n)	
"s!#Pv:q%v|"	bad-	(1) *to tread; (2) to travel (vb)	
mUlLy6V4jE	badh- [mb-]	to judge (vb)	
g8IV`ry?U^	bag-	to sell, trade (vb)	
"lZ@<ni#{qb"	bala	round hump, hump, hillock (n)	
zX$)8HSY$e	bald	*worthy (adj)	
w[ogx1zWd~	balhant	illfated stroke (n)	
vpbLF4bFcu	ballam	with evil malicious tongue (adj)	
j0pt>mQ8N{	balthanc	obstinate (adj)	
dK!ghe_TQC	balthir	evil king (n)	
D.+dRDQIZ.	balt	a plain (n)	
"L>?{J{tk#)"	balvlaud	overweening pride (n)	
CgB$nxQabd	banga- [mb-]	to trade, *sell (vb)	
ze^4[<b6xx	bann [mb-]	duress, prison (n)	
I9b&2=O)BU	bar [mb-] (Dwelling and Furniture)	home, dwelling (n)	
s>,2ftn_wH	bar(n)a- [mb-]	to dwell in (a land), till (land) (vb)	
ivh${`DXG@	barad [mb-]	doomed, *fated (adj)	
i-.TU:b/~v	baradh	steep (adj)	
"nQPB/fp#ng"	barai [mb-]	at home, home (adv)	
H4)L,*OcC<	baravlid [mb-]	homeless (adj)	
rP-7E:*C+{	bara	fiery, eager (adj)	
K0oYlLf|u>	barog [mb-]	from home, out, away, abroad (adv)	
N=nm]cn!e,	baros [mb-]	hamlet (n)	
"g*`$U,K=1#"	bartha- [mb-]	to doom (vb)	
Oxr[Mj(H~I	bart	*fate (n)	
C.w56~wxQo	barwen [mb-]	homestead (n)	
eQX2r2fQvi	basca-	to flap (vb)	
i2FVBt:i8n	basgorn [mb-]	(1) loaf (of bread); (2) loaf, [G.] loaf of bread, [ᴱN.] round loaf, cake; (3) round loaf, cake (n)	
Po,g$Yh3uK	batha-	to trample (vb)	
ueTsg[23l.	baudh [mb-]	judgement (n)	
lL1zU(x<J~	baug [mb-]	tyrannous, cruel, oppressive (adj)	
C3ZsHEPW%Q	baugla- [mb-]	to oppress (vb)	
M>MTJu)ma.	baul [mb-]	torment (n)	
NBH`xK+U%4	baur [mb-]	need (n)	
QiW%R6rch<	bellas	bodily strength (n)	
Me+x!J%z;M	belt	strong in body (adj)	
K9zSwlVd8Q	belwa-	to unroll, unfurl (intransitively), belly (of sails), swell (vb)	
KEkb.)MkO5	benc	small boat (n)	
cn;1og~^};	benli	a pretty (n)	
p8fVKYGf;V	bennas	angle (n)	
nofDQW$7fY	benn	(1) husband; (2) man, male, †husband (n)	
E{Vy-Ki4{8	benwed	shapely, pretty (adj)	
mD-kN:i.OV	beren	bold (adj)	
rbp*b6pGhW	bereth (n)	queen (n)	
BH[J/`.sjG	beria-	to protect (vb)	
b_(zlz_g-e	bertha-	to dare (vb)	
e~Nh(yf2Az	besgad	wedlock (n)	
Ra~/FU0-J,	bess	(1) wife; (2) woman; †wife (n)	
"B#ThLfM@tO"	bir	in, within, inside (prep)	
"H*K#w>0|m,"	blab-	to flap, beat (wings etc.) (vb)	
c6ggadI|(/	blencha-	to flash (vb)	
xy2069v[Bf	blid-	to free, rid (vb)	
N<=yAlVqtX	blith	air, breeze, zephyr (n)	
HS63QQfqC_	blé	fat of meat (n adj)	
Jp>ffZ5~tB	bod-	back, again; un- (= backwards) (pref)	
lC&LCh-,BX	bodamrost	resurrection (n)	
oHA=bAh5lO	bodra-	to hinder, delay, tarry (vb)	
vFMqMN{ph~	bodra	back(ward), hinder, rear (adj)	
k$zqPOAS@e	bodron	behind, further back (adv)	
HDZ.p1D+fs	bodruithog	thirsting for vengeance (for a particular act) (adj)	
y+7?vkDwVX	bodruithol	vengeful (by nature) (adj)	
n7o)N`4hk0	bodruith	revenge (n)	
F6w)$A9Tzl	boer	hot, raging; heat, rage (adj n)	
qqG|-fAB_i	bogligen	cheap (adj)	
O0&:cX?HFM	bogodog	dear, *expensive (adj)	
l+e6&tv+)_	bont	back(wards) (adv)	
kITNSs*Un;	bordh [mb-]	heat, rage; hot, raging, wroth (n adj)	
e-.~TR-8cb	born (n)	age, great period (n)	
"h}T]0#{U_%"	both [mb-]	puddle, small pool (n)	
bOR:3l`GQ*	brann	lofty, noble, fine; high (adj)	
d_]t<M@(:D	brass (Sense Perception)	white heat, *extreme heat (n)	
cBy&$t<1vU	brassen	white-hot, *very hot (adj)	
C(tD+g5lgv	bregedur	wild fire (n)	
t7:p|jQ8<,	breged	violence, suddenness (n)	
n0lcNcfM^i	bregolas	fierceness, *ferocity (n)	
lec9,xbd!k	breitha-	to break out suddenly (vb)	
i.$4qCAA%_	brenia-	to endure (vb)	
o$@.of}xX=	breth	mast, *fallen nuts or acorns (n)	
n}v)K]:r=H	brin(in)	glassy substance (n)	
LJ2%Dz+BtJ	brinc	clear, transparent (adj)	
s1J^CD0$P.	bringlast	alabaster (n)	
"vt5U]yJ)#6"	brin	dwarf-glass (n)	
ebl?i:R/>U	brith-	to chance (vb)	
mF.t<P6QDZ	bron(n)	steadfast, firm (adj)	
qZF5{}tf8q	brona-	to last, survive (vb)	
P+O$@B6=:1	bronadui	enduring, lasting (adj)	
y?^zc2;K8a	bronwedieth	constancy (n)	
f2uAsMnJXg	brumla-	to make a noise (vb)	
cxlTqboj9Z	brum	noise (n)	
v&)@?KOY*K	brôg	bear (n)	
yBh8X`3PW7	brûn	old (has long endured) (adj)	
m9i8|TZtSk	buia-	to serve, hold allegiance to (vb)	
kG;d@Q)E*2	buin	desire, wish (n)	
vt:i*V,fFi	bár	home; earth (n)	
OL(1_(6C$0	bâd	beaten track, pathway, [ᴱN.] way, [G.] path (n)	
gN/)^qY|$A	bâr [mb-]	(1) house; (2) house, dwelling, home (n)	
A[e7RZ4i?x	bâ	away, off (adv)	
K?,(vjtik5	bôn	back (n)	
pj%bjj,%F=	bôr (adj n)	steadfast; trusty man, faithful vassal (adj n)	
el%3*:nt}y	bôr (n)	descendant (n)	
e9:<Cg>sNW	cabor	frog (n)	
D]A4fc{![@	cadwor	shapely (adj)	
hjmG:ESwAq	caeleb	bedridden, sick (adj)	
DwVw,.g`y9	cael	lying in bed, sickness (adj)	
F,]i/O9A:Q	caew	lair, resting-place (n)	
q>r,DjI*)4	cafol	bald (adj)	
J5N%hj[RHh	caineglad	fortnight (n)	
qHn(|Qnx1>	caiw	lively, quick (adj)	
dT*5AI[JB;	calf	water-vessel (n)	
N1R3HpXh-0	callon	hero (n)	
"CC#0#h@G)7"	camba-	to stoop, cower (vb)	
"vur]O2#|1)"	cangi-	to go wrong, get tangled (vb)	
E$aUKOO}Bi	cantharol	glaring, flaming (adj)	
I~F7mBAjX[	canthor	blaze, flare, glare (n)	
j}`S+EcEZ/	car(dh)	house, *construction, structure (n)	
NRN*fcOlPm	carab	hat (n)	
ld?Ip{-lbM	caraes	*jagged hedge of spikes (n)	
oBCY!27O{?	carag	spike, tooth of rock (n)	
iO*/UI9`vz	carch (Sense Perception)	tooth, fang (n)	
EZh9l%%c?t	carpa	together, in a bunch, bunched-up (adv)	
qZw4[,QMg&	carp	bundle, bunch (n)	
~*zBSL3u-	cas	head, skull (n)	
JWmQAwl(:P	caug	humpback (n)	
j70n)8UTGD	caw	top (n)	
HmbqWGV]b9	ceber (Physical World)	?limestone, -rock (n)	
OsQDk(v24a	cectha-	to spout out (vb)	
p.%$hr{{o+	cef	soil (n)	
8Oy`p<$H7	celebren	of silver (adj)	
lK%s}/zl65	celeth	stream, *brook, rill, runlet; (lit.) a flowing (n)	
L0W4TNxZ:=	celevon	*of silver (adj)	
"t+z$@6l#>K"	celu-	to trickle (vb)	
t>CNZy_(1g	celwa-	to trickle (n)	
Ig7xo(0OEI	cerch	sickle (n)	
Pzo+K(C7HS	ceredir	doer, maker, *crafter (m.) (n)	
QgYugI+8fv	cerin (Spatial Relations)	round enclosure (n)	
A]l=CpaoKl	cevnas	earthenware (n)	
F3EsYSEn_T	cevn	of earth, earthen (adj)	
GMx`zRzK<Z	cingra-	to plait (vb)	
u`]PK+%-=W	cingra	plaited (adj)	
"p)J,)#tk)("	cirdan	shipbuilder (n)	
sP)K/%!pnw	clamfa-	to grab, claw at (vb)	
JL}k_A>5M_	claur	splendid; †splendour, glory (adj n)	
KsXCl}b0Ps	clib-	to uphold, support; to lean (vb)	
Ftkq08+?z2	cli	?attractive (adj)	
g+lLe=nq`~	clochrin	stony, stone-like (adj)	
zeax0(*4uQ	clochwed	stony, stone-covered (adj)	
NxzB.RE2rP	clog	stone (small) (n)	
O~hv_e)JkX	closs	shingle (n)	
c1Z.bWoSWT	cluimri	pleasant warmth, cosiness (n)	
sjQ4xr)W:X	cobar	knob, head, tip (n)	
G(M?|KCf7O	codomla	*chestnut (n)	
K_x9BJf8eG	codrin	nutty (adj)	
oZC3`G+wI+	codwalion	walnut, chestnut (n)	
qUy5%V}@[,	cog	claw, fist (n)	
B~L&*?J<OX	coll (adj, Sense Perception)	red, scarlet (adj)	
E81YIn%U-b	corin	round, circular; rolling (adj)	
jRmXT0iT7_	corn	round, globed (adj)	
u+dP(bSS6a	coron	globe, ball (n)	
p|~XffFZ1l	cost	quarrel, *dispute (n)	
mLf4q^llhL	coth (Food and Drink)	nutshell, husk (n)	
Ow@yeG+CA|	coth (Social Relations)	(1) enemy, foe; [N.] enmity; (2) enmity, enemy (n)	
i314qv}Q8]	craith	foam, froth, spume (n)	
Nas{oPwgHK	crann-	to finish, complete, accomplish (vb)	
N$TJ=zWu?d	crann	ruddy (of face); blush, the cheeks (adj n)	
GumMfZ$12>	crintha	rosy, pink (adj)	
Mb>LkZ~bPA	criptha	together, in a bunch, bunched-up (adj adv)	
M/F7CE!7(e	cris(s)	cleft, gash, gully, ravine (n)	
:sR?/b(:6	criss (Physical World)	cleft, cut, slash; pass (n)	
K2jE!GLAw7	crist (Physical Acts and Materials)	knife; slash, slice (n)	
EU}`39vjBz	crist (Warfare and Hunting)	(1) cleaver; (2) cleaver, sword (n)	
cPX6@1G%=W	critha-	to reap (vb)	
sZN0fn12oh	crithla-	to encircle; to circle, go round (vb)	
w~n)vRyV_8	crithos	circle, ring (n)	
n{Ht>!o5tY	crogin	hooked (adj)	
lVOZEuwL4m	crug	beak (espec. of a ship) (n)	
gt*(3BI_vu	cruith (Physical World)	spume (n)	
ltZ4ai(-HR	crumguru	wiley, sinister, guilty (n)	
l,>+x(Y}H*	cuctha	consideration (n)	
diOa]=byy)	cuen	small gull, petrel, sea-bird (n)	
J}wt^}DgC+	cug-	to ponder, resolve, think, consider (vb)	
N?g=2Zl@%9	cugu	dove (n)	
H-<Re9w~Z(	cuilogwi	liveliness (n)	
jfDFwXFt@3	cuil	(1) life; (2) life, [G.] lifetime; (3) life, lifetime (n)	
v%Mw@/19,n	cuin	alive (adj)	
y]/%whxRYb	culon	*gold (n)	
J}durtLQ-r	cum(b)	mound (n)	
QG(Xw:_kk@	cumli	couch (n)	
w,+Q%nG|L]	cuno	care, thought, ‘pains’ (n)	
"g#Gu}gC@-t"	curdhuig	sinner [m.] (n)	
IEz[SX-*C*	curdhuin	sinner [f.] (n)	
yPqCz}bCNF	curu (Mind and Thought)	cunning (n)	
"n)~*qG]O7#"	curunir	a man of craft, wizard (n)	
km~1%mPKYF	cwathil	plume (n)	
c3tM2;AfR3	cwedri	telling (of tales) (n)	
"d[ZL6Al)b#"	cwent	tale, saying (n)	
Nkpj9%^%oC	cwidhra-	to rustle (vb)	
"M7,`Y}Nhe#"	cwileg	alder (n)	
u$1c`?fD6d	cwilon	bright-hued (adj)	
xn~lXA%,}X	cwingfimli	skill at archery (n)	
dkCJXU?uSx	cwingfim	skilled at archery (adj)	
ii]19yH5Cu	cwithra-	to murmur, whisper (vb)	
BtCh5rGrxB	cílobi	robin (n)	
O/5:_+tE?n	cîrin	present (place or time), modern (adj)	
jT2@!41X&y	cîr	sour (of milk) (adj)	
P)!oo8pA/:	côl	herb, vegetable, edible plant; wort (n)	
tjiN}FB6!W	cû (Spatial Relations)	(1) arch, crescent; (2) bow, crescent; the waxing or waning moon (n)	
r3CU3=o&6f	cûm	mound (especially grave), burial mound (n)	
k[3P2G!08<	cûn	(1) bowed, bent, bow-shaped, [G.] concave; (2) bowed, bent, concave (adj)	
oA$9*,Eoq4	dadbenn	downhill (adj)	
BHf|IiAM5o	dadben	downhill, inclined, prone; [ᴱN.] (figuratively) easy-going, easy, not arduous (adj adv)	
C9$=U|8mw{	dad	down (adv)	
iRhHJ@!0!1	daen [nd-]	corpse (n)	
I0-x|=%~Tm	dae	shadow (cast by an object or form), shade (n)	
so+qn^_0|i	dagra- [nd-]	to battle (vb)	
c{a0p.4QjM	dairwen	mirth (n)	
bnXn:gMwLZ	dair	play, merriment (n)	
i?zJwQ||[6	dalath	(1) flat surface, plane, plain; (2) vale (n)	
qMlL}7y6m^	dalhung	not heavy (adj)	
f,pq9]Y5Q;	daltha-	to erect, set up (vb)	
D?^FCqE/>p	damma- [nd-]	to hammer (vb)	
lVxD1B(;Yg	dammog	valueless (adj)	
"G9c_SZr#)H"	damor	no good (adj)	
BsO,FFCL*Z	dan-	negative prefix attached to adjectives (pref)	
I8%QiBs$`V	daneitheb	thornless (adj)	
najb>T~c_O	dangair	mirthless (adj)	
eYchx@)8(z	danglarweb	without light (adj)	
nY(T&}Wkz%	dannen	fallen (adj)	
G!&CW_W8(A	darhod	not free (adj)	
bCA`x6b4hs	daroth	summit, peak (n)	
"N#TAoWja$/"	dartha-	to wait, stay, remain, last, endure (vb)	
BRfl+tF`w)	dath	hole, pit; steep fall, abyss (n)	
jhpiKCO]&X	daug [nd-]	warrior, soldier [with evil connotations] (n)	
pIt%!Ty{+L	daw	hush, be silent (interj)	
g`n00ZZ4I;	dein	height, summit; height, loftiness, sublimity (n)	
cw+g(=0SI6	deldrinwed [nd-]	beechen (adj)	
"LcctXL2)#z"	deldrogod [nd-]	beech nut (n)	
LNZLQfY;u~	deleb	horrible, abominable, loathsome (adj)	
HG:V`VNURk	diant	most (adv)	
D2LA4DY@`s	difedhin	*outlaw (adj n)	
e1mErx&P|w	dilia-	to stop (up) (vb)	
LNH,;u%H^)	dim (adj)	past, over, former (adj)	
mJ8`al->z(	diriol	tedious (adj)	
shF*>6&K7_	dir	through, over (prep)	
c}4s-Q1NRR	doll [nd-]	obscure, dark, dusky, hidden, secret (adj)	
lKK,H=u5C:	dolt [nd-] (adj)	obscure (adj)	
m+3K130H3&	dolt [nd-] (n)	round knob, boss (n)	
m]1myDdDJ&	donn	swart, swarthy; shady, shadowy (adj)	
L.<XukXZPV	dortha- [nd-]	to dwell, stay, [G.] settle (vb)	
qBG7qWZshf	dortha-	to settle (vb)	
bJps`jZXu/	dram(b)	heavy blow (n)	
F9@QgVj!Q&	drambor (Body Parts and Functions)	clenched fist; blow with a fist (n)	
v.R3nubPt]	drambor (Physical Acts and Materials)	thudder (n)	
B-_.zo,.Jp	dram	heavy stroke, heavy blow (n)	
"p%`X+#c|.)"	drauth (n)	labour (n)	
s0`0mQ[g&G	drava-	to hew (vb)	
F>~5Zk:>c=	dre	wearisome, irksome (adj)	
GznoDs%aR}	drib- [nd-]	to rot, decay, wear out (vb)	
umqi[Cj&p<	dringa-	to beat (vb)	
Px6fKSz?&+	driothweg [nd-]	hero, warrior (n)	
ep}.=u)~ex	driothwen [nd-]	heroism, valour (n)	
Iex,lw]`uv	drith [nd-]	savour, smell, flavour; suggestion, inkling (n)	
B~5f?9aSXd	drith-	it smells, smacks of, savours of (vb)	
K7tHIQ0Z?x	drogod	slavery, bondage, thraldom (n)	
Hh];DlAg|Z	drogwin	slave woman (n)	
z9$/SMG*[T	drog	slave, thrall, servant (n)	
uJwCf3rZaT	drû	wood, forest (n)	
qfupVl]VUU	duileg	having power of flight, fledged (adj)	
j,1L(P])HC	duilin(g)	swallow (n)	
u<G}xzxX<^	duil	flight, power of flight; having power of flight, fledged (n)	
g+Xpo$D]fH	duirro	*river-bank (n)	
"x4LF]M8s#G"	dum	secret, not to be spoken (adj)	
Rf/gXj>~@<	duruin	wooden (adj)	
fDGyodt}_<	dwindi	a swift (bird) (n)	
JgPxyA?v=@	dâf (Social Relations)	permission (n)	
-=UUDUMV1	dân	day (n)	
BCO<8]WBO.	dâ	high (adj)	
]D@w5$*XX	dîl	stopper, stopping, stuffing (n)	
eT>to1WPry	dîn (n)	opening, gap, pass in mountains (n)	
lz2$F]J_*O	dîr (adj, Spatial Relations)	long (of time) (adj)	
M[Rc&`Xu.B	dîr (n)	man, adult male; agental suffix (n)	
Q4NRuA>/FJ	dú(w)ath	night-shade (n)	
LA/?Q*`@JH	dûr	dark (adj)	
u&diGEn`[~	eb (Time)	?before (prep)	
DeJXuByKpg	ech (n)	spine, *spiny quill or bristle (n)	
jGcfwjjN~0	echad- (Physical Acts and Materials)	to fashion, shape; make (vb)	
O.Ud1FT:v0	echain	new, built again (adj)	
CbtqcvxGTN	ectha-	to spout, jet (vb)	
Og4@CXNe/E	ed-	forth, out (pref)	
I&u~&>u6sj	eden	new, begun again (adj)	
QKb8OZ8)`C	edonna-	to beget (vb)	
A91/KMw1x6	edraenui	?outside, bordering, outer (adj)	
s8lLx^Z1lY	egelmion	broadshouldered (adj)	
timo4xw4ly	egiont	further, farther (adj)	
hEFF0aU]c^	egnas	sharp point, peak (n)	
u_E*3XbHJ!	egriol	excessive (adj)	
K@1d+R;8|X	eg	far away, wide, distant, far off (adv)	
za~3$lIxN|	eiben	cherry (n)	
gp{UR./d.;	eirin	holy (adj)	
cD=vl*X`/Y	eithlod	springing, welling forth (n)	
b2!3%C+NM5	elaig-	to shield, ward off, protect (vb)	
BJk~qu+WXc	eleg	other, else (adj)	
nBjs?sra+b	elianw	rainbow, (lit.) sky-bridge (n)	
GN[7uP]z+`	elt	dig, poke (probe), tug, lug (n)	
m2x,wdY-?9	elvain(n)	wondrous, marvelous, wonderful; wonder(ful thing), marvel (adj n)	
LJ!hO+s__E	emlin	yellow bird, yellow hammer (n)	
"bz;@#A-@?t"	en (conj)	*then (conj)	
g}0b%RBwKd	enfeg	infamous, of evil name (adj)	
NkOIss.F~(	engluid	Stonefaces (collective-noun)	
DrO{8A9~?n	enne(i)rion	adversary, rival (n)	
w~!WAOH)E9	ennin	Valian year (n)	
"MY#s8VM=2!"	ennion	porter, doorkeeper (n)	
s%-xy1m!N)	entha	there by you, thither (adv)	
FI5Z(o$/cb	enwa-	to be called, be named (vb)	
"us0gR#*GG_"	erch	prickle (n)	
GP9hq-xLgU	eredh	seed, germ (n)	
uI~dc7`~1~	eregdos	holly, holly-tree (n)	
nmy%-_5x/f	erethog	isolated, solitary, lonely (adj)	
n^b4eZCt1k	eria-	to rise (vb)	
J9i2vD41UB	eriol	single, alone (adj)	
LNSCH](zBb	ermin	desert, waste (n)	
Ne5qi_Cz)!	erthi	also, as well, besides, too (adv)	
m~_;lA(ZuJ	eru	waste, desert (n)	
"E5IRE#9Kf{"	esc	sharp point, sharp edge (n)	
"JFyCq#`~|E"	esk	sharp upstanding rock in water (n)	
cO3`?d98Yo	estirion	pinnacle, tower (n)	
bHcHX:L,bp	fadriol	sufficient (adj)	
"c&r#p7_uJ/"	fadro(n)	too much (adj)	
Gdw&DjhQlr	fagin	cut (adj)	
e-gfjyo&qy	failtha-	go pale (vb)	
p{]Gtxm}Wj	falas (Physical World)	(1) beach, shore; (2) beach, shore, strand, surf(line) (n)	
b(O5gQ?67%	falchor	cliffs (n)	
o0wSzL2G0-	falf	foam, breaker, [G.] wave (n)	
zDtJt@!,&h	faltha-	to foam (vb)	
I)cLuWt(D8	far (adj adv)	sufficient, enough, quite (adj adv)	
uoPr`C_F>_	far (adv)	yet, however (adv)	
b=D.FN&9VZ	far(o)n	separate, different, strange (adj)	
By$2o{J/3a	far-	to separate, sever, divide; to depart, leave (vb)	
rR6R^/]>Z*	fara-	to hunt (vb)	
Nntrc`X+ZR	farf	?carpet (n)	
z$z2m?wnAw	farn	enough (adj)	
n,K5G=BZSv	fartha- (Spatial Relations)	to divide (tr.) (vb)	
Nj.md!!1%D	fast (Body Parts and Functions)	shaggy hair (n)	
Ey0_6yP=_g	fast (Spatial Relations)	holder, stand (n)	
"uv#W!t:WPQ"	fecthi	less bad; baddish, naughty (adj)	
"QpG#K})m+D"	feira-	to suffice (vb)	
Dtvd&9FS:	feir	mortal man, mortal (n)	
cl0YR+y}C5	fenn	threshold, door (n)	
"nl<3JA-#%J"	fenwed	venomous (adj)	
PxPigy5h5i	fi-	you, 2nd-person singular (pron)	
jEHOj1*cxs	fileg	small bird, [G.] *sparrow (n)	
odZUJle=}7	filigod	small bird (n)	
nM-n(W+W<]	fimlios	skilfulness (n)	
w^F$&0S7u8	finnel (n)	(braided) hair (n)	
JAyMVMhnzS	fintha	thine (pron)	
v/eNGG<.7;	finwi	skill (n)	
Bp6MV_.4b)	fion(n)iel	(fem.) mortal man (n)	
rbOvygy|N!	fiont(ha)	later (adj)	
"p#{kN{W6O("	fiont	least (adj)	
l`f=b&8Zt!	fir	less (adj)	
jh.ibtA}JK	fladweth	meadow, grassland (n)	
nU@T98bV&z	flant	expression of scorn, leer, sneer (n)	
O*2(bW,y[f	flathnir	foam fay (n)	
"Ke*`#L>W8L"	flathrin	foamy, tasseled (adj)	
f`T^M]X$G3	flathwing	scud, spray, spindrift (n)	
bWe&t[yi]4	flidhra	‘willowy’, graceful (adj)	
Y:q|Et*Eq	foen (adj)	radiant, white (adj)	
"KB#dzXc+5S"	forodren	northern (adj)	
k:1OxK-~(Y	fo	a clan (n)	
HcfK[-v/HO	fring	necklace, carcanet (n)	
e-/%<F-wx4	fufuin	hoard (n)	
KAI8C5tnQJ	fuia-	to feel disgust at, abhor (vb)	
z.6Kt`,po/	fuior	deadly nightshade (n)	
bBk0uKoZ)G	fuitha-	to fall (of night); to grow dark (vb)	
obpV/`w$_/	fuithlog	dragon (who guards treasure) (n)	
cZHcoBri]$	furn	secret, concealed (adj)	
pPYjpSP|{-	fêg	bad, poor, wretched (adj)	
Mt}qyKr>>`	fêr	beech-tree (n)	
MBtn__?0B&	fîr	late (adj)	
Qx!f+xxriI	gad-	to catch (vb)	
O`V7}AcV7z	gador	prison, dungeon (n)	
"zPV#q/z0T|"	gadros	union, association, fellowship (n)	
m7.Rc*J~0j	gaduin	bond, obstacle, hindrance (n)	
"u2kd#jI8!l"	gael	pale, glimmering (adj)	
OaVNQVXmz/	gaib	*pregnant (adj)	
DN&v1bu[Kn	gaigin	arms (n)	
w%~@RViez?	gail (adj)	bright, light (adj)	
pjhnU(ZF$G	gail (n)	star; sign, token, heavenly body (n)	
nc)N%2vF1B	gair-	there is room (for) (vb)	
m+4|J!5!_K	gairion	jester (n)	
JVf%@-*I%z	gal-	to shine (golden, as the Sun) (vb)	
LDKVd`he`G	galas	plant, growth (n)	
Nv^2j~fk+J	gammas	s-sign (n)	
A`<Ro~A/OX	gandos	morose temper (n)	
b7LKuBeCa-	gand	dark & gloomy; morose; harsh, ill tempered, sour, gloomy of temper (adj)	
E:Oeu?8|-v	gann(ad)a- [ng-]	to play a harp (vb)	
E`DV,DbuzX	gannel [ng-]	harp (n)	
B%se8Cj4S[	gant (adj)	larger, greater, more, (lit.) increased (adj)	
qLq=1kR$B[	gar(th) (gardh-)	place, district (n)	
Jc%Pdn!BCi	gar-	to hold, have, *possess (vb)	
iM2Zc5A&S&	garadren	having room for, convenient, adequate, opportune (adj)	
iD^|trzK-j	garadros	opportunity (n)	
lx%rmLk%(T	garion	hauberk (n)	
g3~_(;qsRe	garn	‘own’, property (n)	
b.SHNWY+4Y	gartha- (Emotion)	to admire, have affection or respect for (vb)	
hY0jN$H_zI	gartha-	to defend, keep (vb)	
iw,&ch;<HZ	garth	fort, fortress (n)	
N+)adk,Adv	gar	?to go (vb)	
sK8~SH%PnA	gasdil	stopgap (n)	
L7;OG7v<l*	gas	hole, gap (n)	
ga|V3ovUBB	gaudhwen	fever (n)	
L_4ZGC8{&T	gaud	device, contrivance, machine (n)	
JTs=7[kjF)	gaul [ng-]	wolfhowl (n)	
"FfIRSeY~O#"	gauth	heat (esp. of body) (n)	
CfDeb7|_lA	gaw- [ng-]	to howl (vb)	
dHCv?I2AA%	gawad [ng-]	howling (adj)	
viYP/H*--Q	gaw	void (n)	
K)/+%C=?&=	gellam	jubilation (n)	
u)}9K9NqY9	gellui	triumphant (adj)	
rl=zTluSEu	gell	joy, triumph (n)	
fCW4z3K_b`	gem	sickly (adj)	
"ql{vS[a#w|"	gentha-	to grip, seize, lay hold of (vb)	
"k!!#[-T}ob"	gen	closed hand, grip (n)	
p<ISeDWzKW	gern	worn, old, decrepit (of things) (adj)	
rU&j>6?j`E	gersoth	mine (n)	
bv)S=`9LU_	geth	ore of metals (esp. raw iron) (n)	
Lv_tko&G_r	gil-	to gleam, shine pale and silver (as of the moon) (vb)	
JX9Za~{KZ5	gildin	silver spark (n)	
Q:0{}WQ)th	gilhof	dew, *(lit.) star-juice (n)	
NIpZ.yLI8;	gilith	starlight, *region of the stars (n)	
qE}b{C)ayt	gintha-	to join to (intr.), add, increase, add to (vb)	
mKnl&EFTG7	gir	interior, inwards, centre, inner parts, inside, heart (n)	
O)H<^xvM}j	glaew	ointment, salve (n)	
lw>LBJ2OMS	glais	sweetness (n)	
"v7iK<L#daU"	glaiw	salve (n)	
cvM!s`Bt$0	glamm	shouting, confused noise; barbarous speech (n)	
O44?|.zE,	glamra-	to abominate, loath, detest (vb)	
tJ:CRiFY%Q	glamri	bitter feud (n)	
hK]+D:0LR+	glan (Mind and Thought)	clear (adj)	
vN:FJ9,HV;	glan (Sense Perception)	pure, clean, (originally) bright (adj)	
EQr}LOq>nJ	glarossiol	dazzling (adj)	
Jfou)7XD^|	glass	joy, *happiness (n)	
u1RGk]eqU.	glas	joy (n)	
xX%te15xz7	glaur (adj)	light, bright (adj)	
u+;.yXO{TN	glavaitha-	to blaze (vb)	
l$d}r4RDqy	glavaith	blaze, burning, blazing light (n)	
N5J&3=zw<V	glavrol	babbling (adj)	
r%4xKjQ`%w	glaw (Sense Perception)	radiance (n)	
t^g@J1++Xl	glawar (Physical World)	sunlight, radiance of Laurelin (n)	
f;)C496@T$	glent	thinness (n)	
oj`Wu6K}+X	glim (adj)	shimmering (adj)	
D-ejb:c~pH	glimri	sheen (n)	
AK23LbI~eb	gling-	to hang, dangle (vb)	
m6Z{uh!`6j	glir-	to sing, recite poem (vb)	
n{yK]RX5lC	glisca-	to have a sweet tooth, like sweet things (vb)	
"r]>P#o!vmz"	glonta-	to swallow, gulp, devour (vb)	
ISag19a|@*	gloss (adj)	(1) (dazzling) white, [N.] snow-white, [G.] clear white; (2) white, clear white (adj)	
NJ^HA+WPGp	gloss (n adj)	snow, snow-white (n adj)	
c_g|Q`>Jk[	glum	cloud (n)	
CK<B<k12a^	glâm	hatred, loathing, fierce hate (n)	
H+o3rewNfh	glâs	brilliance, clarity (n)	
iCt}l,m|Es	glîr	(1) song, poem; (2) song, poem, lay (n)	
"bZQ1a;ys#u"	glóna-	to dawn (vb)	
"ov#dH{-caM"	glôrin	golden, of gold (adj)	
gTrr0M&VQ/	glûdh	soap (n)	
pXL0-k&~ie	gobennathren	historical (adj)	
d`<P<:qN($	godaithrinwed	grammatical (adj)	
A0i7xF((`6	gofelthi	exact similarity (n)	
cp*oA`?<,[	golc	stink, stench (n)	
sHIsAk+$Xa	golf	branch (n)	
z]ZMx3HGdm	gollor [ng-]	magician (n)	
K~WxxDxMS_	golwen [ng-]	wise, learned in deep arts (adj)	
fG;v!g<GLl	gomintha	together (adv)	
ksjiGYOF:B	gonathra-	to entangle, enmesh (vb)	
Bp[F_8@V6a	gonathras	entanglement (n)	
"o4!Y!&1#k~"	gondram	hewn stone (n)	
NJ?WB:IET$	gondren	*of stone (adj)	
bR3c82wEW&	gond	(1) rock; (2) stone (n)	
o=HO4655ns	gonebedach-	to approach one another, to become like, resemble (vb)	
Q%w?FIxC_k	gonn (Physical World)	(1) (great) stone, rock; (2) rock, stone (as a material) (n)	
eWCXTNna&&	gonod-	to count (up) (vb)	
sXz1yVk-~U	gor- [ng-]	all, altogether, quite (pref)	
QL?HTM6*-0	goredhin [ng-]	related, sib, akin (adj)	
zWyCXnon79	goredhnir	cousin (f.) (n)	
Kf!bZiChZ8	goredin	*related (adj)	
u=rm:H|k_0	gorf	impetus, vigour (n)	
J=@9WxY>Qs	gorgor [ng-] (adj)	dreadful (adj)	
J~=sW4zMQu	goriad	greater (adj)	
pI3=U`RjN)	gorn	impetuous (adj)	
nKQNOlgw!Z	gosta-	to fear exceedingly (vb)	
"htk#)8n-N%"	gost	(1) dread, terror; (2) fear (n)	
EL>O8_[z.a	govad-	to meet (vb)	
MjPlTs%z`+	goveg	just like (adj)	
d:3!Jga/HT	gowest	contract, compact, treaty (n)	
fX?A6U?OYR	grand	town (n)	
z@@d/F)B+L	graug	demon (n)	
G(X%V0.=FX	graus	sow, *female pig (n)	
m9Nqw[e)0d	grendi	cousinship, family (in a wide sense) (n)	
oYHkrG8%Ob	grest (Possession and Trade)	succour, salvation (n)	
wNF.c0g_*e	grileg	ringed, hooped shape (adj)	
"A}5#ba^Z|M"	grind	ankle, wrist (n)	
PqON9Hf=a3	grith-	to attend to, tend, care, care for, mind (vb)	
"I.B5W#mncu"	grithonwed	thoughtful, careful; unselfish (adj)	
H[qP-l&Q/J	griw	alimentary canel (n)	
he*`|sGo>6	grond (n)	cave, cavern (n)	
K*]xs+l{7W	grond (n, Warfare and Hunting)	club (n)	
Lzj1vfVvn%	grondrui	oakwood (n)	
qg%%&3WW6g	gronduru	oakwood (mat) (n)	
"D1V5`W#~u7"	gruim	fierce (adj)	
DJ]t9gvQ(A	gruin	ruddy (adj)	
zyD&*fcd1g	gruith	deed of horror, angry or violent act, vengeance (n)	
"uVu[-0##rm"	grôn	oak, oaktree (adj)	
Ln^Hq8E!FZ	gudh-	to be hot (intr.) (vb)	
D3KKYpD%_M	gudhriol	inflamed, inflammatory (adj)	
tk(eDu%yK;	gudhri	inflammation; conflagration (n)	
yRdZO$>AyC	gulweg	*Gnomish man (n)	
Nv$iY?Z<!I	gum-	to lade (vb)	
LF.6zF)A;-	gunn	?dragon (n)	
q4]T4b]Pvv	gurth [ng-]	*death (n)	
"OvOh#}?6=Y"	gwa- (Spatial Relations)	*away (pref)	
P)e1Fa/e1Y	gwachest	brother and brother, brother and sister, etc. (n)	
dM6mKu(G[K	gwadath(wen)	wandering, journey (n)	
I?+kD!t?0.	gwador	(sworn) brother, associate (n)	
DpM&DSRJys	gwaeda-	to enfold (vb)	
lV(Gk_mBOg	gwaedh	bond, troth, compact, oath (n)	
bsQqfeKESC	gwag (Sense Perception)	soft (adj)	
w!gss$z-;D	gwahae	*far away (adj)	
Os|~E-F,;h	gwalir	rime (n)	
"l^9,7Ra8#="	gwalwed	fortunate, happy (n)	
t!V*G^Ie?0	gwalwen	fortune, happiness (n)	
s(6&.(s0,Z	gwanin	beautiful (adj)	
zR?^hky2t2	gwanna-	to die, depart (vb)	
i]xKH1H<qK	gwann	dead, (lit.) departed (adj)	
xncBPmn?$$	gwant	beautiful, fair; loveliness (adj n)	
D%xZOml|EI	gwanur	kinsman, kinswoman (n)	
u)J.YQO~EJ	gwar- (vb)	*to dwell (vb)	
hd;B98&q_R	gwar- (vb, Sense Perception)	to watch (all senses), guard (vb)	
c}in*c:k+~	gwardhos	m. companion, comrade (n)	
JBc{YPRwpv	gwaren	family (n)	
y~~_Ob=<7V	gwareth	watch, guard, ward; vigilance (n)	
"Mj2H#m-=fT"	gwarieg	watchman, warden (n)	
foY,um$^:G	gwarin	circle of trees (n)	
gZt]%NEC,1	gwarth	betrayer (n)	
i1+tjSq/Iz	gwass (Physical World)	rush, rushing, noise of rushing, splash (n)	
fNJalgCH$k	gwastar	hummock (n)	
f@wPCAd%t2	gwath (Physical World)	(1) shade; (2) shadow, dim light, [N.] shade (n)	
eiMLDybPb&	gwatha-	to soil, stain (vb)	
uHvis2+3~k	gwathel	[sworn] sister, associate [f.] (n)	
"L`k#y81jUA"	gwaun	goose (n)	
rz;W&;Z8%~	gwaur	soiled, dirty (adj)	
P{a>]~N[D-	gwe-	you (plural), 2nd-plural pronoun (pron)	
qHj+X8i]2?	gwedh-	to bind (vb)	
FX63ifMM{:	gwed	*brook, small river (n)	
"k~#}#l(7Yb"	gwegwin	hermaphrodite (n)	
F&_8gi$q,$	gweg	man, male of the Elda (n)	
h$JhD!G%6g	gweithiad	nation, folk (n)	
"MR!830F#&B"	gweith	people (n)	
Ga;g$g23K;	gwend (Emotion)	bond, friendship (n)	
jSrW1DWQyY	gwenn	maiden (n)	
trh*BD[`n,	gwent	big, large; fine (adj)	
OJqF51oP7U	gwerb(e)lin	top, whirligig, *(lit.) wind-unwind (n)	
yVy]h]r;FD	gweria-	to betray (vb)	
Em8{udIr/w	gwes(t)	rich (adj)	
O~nYQMD_F-	gwesg (adv)	weakly (adv)	
w^u@bj-TP.	gwest (Law and Judgment)	oath (n)	
D(%j>3Au`w	gwesta-	to swear (vb)	
"oy#M`n|B#>"	gwethlir	song of welcome (n)	
"H?#QU+fo,["	gwethriol	welcome, acceptable (adj)	
Eb|G_G4R1p	gwi-	twi-, bi-, di- (pref)	
OQ@EBty);-	gwil-	to sail, float, fly (vb)	
s?6@d6WdDH	gwilbriniol	like a butterfly (adj)	
muNb8pcTn_	gwilith	(1) air (as a region), *lower sky; (2) breeze (n)	
yb.$vZ,Y^K	gwilw	quiet, peaceful (adj)	
cQP?Y`R:Ss	gwirtha-	*to not to wish, not mean to, mean not to (vb)	
w%?64}9@TA	gwirthol	reluctant (adj)	
l*K?,q[OZk	gwirth	unwillingness, reluctance (n)	
M3JQJ3l.4m	gwithant	shuttle (n)	
C@<v)BQyV-	gôf·clochiol	stone-fruit (n)	
w54n6c{LPJ	gôma-	to nickname (vb)	
dtr6i`gB1P	gôr	each, all (adj)	
g0c57RWLt>	hab-	to clothe (vb)	
bd)amAndzZ	habad	shoe (n)	
fpD7zGrqwU	had-	to hurl, *fling; [G.] throw at (vb)	
I&-72S$/8Y	hada-	to throw at, aim at (vb)	
jQ32<e]z+L	hadh-	sit (vb)	
t;MLraX~C$	hadruithog	thirsting for vengeance (adj)	
H0PmsRd/.M	hadruithol	vengeful (adj)	
y9Rm&p9nCD	haew	custom, habit (n)	
FB+JxrVJ`i	hai (Spatial Relations)	there (by him) (adv)	
dloPQ6,Yr;	hai (Time)	in good time, punctually, early (adv)	
Dqyb1uJ?O_	haidra	timely, punctual, in good time (adv)	
ImH9s~IvcR	haidri	forenoon, after breakfast (n)	
w&W{+&2a>/	haid	way, road, path (n)	
e@f<Iq_-1v	haim	gone, departed, lost (adj)	
"d)%%#?&m_P"	hair (adj)	timely, punctual, in good time (adj)	
gumR`H7Q$y	haith	moist, wet (adj)	
x?57otiGF0	hal-	to lift (vb)	
KiPWn/Tj5Q	halath	skin, fell (n)	
PYhhw{p^p`	haldir	fur-hunter (n)	
"HJ!M#C,PX+"	half	seashell (n)	
ie>9rsq|Xt	hall (Physical World)	veiled, hidden, shadowed, shady (adj)	
"sm^aVJ#g0>"	hall (Spatial Relations)	exalted, high (adj)	
c{jU+c_eq;	haltha-	to screen (vb)	
oHc|y-XC)!	hamma-	to clothe, *put on clothes, get dressed (vb)	
leP>zefU?*	hammad	clothing, *clothes (n)	
buWOH:iB<4	hamra-	to abase, abash; to humble oneself (vb)	
LoMP<rKzI&	ham	?chair (n)	
I3_Lp3V7Yb	hana	it (pron)	
MC0Zl0;C%G	hannas	understanding, intelligence (n)	
H}{uM6l;E0	han	above (n)	
K}Ea}bKOq!	harn (Body Parts and Functions)	wounded (adj)	
"OeZ=P3*|?#"	harna-	to wound (vb)	
P;`Mq?|cuW	harthad	hope (n)	
eaQ~EBTVEL	hasta-	to hack through, *cleave (vb)	
Q/pfex0L3L	hast	axe-stroke (n)	
x}m[sr%l[w	hathel	broadsword-blade, axe-blade (n)	
hp%mS%En,R	haust	bed (n)	
FFC}?v/6qv	hebwirol	circumspect (adj)	
H+f*ByKL~w	heb	(1) about; ?from, [G.] round about, around; (2) round about, around (prep)	
"G,/rPX#y?c"	helch	bitter cold, [G.] ice-cold, icy (adj)	
MkfR{040P5	heledir(n)	kingsfisher, (lit.) fish-watcher (n)	
fkVr@v&:ch	heleth	fur, fur-coat (n)	
mj`.Nm&uw(	helfin(n)	icicle (n)	
w-J)1}r}cU	helf	fur, *hide (n)	
oWx@Qh4lep	hell	naked, *stripped (adj)	
r_Y$Ih/vw4	heltha-	to strip, *flay, peel skin; *to despoil, make bare (vb)	
d9<nNJZ)>T	helw	ice-cold, icy, cold (adj)	
Ri=I%j~CYR	henia-	to understand (vb)	
I2v[sZ,|jh	heria-	to begin suddenly and vigorously (vb)	
AynmyRIiUN	herth	household, troop (n)	
p&k62cOL?%	hethgedwi	twins (n)	
Itq`dI1`0?	hethrin	of the same family (in a close sense), consanguine (adj)	
ba7ClUs=*M	hilon	adolescent (adj)	
lY@)=-&6VL	hirilwen	anxiety (n)	
"g-B?tZ#W3!"	hiril	princess, †queen (n)	
pI-4*IRaUB	hiriol	anxious (adj)	
fRm:,SDy]S	hiron	guardian, overseer, lord, master (n)	
c?]?Jw9~P{	hirtha-	to care for, mind, tend; to care, reck, mind (vb)	
LpgGP42iq9	hirthol	careful, attentive (adj)	
r:HvINQl5&	hista-	to listen, hearken, listen to (vb)	
LYSE^AIs>n	hiw	sticky, viscous (adj)	
J$uRI+r5dL	ho(n)-	grandson of (pref)	
e?jYed{AdC	horn	driven under compulsion, impelled (to do something) (adj)	
Byty{VU(kw	horoth	age, eld, oldness (adj)	
F*!)X75Kez	hortha- (Social Relations)	to urge on, speed (vb)	
"wZ#B:LYeWv"	hortha- (Time)	to grow old (vb)	
"b5rE=>C#&m"	horweg	an ancient, old man (n)	
oSjRg3F{E@	host	gross (144) (n)	
dC|FE~{@`[	hugin	young pig (n)	
zb+lz6=s[e	huitha-	it is misty (vb)	
Nzw,fIK>O+	husta-	to burn (tr.), destroy (vb)	
uQ6(6J,EJ`	hyriaith	gale (n)	
wT.(&]yN2m	hâdh	*cleaver (n)	
Fzg$C=b[kc	hîr (Emotion)	care, anxiety; heed (n)	
GlY1{ep6kL	hîr (Social Relations)	master, lord (n)	
Cy<XBw%it-	hûb	haven, harbour, small landlocked bay (n)	
e]CAJ_l%j+	hûd	assembly, *gathering, moot (n)	
E?+1iV$.<m	hûl	cry of encouragement in battle (n)	
Heo)%Vqi2i	hûr	readiness for action, vigour, fiery spirit (n)	
p),il+IA`V	iaeth	neck (n)	
p=>~EFmo+*	iaew	mocking, scorn (n)	
ynxb~ZI6;&	ialla-	to call (vb)	
ph~oV1=Dt2	ial	*cry, shout (n)	
JH0dVccucz	iaun (n)	holy place, fane, sanctuary, *shrine, temple (n)	
NF$P,UPj$^	iau	corn, *cereal crop (n)	
Q/a8{R7&~G	ia	gulf (n)	
qqb,3)ktW!	idanc	masked, *not firm (adj)	
"IQJcR^&#<w"	idhraluin	long ago (adv)	
p1~1k*i<{|	idhren	pondering, wise, thoughtful (adj)	
Mqg&xu+w7V	idhril	*Man (f.) (n)	
"mn7;Hk$n#%"	idhrog	*Man (m.) (n)	
Gt&Ra,)_p>	idhruglin	the language of Men (n)	
vRhUTf>c&W	idir	no king (n)	
A4`7w?BVhD	idra-	to value, prize (vb)	
w0ya/4}L|[	iest	wish (n)	
C-bsi^EhDs	ifant (Time)	aged, having lived long, (lit.) year-full (adj)	
RjXhM~IL`Z	il(d)rim	unquiet, disturbance; disease (n)	
"bLj{v34!#}"	ilgioth	sterility (n)	
s0|x<>p(2o	ilrimog	uneasy (adj)	
y:ZUzbh:Ao	ilt(h)a-	to yoke, join (vb)	
g>aDDDZ0EU	ilwi(n)	sky, heavens (n)	
F>ri3m(mow	im (n, Religion and Beliefs)	fairy (n)	
yF6NE^!iQ-	imm	dell, deep vale (n)	
"k+#7gvOUKq"	in(d)wed	indoors, at home; homely, domestic(ated) (adj)	
"e4gN#RrS]r"	in-	house of (pref)	
M9705&y%5M	inc	guess, idea, notion (n)	
ik5qX8<XoT	ind(r)	long, a long time (adv)	
"AJcw^wY`l#"	ingem	old (in mortal sense), suffering from old age, decrepit, (lit.) year-sick (adj)	
BOQoV!L(b]	inni	home, at home, in right place (adv)	
O425v<%zX;	innor	master (of house), lord (n)	
O=5B.)!i~r	innos	house, hall (n)	
E@;i,Dju2N	intha-	to go (indefinite), fare, proceed (vb)	
J,mGYeUS+8	inthi	less (adv)	
p421G&pDp`	in	go, move, turn, occasion (n)	
x-h3qEE$IS	iofog	fruit drink, cider (n)	
c4N3$RquU[	iolf	brand (n)	
k@+wh;F;H^	io	ago (adv)	
IrD_6%SA&W	ir (prep)	dative and allative (prep)	
kZYh`lw%W	irm	a wish, intention, resolve (n)	
uerb74Z&25	irtha	her (pron)	
l^+o!ZSS(U	irthod	intent, intention, will (n)	
"g(YijK2=U#"	irthol	intentional (adj)	
f{/Z{%vcU<	ist (Emotion)	feeling, sensation; notion (n)	
pR8[S%i2Nd	ist (Mind and Thought)	lore, knowledge (n)	
wR@`4wLU~	ista-	(1) to have knowledge, [G.] know; (2) to know, be aware, perceive, feel (vb)	
C}.sj%1sG6	istui	learned (adj)	
p[Ohd/2PfP	ithog	any (adj)	
hn?.%&Dxi>	iuitha-	to employ (vb)	
M(&xY|I+68	iuith	use (n)	
F2q:9[/IRE	ivogodron	walnut tree (n)	
NPyi|}@fJb	iôr	course (n)	
"bfPiK#/[QU"	iûl	embers (n)	
rBZZdr!&xq	labra	loose, lax, flapping; weak (adj)	
"s07#x&ke:X"	lad (Spatial Relations)	a level, a flat; fair dealing (n)	
t+CcNF9VnK	laden	flat (and wide) (adj)	
JxAEr}>Dh>	ladwen	levelness, flatness; plain, heath; plane; surface (n)	
Ax?0Jw]x67	laithra	dead and gone, over, former, of yore, forgotten (adj)	
z=hI67@]%t	laith	*lost (adj)	
J`w3:gDgr~	lang-	to blare, clang, ring (vb)	
FH-5J{UIi1	laptha-	to relax, loosen (vb)	
"o|5#/6x${W"	larm	elm, elm-wood (n)	
A|0M5qmPMR	las-	to look at, glance at (vb)	
q05@V&ubTl	lass	(1) leaf; (2) leaf; petal (n)	
HjpzUo3dVO	laur	threatening, foreboding, darkling (adj)	
k>7tE=ctmB	le (prep)	and (prep)	
IL6ZQ&oB&c	lech	smooth place; slide (n)	
"Cj#t0gM*uF"	ledh-	to go, *travel, journey (vb)	
lC<XWq8By=	leg	keen, sharp, piercing (adj)	
ys|*DZ}`[@	leithia-	to release (vb)	
j}>Y*km7f	leithian	release from bondage (n)	
zzu;[?h]&;	lemfin	halved, in half (adj)	
A$S)Wj^{&$	lempachùn	wishbone (n)	
ENS~(2HWjV	lenthol	coming, approaching (adj)	
"qj@]#(=:ia"	lenwin	‘arrival’, a stranger (fem.) (n)	
s)T$Rghh)G	lethrin	slippery, peril(o)us (adj)	
G:vTk1|@iS	leth	therewith, with it, withal (adv)	
nJ(/^0O;--	lhaden	flat, smooth (adj)	
j;{{_o?[v@	lhalwen	elm-tree (n)	
Be>-h(PgTp	lham(b)	tongue (n)	
O6{]$<P9BR	lhind (n)	arrow (n)	
FYgCA4!{|v	lhoeg	keen (adj)	
HK:X9@IqOz	lhuth	magic, spell (n)	
o%+4o+,79=	lillir	a song, lullaby (n)	
p*g8MFd3/r	lim (n)	sheaf, bundle (n)	
tb%nlmNFIs	limfelis	drink of the fairies (n)	
J}2Ql;2<Yy	linthanin	playing or music of instruments (n)	
b!i0Ub.iwR	liscaloth	reedy, reed grown (adj)	
C0]U3HfWT/	lithin	bygone, ended (adj)	
z[:hET+4a{	lithra-	to cease speaking, become silent (vb)	
O/HVxiq3^z	lo (n)	flood (n)	
vPHt;GyRBF	lobor	[heavy riding] horse (n)	
A64r%14hHl	loda- (Body Parts and Functions)	to swallow, gulp down (vb)	
q7TO$!$4}[	loss	blossom, bloom (n)	
s9fFB,2wNR	luithia-	to quench (vb)	
g7~$O1$hXq	lulwi	a lullaby (n)	
h:Dx2PLR!+	lumba	overcast (adj)	
v)%IB%aQL_	lung (n)	heavy (n)	
j[v@0Zy0:l	lung (n, Sense Perception)	heavy; grave, serious (n)	
"mmf6H%C#,t"	lungra-	to weigh, bear on, hang heavy (vb)	
N6B$F01UEX	luntha-	to balance, weigh (vb)	
G9daWk_]ET	lunthang	balance, scales (n)	
FMJPCgtGgz	lur-	to frown, scowl (vb)	
sDKX5<jHG^	lurc	a frown, scowl (n)	
"b[UbGo;X#B"	luv-	to hang, lower (of clouds) (vb)	
N]C**jB)M+	lu	occasion, time (n)	
D88N^FK=(s	lôda-	to smooth out, stroke, caress, soothe, beguile (vb)	
lOw]PJKI>+	lô	pool, lake (n)	
"QxMCtIj#x]"	mab (Body Parts and Functions)	hand(s) (n)	
"eU3#?FuM&S"	mablod	palm of the hand (n)	
p{U?Dw%=Od	mab	grasp (n)	
JstG~!p`Az	madheg	something (n)	
o/%`?<hlG_	madhias	softness, pliancy (n)	
PYZ(lN3iB]	madhin	some (adj)	
lY-nbkxz:)	madhir	someone (f.) (n)	
"z#i8PAqLf["	madhon	someone (m.) (n)	
oh@}LI/T+`	madriol	edible, fit for food, wholesome (adj)	
f~YCIOS&&L	maen (adj)	skilled, clever (adj)	
DLIVBC>*]9	maenas	craft, handicraft, art (n)	
"FP#)GZUb0Z"	maeth (Warfare and Hunting)	fight, battle (n)	
kK6!7]AH)H	maetha- (Warfare and Hunting)	to fight (vb)	
C$LNt6uOM<	maethon	snuffling (adj)	
"l*#5i|2/<w"	maethor	warrior (n)	
Q9N0RwMBSm	magradh-	?to smell (vb)	
u9lhv|{OHB	maidhon	midday (n)	
J%*[J~F8%=	maidh	pale, fallow, fawn [light yellowish tan colour] (adj)	
wHU}+n0vu]	maimelion	dearly beloved (adj)	
Om)WhVFQ.Q	main (adv)	better (adv)	
eV@4UJ!1{*	maint	*better (adv)	
dO9l<L/2G8	mairos	mane, long hair (n)	
Hf4oP|.Bwi	maithod	rapture (n)	
H@5tCgAD6K	mai	well (adv)	
"C^!o#P!L[]"	malcwed	lordly, noble, mighty (adj)	
F_FWMulFQ}	malen	(1) pale, wan, yellowish, sickly; (2) yellow, [ᴱN.] yellowish (adj)	
gy^lXgC_sR	mallen	of gold (adj)	
rdbp1!34[8	malthen	of gold [metal] (adj)	
M7A}ntDu),	manadh	doom, final end, fate, fortune; final bliss (n)	
otDkmc`+iE	mar(o)n	ripe (adj)	
c.6.$;;GpK	mara	sand (n)	
q/5y%;~Q$i	marn	?ripe (adj)	
"G&ukU#!&V#"	maroglin	yellow song, daffodil (n)	
I8Fc:>qfh1	mastir	*shepherdess (n)	
m97DJZCuS|	matha-	to stroke, feel, handle (vb)	
rmOXF*Z{$.	maudra-	be early, come first; to prefer, to be preferred (vb)	
h=$}M)SpSc	maudri	early morn before dawn, time before first meal (n)	
"DK#bXZo=0x"	maudro	sooner, earlier; rather (adv)	
tZ=rM>3~64	maul (Animals)	the lowing of cattle, bellowing (n)	
C&A-?TgznS	maur	gloom (n)	
E+~nw9GyR?	mau	soon, early (adv)	
EzPrdgR/NS	me-	we, 1st-plural pronoun (pron)	
y0X3;~A-Gh	medion	eater, feeder (n)	
VSS99yH4v	meg	any small animal; (esp.) mole (n)	
"h#@m_TyKe{"	meidianweb	worthy of being eaten (adj)	
w6fe_a0S7!	melch	greedy (adj)	
Gw*yl+:^26	meldir	friend [m.] (n)	
AmZn>{b8N	meldis	friend (f.) (n)	
C^{D06LHvb	melethril	lover (f.) (n)	
Nx_|lYD2*1	melethron	lover (m.) (n)	
x`vBR6c[X&	meleth	love (n)	
iulS>57{?<	meltha	dear, beloved (adj)	
yR]Nwk[Vq(	ment (Spatial Relations)	point (n)	
J+cOH0_/d!	methal	footstep (n)	
xd{S6?~D1d	midh	mist, drizzle (n)	
jlM<h8,,jX	miginthi	littleness (n)	
uN|u.,X)%e	milui	friendly, loving, kind (adj)	
"nEH#K82Q]j"	mim	gum (n)	
ul/VC,4hqS	mindon	(1) tower; (2) tower, isolated hill (especially a hill with a watchtower) (n)	
oPx?Ga,T|g	minn	?one (cardinal)	
vS%.y!UeVm	mintha	ūna, in one place, together (adj)	
Mb}^lq^4ec	mista-	to stray about (vb)	
J|Z`:!q+,F	mistrad	straying, error (n)	
of_8:Ya{eT	mist	error, wandering (n)	
k<:PN+UVqU	modog	*a large number (adj)	
M~?S[K;>)r	modra-	count, measure (vb)	
Aq;kN3{IEv	modri	measurement (n)	
z}-AUg*9Dz	modwen	a large number (adj)	
ev5nVQKS}A	mod	a number, figure (n)	
N(4]2F`.6:	moir	goods (n)	
i:nMfg[S5p	mord	man, warrior; †shepherd (n)	
I@_9zO:UEP	morn (adj)	(1) black, dark; (2) dark, black (adj)	
"q+|#Y?;qL@"	mothwen	1000; †flock (n)	
y%Ww6:j+:~	muda-	to labour, toil, *work (vb)	
Lu=PgfvH9H	mug-	to keep silent, say nothing (about) (vb)	
JXrYdGwZ|g	mugol	taciturn (adj)	
j4tYhX=U[R	mui (Food and Drink)	crumb (n)	
P.L-TPyHCB	muin (adj)	dear (adj)	
"mC+#!l~S{j"	muin (n)	kine, cattle (n)	
"u#>txNY($n"	muinos	security (n)	
wLYxnNIdL>	muint	best thing (n)	
"rSSjZ,n#Ah"	mumla-	stammer, gibber (vb)	
l3+p!&1KGh	mumloth	stuttering (n)	
"PYseK?/Z#G"	mumol	stammering, gibbering, inarticulate (adj)	
l5~fK?(@JQ	munc	shut mouth, silence, secretiveness; (aj.) mum (n)	
e]z6_I@!]_	murc	a nightmare, vision of the night (n)	
wlr-(X_k>;	muthra-	to veil (vb)	
n8O>phB:Po	mân	departed spirit (n)	
Lx(V$L(?qp	mîl	love, affection (n)	
bVgu|4s=vX	mîw	small, tiny, frail (adj)	
Cah06j12)p	môl	the (inside of the) mouth (n)	
cGl{b5qi?l	môn	bare hill, knoll (n)	
qj+T6WHU-/	mútha-	depart, go, leave; (c. gen.) leave the place of/time of/speaker, go forward (vb)	
"IH>EKEGj#;"	mûl	slave, thrall (n)	
F%T{1miw?	mûm	lowing (n)	
xsV@/LzhaK	nad	thing (n)	
Ad:(RlE[z;	naeg	pain (n)	
k;B8.;%T}%	naeth (Body Parts and Functions)	biting, gnashing of teeth (n)	
G?Ln}/r]aW	naew	jaw (n)	
w?Lc>%b%Ki	nae	alas (interj)	
Dd)N2?4{3i	naf-	to suspect, have inkling of (vb)	
g{L:Utxjz5	nafol	suspicious (subjective) (adj)	
z<vPP7F$gs	nafra-	to nose about in others’ business (vb)	
oI6KS)hmxz	nag-	to bite (vb)	
tE>&6mlQ>|	naithol	miserable (adj)	
K(+W>EI%yo	naithonwi	misery (n)	
jE/FhD7[8I	nam-	withdraw, draw out, draw back, take back; (intr.) withdraw, retire (vb)	
v2X*Z|J77D	nana	mother (hypocoristic), *mommy (n)	
zays!w~wUN	nand	dale (n)	
lj/Rj>0-Xg	nann (Physical World)	(1) dale; (2) wide grassland (n)	
O;{~(=@bQu	nanweg	*farmer (n)	
yn4Z/JY@{0	nara-	to tell (vb)	
Eahz^5*Jg	narcha-	to rend (vb)	
Ckv7>4x{oy	narcos	rot, decay (n)	
"K/tJo62#HA"	nardh	knot (n)	
LrxmJdo>Z2	narog	violent (of water, rain, etc.), torrential (adj)	
H%B3*&Sz7y	nartha-	to kindle, *ignite, inflame, set fire to (vb)	
b:1&Rb6WP^	narthiel	fragrance (n)	
BvTL,%]f`x	narthol	fragrant, odorous (adj)	
o]l<H^e00)	naru	[fiery] red (adj)	
n6]xP:bE7$	nass	point, (sharp) end; angle, corner (n)	
MbjpyLmMAD	nasta-	to prick, point, stick, thrust (vb)	
AW=H.6/sN;	nathanwi	fatherhood (n)	
n1^$1pDG=:	nathron	weaver, webster (n)	
A~KcFHu`H&	nath	web (n)	
[*Q.7&p;1	naud (adj)	bound (adj)	
jv.h6q{ISW	naud (n)	treasure (n)	
EMT7i/SgOO	naudra-	to abash, to make ashamed (vb)	
uP91%zHKP|	nauin	dwarf (adj)	
"E#}Rp[;w|;"	naur (adj)	ill-tempered, sour, grumbling (adj)	
JqQ4K;fssr	naur (n, Emotion)	a snarl, ugly grin (n)	
J^)E-)CAI~	naur (n, Physical World)	(1) fire; (2) flame (n)	
CD$(rwL9v`	naus	keen-witted, observant; notice (adj n)	
s02T/5Mr*C	nautha-	to conceive (vb)	
p,%FdA!dUL	nauth	thought (n)	
m;,fXo|K,+	naw (n)	idea (n)	
md?qHUvUsu	ne-	in (pref)	
E=Gp[fH3sE	nectha	honey comb (n)	
l[hVmU^<-e	nedh-	mid- (pref)	
lwRt(p[!b1	neibio	nearly, almost (adv)	
z0_O<N!lLE	nel-	tri- (pref)	
Nd24Os2.=p	neledh-	*to go in, enter (vb)	
n{V.&(5jHx	nella-	to sound (of bells), *ring (vb)	
k&[j@5iqVj	nelladel	ringing of bells (n)	
htoIcvrXuG	nell	bell (n)	
qc|a[7NptL	nelthil	triangle (n)	
ltQ.,MI+Rs	nel	point, end, tip, jutting end (n)	
F>St)suZ]s	nem (n)	nose (n)	
"O:m0%q#}ij"	nen(n)	(1) water, river, stream; (2) water; river (n)	
hOC)pc_(n6	nermil	a fay that haunts the meadows and riverbanks (n)	
n9FOu;*TXr	nesta-	to heal (vb)	
z}oBN[|G==	nestad	healing (n)	
g:oeg58wZq	nestag-	to insert, stick in (vb)	
AMPD?F?IWB	neðw	scarred, bruised (adj)	
PIs2P=F9]u	ni (prep)	without (both senses) (prep)	
A*a(RWA3Hq	ni-	I, 1st-singular pronoun (pron)	
tju-Qme._A	nifredil	(green) snowdrop; *(lit.) pale point (n)	
eJ{Dt=Em5L	nifred	pallor, fear (n)	
j*o48%}ryY	nigrim	to swarm (n)	
HaN:Lk@o?>	nimmid(a)-	to whiten (vb)	
i/4hE2VhX,	ninghonin	*snowdrop (n)	
fb9Y)R`|G9	niniel	tearful (adj)	
t!n74BR.Hs	ninion	water lily (n)	
P3($g3/)Jb	nion	(1) bee; (2) grandson (n)	
J(P@H^7N]4	niosturwin	queen bee (n)	
"Ll~!iK%bB#"	nir	grandchild of (pref)	
j1*VTl6^Ve	no-	re-, back, again (pref)	
KYV+g2aDOl	nobra-	to follow, go after (vb)	
"v|_2Kny#/3"	nobron	the second, next following (n)	
f+EC-ucJY<	nod-	to tie (vb)	
"K6+)#8l|Sp"	nodro	farther on, further forward, later, again (adv)	
"e9=lZAWA#^"	nod	forward, on, in advance (adv)	
O<ae[wz,a$	noen	wise, sensible (adj)	
i7y4H?-CM4	nogra-	to excell, exceed (vb)	
o`^NC!zbkZ	nogriol	excellent, conspicuous (adj)	
s%Qo0!/_|l	nontha	the next, the succeeding (time only) (adj)	
ExK1Om9YPa	nordh	cord (adj)	
oGXvDClX78	norn (adj)	twisted, knotted, crabbed, contorted (adj)	
gi>=W[5bHx	norn (n)	(1) [G.] wheel; (2) wheel (n)	
t+S!N~*,{c	noroth	giant (n)	
Pyyk}?s;Er	noss (Social Relations)	clan, family, ‘house’ (n)	
BBoNez5d15	nos	kin, people (n)	
l:h.0Qm4u=	noth (adj)	damp, wet (adj)	
v!HY{QE91|	noth (n)	rain (n)	
g+CR^(q|;u	no	then, next, again; then, after(wards) (adv)	
G1[oZ?gJ?q	nuidro	still later (adv)	
BCaL@7S5Zw	nuinvrond	steadfastness (n)	
h*68g(hdEZ	nuin	mind, thought (n)	
xc)!pT+S31	nusiothli	sagacity (n)	
j-+@c&7dKe	nâla	yellow-lily (n)	
A>G&qVIfij	nâr	rat (n)	
I:FD}F/[`+	nírnaeth	lamentation (n)	
r~~H}T5C^j	nîd	damp, wet; tearful (adj)	
EM5ndEk$x+	nîf (Spatial Relations)	front, face (n)	
vtu,a+pRe$	nîr	(1) grief, sorrow; (2) tear; (3) weeping, [G.] grief, sorrow (n)	
e>6TNNd2vC	nîð	hurt, bruised (adj)	
"qsO^OqU_#U"	núnad-	to wester (vb)	
rEb[%YZOTo	núnadol	westering (n)	
h![CR2BwH9	nún	sinking, going down; west (n)	
LQJb:$e^>2	nûr (adj)	deep (adj)	
"xfqC|#.ky{"	nûr (n)	race (n)	
Q&Sv?UtkI7	o(r)dhraust	without work, workless (adj)	
kmLv[),F~I	o(r)ngolodh	without gnomes (adj)	
nU@eOoWPP)	o-	he (conj)	
C[MEt_.Yu}	obin	second, next (adj)	
cd]a:g(>qg	obron	*next (adv)	
bA2eD_a}{l	obruith	(evil) consequences (n)	
"DYP@B!P3N#"	odhril	parent (f.) (n)	
hdP1+4PFvg	odhron	parent (n)	
qrLG%_kfFD	odog (adj)	(1) mighty, great; violent, excessive, exceeding, very; (2) much, abundant; large in quantity (adj)	
J6<b|b2_:a	odra-	am able, can (vb)	
x]Un[~EGP)	odrim	(very) many (adj)	
j@cWjm*@</	ogra-	to be able, can (vb)	
pq%lmc4n<4	ogra	able to (prep)	
Mb<UP_HgX(	ogriol	possible (adj)	
jNHz51`_Ab	oith	feud (n)	
cJ~SRvya&W	oland	tide, motion of sea (n)	
w=`Y/MbtW1	olaud	tide, motion of the sea (n)	
djgR6f%;19	olerdh	pitiless, cruel, (lit.) without bowels (adj)	
qsp2-g^92`	olfin(g)	branch, wand, stick (n)	
o<[!rQ?*b5	oll	torrent, mountain-stream (n)	
f2;t,$y,c1	olor	dream, apparition, vision (n)	
QxBr[OSDOr	oltha-	(1) to appear as an apparition; to dream; (2) to dream (vb)	
Adg)17g58J	omla	a horse chestnut (n)	
cQbI*3%k15	on	*he (pron)	
Dj9K.3.9k%	or (adv prep)	(av.) on, on top; (prep.) on, onto (adv prep)	
L$B(3/TL{K	or (prep)	above; [G.] onto (prep)	
fodN9&KSwh	or-	privative prefix, without, -less (pref)	
z5DZ>)@5^5	orann	doorless (adj)	
QTz!{O(rDX	ordarn	gateless (adj)	
"Nws?G(#,1L"	oren	hot (weather) (adj)	
"s4s#CZQ;uN"	orerdh	without bowels, pitiless (adj)	
q*=!fCng;L	orfang	beardless (adj)	
H(.~`g&5{0	ormagodron	a (Spanish) chestnut tree (n)	
zv_DrHYf?F	ormagod	a (Spanish) chestnut (n)	
sr}=w1ie0=	ormar	houseless (adj)	
BKmFgndY{g	ormast	breadless (adj)	
j+RB0`)AMX	ornath	numberless (adj)	
J$8dYdQAjR	orost	rising, sunrise (n)	
CDm{@D-{5E	oroth (Time)	impetus, speed, haste, rash courage (n)	
k9-_d(NI&j	orsarn	stoneless (adj)	
o&<Nt=&(AB	orthalos	courageless (adj)	
BDjZHZU3Op	orthanc	unbroken, without break or cleavage, united, continuous; masked (adj)	
CDH+Zt.-z%	orthannen	raised (adj)	
g+`^E,Jdx9	orthel-	to roof, screen above (vb)	
Q[-@FGplEV	orthelian	canopy (n)	
D&]M.gnnF+	orthor-	to master, conquer (vb)	
E2%jp_cTt0	orvab	handless (adj)	
zVvUe?Q*FH	orvaith (Clothing and Adornment)	garmentless (adj)	
FQSW/i6}oS	orvaith (Law and Judgment)	unravished (adj)	
D&t<oBU*6=	orvang	staffless (adj)	
K&3+66.]2l	orvath	foodless (adj)	
F@}2!0au|R	orvlann	without deceit (adj)	
F9@txcD;`?	orvlod	without pride, spiritless (adj)	
pG]kUW%{9@	orvog	priceless (adj)	
u~LmN(Pjxj	orwadh	barkless (adj)	
"k7WDILl#V0"	os-	about (pref)	
dect)1CC{w	osgar-	to cut round, amputate (vb)	
j}ccnYCy]q	ospathol	ebullient (adj)	
LY_ql8+77B	ospoth	froth (n)	
kCN_K=w(mW	osp	smoke (n)	
E@&N46w7$h	oss	outer wall (with moat), town wall, moat (n)	
psoeX!LeI4	ost (n)	(1) city; (2) city, town (with wall round); (3) enclosure, yard; town; (4) fort, fortress, stronghold, citadel; (fortified) town, [N.] city; [orig.] [S.] enclosure (n)	
zQ&/EzK~]R	ost (pron)	yourselves (pron)	
m|{EdaUsZ}	oth	ye (pron)	
s%^20%S<^w	ovor	abundant (adj)	
xq]wy6mDlb	ovra-	to abound (vb)	
J-x3DfP*6V	ovras	crowd, heap (n)	
sQXT(:Y2~5	padhra-	to skin, peel, flay (vb)	
zg/6}oIl`2	pagra-	to pave (vb)	
F8acYhK>F}	pagros	pavement (n)	
Bd5EF?bh]y	paib	sour (adj)	
N_S`!6pY@c	palath	surface (n)	
GR&a|7*CV<	pan (Spatial Relations)	arrangement, settlement; place, spot (n)	
x.n/+~(Y13	panas	floor (n)	
DFt-33n,|v	panna-	to open, enlarge (vb)	
iWE[AqpFXP	pannad(a)-	to fill (trans.) (vb)	
e~PUPKJLA7	pann	wide (adj)	
5Qhg?3[$z	parch	dry (adj)	
"D~%;h#jWp*"	parf	book (n)	
r$n(V:Nt/5	path (adj)	smooth (adj)	
r|A]vJy/-v	path (n)	peel, skin of fruit, fine bark (paper) (n)	
Ek@[6Y>wa!	pathra-	to fill (intr.) (vb)	
x~mgC.0^:!	pathred	fullness (n)	
x|uud9_-QY	pathren	fearful (adj)	
tXDEIGdC&F	pau	sickness (n)	
vU7+-$OCf_	paw	sickness, *illness, ailment (n)	
Cv+L?.6RL!	peg	dot, small spot (n)	
xko$}Y,w)>	peidion	sayer, soothsayer (n)	
"ba4##&kwf!"	pelia-	to spread (vb)	
s0(3BKy|lF	pelthaes	pivot (n)	
bo?O@!5:CH	pendrath	passage up or down slope, stairway (n)	
tNQ&Xoa<0@	penia-	to fix, set (vb)	
f<jkE%2p,c	penn	declivity (n)	
wB?|Gfk%;>	pent	tale, story (n)	
I(]vW?R%bN	perin	half (adj)	
k0l);my>xw	pessa-	to affect, concern (vb)	
iw>mu3UU*$	pesseg	pillow (n)	
G2px-}zcJ-	pichen	juicy, *oozing (adj)	
m8tP0{dF/v	pictha-	to make urine (vb)	
FE[(%)f*Y:	piectha-	to pin, prick (vb)	
xsbJW_o[,J	pigen	tiny (adj)	
vjf{L?AJ0z	pilingwathil	feathering of an arrow (n)	
FotedaoC``	podod	potato (n)	
OI9TtkgyZh	poen	small gull, petrel (n)	
wMcVo>C<TT	poiant	stern (n)	
CB_WuOdNyI	poi	aft (on a ship) (n)	
"h#eLh{k`Yp"	polwed	strong (physically) (adj)	
g,oW+kPk.M	polwin	strength (physical) (n)	
CDFE}Ph-fg	pont	the back, reverse or far side (n)	
nwk]gi)cqP	post	pause, halt, rest, cessation, respite (n)	
P!$9I/|hw^	presta-	to affect, trouble, disturb (vb)	
M=kZS*chbl	prestannen	affected (of vowels), mutated (adj)	
OodkKb`Kyo	prestanneth	affection (of vowels), mutation (n)	
OFX/a+wChb	pridu-	to decide (vb)	
e@`~Pyn{F/	pridwen	judgment (n)	
p|VKbX&Z;1	prind	distinction (n)	
Iuq9}*_7NQ	puibra-	to wash, cleanse, soap (vb)	
uh6>9^JS@0	puig	(1) clean, neat, tidy; (2) clean, tidy, neat (adj)	
s~)@laxmUp	pân (n)	plank, fixed board (especially in a floor) (n)	
nUL5,3t,,u	pôd	animal’s foot (n)	
OeJ9Z/bulr	quing	bow (n)	
j,Q1Zm]QQ5	rada-	to make a way, find a way (vb)	
HQ-]mnVcnS	raibros	(female) zebra (n)	
o(CIBkLJyj	raim	edge, border-line (n)	
Br0;{)CLD7	rain (n, Time)	anniversary, year complete (n)	
NPOGqRkMq}	ram(m)as	*great wall (n)	
A,h).w$WiM	ras-	to scorch, toast (vb)	
"Kv[S#Fc4<V"	rasc	toast(ed bread) (n)	
"DU57+>iWk#"	rath (Body Parts and Functions)	the full arm, the extent of one’s arm, one’s reach; a measure = 2 feet (n)	
v7<iKR*TFZ	rath (Motion and Transportation)	(1) course, river-bed; (2) street; [N.] course, river-bed (n)	
HT&dk0&~_i	redhos	land (n)	
kew9oZMUX$	ren(d)	cousin (m.), relative (n)	
qsyRM-B.Y8	rhaid-	to rush, hustle (vb)	
uZ}%ep*?e5	rhaid	a rush(ing) (n)	
xydZfN@:._	rheidiant	set free (adj)	
AVxTh^cNaG	rhess	ravine (n)	
"dD/(cv%1#L"	rhofan	wilderness (n)	
k5$*FHOs2i	rhogrin	doughty (adj)	
"j$.{p?#ZH~"	rhoidia-	to let go (vb)	
QCyWZ_=0]5	rhód	course, running; way, method (n)	
q~=<pyMo}=	rhôg	strength (n)	
z+^@nt5caO	rig	a snarl, a sneer (n)	
P%-rIl~yNM	rim (n adj)	peace, quietness, calm; quiet, calm, peaceful (n adj)	
lSN_ns|?TF	rim (n, Language and Music)	stripe, line; border, fringe (n)	
z&!I$>TKFA	rimin	quiet, calm, peaceful (adj)	
B<tE]Bqz)|	roch	(1) (swift) horse; (2) horse (n)	
C%@BH$qRoG	rodrin	cylindrical (adj)	
NE{aQ4=n<l	rosta-	to hollow out, excavate (vb)	
z[PswDtOK|	rosta	ascent, uprising, rising (n)	
B=q&EOb}kL	roth	cave, grot (n)	
wL2s}xA4b5	ruim	secret, mysterious (adj)	
l83sL?X~n%	rusg	oatcake (n)	
u4e,dw!Ew`	rust (Agriculture and Vegetation)	inhabitation; cultivation, tillage (n)	
hEb4ty05+g	ruthla	oaten (adj)	
C&XGqUAhmS	ruthli	oats (n)	
g-C(rA!<sD	rî (Sense Perception)	coolness, cool; a sudden breeze or cold breath (n)	
n7N]q<<hle	rôg	doughty, strong (adj)	
d+Cc-$QY|f	rôl	a song (n)	
o0%nZ86`v4	rôn (Possession and Trade)	embrace, clasp (n)	
kQnH1jORIa	rûm	secret, mystery (n)	
x]8CIX]L6F	rû	mystery (n)	
rw<I}{]4o-	sachwen	summer, midsummer (n)	
b>I62cDjM(	sad-	to reck, care, value, esteem, show respect for, consider (vb)	
MRYr.dPv=W	saichwed	fiery, fierce (adj)	
"P0:!-JeO?#"	saictha-	to have hunger (vb)	
"M#rsuLUoe4"	sairos	great age (n)	
d819J[cyf0	sairothwen	antiquity (n)	
M}9]Bd3a%%	sairweg	old man, sage (n)	
F!|)AF9]T%	sairweigian	proverbial wisdom, sage saying (n)	
oT2*`b/+hI	sair	aged, ancient (adj)	
g^/BhZ)I)y	salab	herb (n)	
rcbpi6@_&[	salta	a game (n)	
"}##M*L!yT"	saltha-	play (vb)	
"gH8#-K@HGL"	salum	*harp (n)	
zIah|`Q@,`	samtha-	to settle a matter legally (vb)	
JA1Gf(q9<?	sara-	ait (vb)	
f$,?NrY*.L	sarn (n adj)	(1) (small) stone, pebble; stony (place); (2) stone as a material (n adj)	
A<]j+Yy=!7	sarn (n)	(1) a stone; (2) stone (n)	
wSB~=WPd{>	sarnas	cairn (n)	
nNK4v5wto5	sautha-	to drain (vb)	
cFu`d_^dHe	saw (Food and Drink)	juice (n)	
y!rxh+-Ma_	secthadron	midmost (adj)	
J+xVR4@Z:8	si(n)-	granddaughter of (pref)	
LA`0aB2%s`	sigil (Physical Acts and Materials)	dagger, knife (n)	
ozWfF6,b?$	silef (adj)	silver, shining white (adj)	
j./giJfxuA	silif	light of Silpion, †silver, *moonlight (n)	
O2b9u5R}Z+	silith	light of Silpion, *moonlight (n)	
CQ(Rb!y0i	siniath	news, tidings (n)	
FQuem$u(^O	sinnarn	novel tale (n)	
f1wPxhrxCK	siria-	to flow (vb)	
k8iD>44_Mw	sog-	to drink (vb)	
OVh_%wgG~2	solch	root (especially as edible) (n)	
pS{tCE2d2n	suitha-	to dry, wipe (vb)	
w)7Ul|:}rJ	sulus	air-spirit (n)	
tQ|ghYW&tO	suss (interj)	hush (interj)	
o=/r5LS(U)	suss (n)	hush, sudden quiet (n)	
Ary|x=|xK`	suthra-	to hush, to make or go quiet (vb)	
KZ]5SW7w)]	sî (n)	bead, small gem or pearl (n)	
Nkvz-(<5T@	sîdh	peace (n)	
J*!bmP(rv!	sîr (Physical World)	(1) river; (2) river, stream (n)	
E!CAsu5UuB	sûl (Food and Drink)	goblet (n)	
C]=~wyEqO(	sûr	long, trailing (adj)	
Fx=<Kp0/NZ	taen (adj)	long (and thin) (adj)	
cA>H1C:@R-	taen (n)	height, summit of high mountain (n)	
Q@dDa-x_ae	taes	nail (n)	
A~^*(f@[Dd	taetha-	to fasten, tie (vb)	
df<S|Od].9	taew	holder, socket, hasp, clasp, staple (n)	
hN1RJrsdXc	tair (n)	look-out, watch, guard; gaze, regard (n)	
ohNEN5}$x5	talad	incline, slope (n)	
e3b6^&dq)q	talaf	ground, floor (n)	
"l[SoRT%2#1"	talc	upright (adj)	
L]&Z`x4gL2	taloth	(foot)path (n)	
NB`*;hc8_b	talpa-	to prop up, buttress up (vb)	
s)Bfz[`nEQ	talpon	a slender pillar (n)	
mF4DEL4ICt	talt	slipping, falling, insecure (adj)	
z58tH[N3s6	tamma-	to knock (vb)	
LU*vg_x!Y/	tanc (Emotion)	firm; [ᴱN.] steady, steadfast; [G.] settled (adj)	
K</>s!>PRH	tanc (Mind and Thought)	(1) firm, steady, settled; (2) firm, steady, steadfast (adj)	
LPv!*2[wiX	tanga-	to set light to, kindle (vb)	
eu;}HPgbnD	tangad(a)-	to make firm, confirm, establish, [ᴱN.] fix (vb)	
i~b0>8h8X<	tangad-	to fix, make firm (vb)	
O:*DE_6USO	tangod	fixing, confirming, making (n)	
IsniEzkM[@	tangor	hearthgrate, fireplace (n)	
Ar:9wH^U8;	tangos	firmness, steadiness (n)	
I*.mrlS8MJ	tang	bowstring (n)	
w)9$Dqt-);	tarag	horn; steep mountain peak (n)	
entb8-OQuF	tara	tough, stiff (adj)	
BBDp)5>Fhf	tarf	dry, stale (adj)	
nk)x1RdcYW	tarias	stiffness, toughness, difficulty (n)	
PN)_&mQQZl	tarnon	porter (n)	
w{=L{j0N_0	tarn	gate (n)	
K1$igITE0;	taru (adj)	horned (adj)	
QeS4V3(KD(	taru (n)	(1) cross, *crucifix; (2) cross; crossing (n)	
n6NJC~v.+w	tass	labour, task (n)	
MLgyp+-B+0	tast (Quantity and Number)	total, amount (n)	
xy&6X:P(+W	tathrin	willow (n)	
MCa_!*H4u?	taudha	phosphorous (n)	
A1c1NCEZ:|	taul	pillar (n)	
I=$Sk1%}9Y	taur (adj)	vast, mighty, overwhelming, awful, huge; high, sublime (adj)	
ltv9ce6Y*}	taur (n, Physical World)	(1) dense wood or forest; (2) forest, great wood; (3) forest, wood, [N.] great wood, [G.] dense wood (n)	
qcin;G(dJ~	taur (n, Social Relations)	king (of a whole tribe) (n)	
xf]ym5N_sC	taus	thatch (n)	
YQ)F)fYfh	tavor (Animals)	woodpecker, knocker (n)	
PbZ$f^wB:8	tavor (Religion and Beliefs)	wood fay (n)	
w}=tuR4e3s	taw (adj)	of wool, woollen (adj)	
sk/QUQ14yf	tawar	wood (material), *forest (n)	
NQj<XA!Y-I	teb	point, nib, neb, nose (n)	
ud_;M5nl3B	teglath	noted year, special year, feast year (n)	
"c$eS1>`)#x"	teglos	awning (n)	
k:eKaYtkVf	telch	stem (n)	
Pn&b5PCE!a	tele	end, rear, hindmost part (n)	
loel)5I$HC	telien	sport, play, [ᴱN.] game (n)	
"Bi]^#Petq|"	telingail	sign of heaven (n)	
FA>4).dow,	teloth	roofing, canopy, shelter (n)	
fmuH@/._JC	telthon	roof (n)	
X$k1_^j-v	telum	roof; sky (n)	
g*(Dhlv-Xs	telu	dome, high roof (n)	
fHue7b]ekU	tengedion	confirmer, fixer, establisher (n)	
jt[lYq(N<4	tentha-	feel with the feet, walk on tiptoe (vb)	
mdvol<@4Ux	tess(il)	little flower; †maiden (n)	
j<7u-.JSZn	tess	fine pierced hole (n)	
ta3!gGuCww	thaigra	choice, select, elegant (adj)	
gz^r8+c*(R	thaig	choice (n)	
MvYAg0K}Fw	thain (Spatial Relations)	level, even (adj)	
bmRHby{(DP	thairin	magic (adj)	
m|wfvK~_bo	thala	(1) stalwart, steady, firm, [ᴱN.] hardy, valiant, bold; (2) valiant, hardy, bold (adj)	
LLfcxI{QhM	thalion (n)	(1) hero, dauntless man; (2) warrior hero (n)	
ji+4]YzY?}	thamas	great hall (n)	
J){<;mQ)4N	tham	chamber, room (n)	
q>Ed!u<0pw	thang (Quantity and Number)	a crowd, crush, herd (n)	
"s)`z#y2:pL"	thang (Social Relations)	(1) compulsion, duress, need, oppression; (2) oppression, pressure; [N.] compulsion, duress, need (n)	
rRAoR>D`qS	tharas	hassock, footstool (n)	
i]HUU}xRUE	tharn	sapless, stiff, rigid, withered (adj)	
PnQn+<FJl]	thas	thy (pron)	
C82!OjD`$i	thathri	shavings, sawdust (n)	
GNM$I`{qm	thavron	carpenter, wright, builder (n)	
GhuV;>XhYh	thaw	corrupt, rotten (adj)	
e83~`D)^75	thegin	leading, chief (adj)	
Kz=(<YdxHs	thegla	first lights of dawn (n)	
wk|UZ{mCHa	thegor	chief (n)	
dO`tnVt>ZS	thegra	first, foremost (adj)	
iFRJ9&VXB&	thela	point (of spear) (n)	
o:6BzGs!$+	thibindon	flute-playing (n)	
w(=x4V=g]$	thig-	to pick out, select, choose (vb)	
h*a$(@GK~L	thilia-	to glisten (vb)	
v=iOjfb*h$	thilim	gleaming (adj)	
KNCg0=IKLx	thinc	a pick, a choice; a bunch, posy (n)	
iqS*Wo8=.+	thinna-	to fade, *(lit.) become grey (vb)	
M<ROft1Mo@	thinn	grey, pale (adj)	
H%t/|+uwaD	thirad-	to make complete, fill in the last details (vb)	
o?uM=4w42}	thiradant	elaborately finished (adj)	
"u[8I#z$_9*"	thlidhra	‘willowy’, gracile (adj)	
w`AHzGSqik	thlim	race, kind, species, sort (n)	
"r#C:G85eD}"	thloss	breaker (n)	
O(Mjs,z:U$	thol-	to roll (vb)	
u>v{BwCh-3	tholos	axle of a wheel (n)	
oCiFKwc!S!	thonnas	root-word; *foundation (n)	
z2C.2la>_s	thonn	base, root, root-word (n)	
"mV#C.A.(9`"	thora-	to fence (vb)	
ObxZK>)>9d	thoren	*fenced (adj)	
j+,B9ql>;S	thosta-	to stink, *give off a smell (vb)	
s<10bWW_*6	thost	smell (n)	
q8Xf,;/(;<	thothri	black magic (n)	
xlLrn0V49(	throthriol	wizardous (n)	
ljU;c?^5U	throth	beat (of oars, wings, etc.) (n)	
k?Tcj;].xB	thug	?resin (n)	
"CS,nkCGn#F"	thuia-	to breathe (vb)	
J(WOJ;-e?+	thâr	stiff grass (n)	
j>f+7+7J7k	thîn	evening (n)	
QB_92([A9=	thîr (adj)	complete, full, accomplished, ended, up to the required number (adj)	
ypr7TqU=@~	thîr (n)	(1) face, [N.] look, expression, countenance; (2) look, face, expression, countenance (n)	
FSoi-@Km*{	thôr	swooping, leaping down (adj)	
DjA&I5VRba	thûl	breath (n)	
fO>3zy=1}d	tilithli	little elf (n)	
D5^tszK6}_	tilithril	f. elf (n)	
cw)BV6JUy0	tilithrin	elfin (adj)	
f!QGJ3bPR(	tilithron	m. elf (n)	
E}ZC=Yx~nO	till (Body Parts and Functions)	horn (n)	
"vHnK)>6#1,"	timpintha-	to ring, jingle, tinkle (vb)	
CqFW8=U22o	tinna-	to glint (vb)	
EP]8]<lrDC	tirion (Warfare and Hunting)	tower (n)	
j!!CKqU-MC	tirion	watch-tower, turret, tower (n)	
e&+KXRix3A	tithen	little, tiny (adj)	
"EJ%hIVbj#z"	tiwdi	alphabet (n)	
P+V+(AE1WW	tlacha-	to clap, clash, clatter (vb)	
FL>E`+i$Pa	tlachol	clashing (adj)	
x?qoO=A$p@	tlach	clap, clash (n)	
d3U;aY^Hr>	tlaud	sloping (adj)	
tq{dywRVwM	toba-	to cover, roof over (vb)	
r7-UU)xsiF	tobas	roofing, roof (n)	
mWA|7Y5F$r	tog-	to bring (vb)	
l`E&h:EDNJ	tolog	stalwart, trusty (adj)	
HXly!zsQV}	toltha-	to fetch (vb)	
n/3jWktK+*	tol	isle (with high steep coast) (n)	
"BE][{MEwI#"	tong	taut, tight; resonant (of strings) (adj)	
G8H}CR|fGO	torc	a sear, mark of a burn (n)	
sIqdK*;38*	tortha-	to wield, control (vb)	
c0+0q!=Ay5	toss	bush, low-growing tree (n)	
"h-#C,etrJG"	tranc	criss-cross, crossed; cross, at cross purpose, perverse (adj)	
EP1SZlf>-A	trasta-	to harass, trouble (vb)	
L~x_A6I5u)	tre-	through (pref)	
uVfHS|cF$D	trenar-	to recount, tell to the end (vb)	
Ge7x-7t}h:	trenarn	account, tale (n)	
CQB+5zF!<_	trevad-	to traverse (vb)	
f7u8^_34V5	trîw	fine, very slender (adj)	
nSb{9q3O?z	trî	through (prep)	
hJ,U9U@sbo	tufrin	fluffy (adj)	
wk@~*/P2gu	tuf	down, fluff (n)	
J$9@m6ubOK	tuia-	to sprout, spring; to swell (vb)	
c8_n5H,Dd}	tuilinn	swallow, (lit.) spring-singer (n)	
r0sSXllni+	tui	sprout, bud (n)	
Dar;4croG1	tulog	steady, firm (adj)	
"oWqjc4eg#7"	tultha-	to lift, carry (vb)	
rz4Jz-a0|8	tulus	poplar-tree (n)	
oj4rm~=1ma	tulu	support, prop (n)	
n-0.VNI,kK	tum(b)	flat vale (n)	
ED:.[:-Inj	tump (Physical World)	hump (n)	
wurA51^cJH	tur-	can, to have power to (vb)	
v$yLXY{e0h	turinthir	*queen (n)	
Ku:5V50KNR	tuthlos	a teazle (n)	
y>;c3LM0Pw	tê	(1) line, way; (2) mark, line; track; path (n)	
y,ywCr-N17	tî (adj n)	straight; line (adj n)	
oXr]TmAd=_	tî (n)	(1) line; (2) line, row (n)	
JHnK2-_`Np	tîr (adj n)	†straight, upright, honest (aj.); esteem, regard, honour (adj n)	
b&Q4l`sdjg	tîr (adj)	straight, right; [G.] upright, honest; esteem, regard, honour (adj)	
ywH%?l+F8p	tîr (n)	king (n)	
"QszK6jtSP#"	tôg	storey, floor (of a house) (n)	
EC,pRj)D&C	tûg	thick, fat (adj)	
qvXn<h{-`3	tûm	valley (n)	
h{VRUehrDl	tûr (Body Parts and Functions)	power (n)	
yE<1OS<$?_	tûr (Warfare and Hunting)	mastery, victory (n)	
b+NEn<,2Hp	tûs-	to tease wool, comb out (vb)	
wovvQ_EBX$	tû	muscle, sinew; vigour, physical strength (n)	
D%RM3]7|_G	u(r)dhrog	without slaves (adj)	
EZr$]!VM3s	u(r)ngúl	without wisdom (adj)	
C%mG5!biJ[	u(r)vrog	horseless (adj)	
K@NEg0r+<C	u-	negative prefix (pref)	
h&!&q|zb;v	uanui	monstrous (adj)	
QN(/Il/A8k	ubed	denial (n)	
iQMx~k?CkL	uchirin	secure (adj)	
"t<T#|*{70*"	uchirthol	reckless (adj)	
BD:)F!tI-$	uchir	recklessness; carelessness; security (n)	
oA*,HYyu^-	udrug	intractable, fierce, untamed (adj)	
x(o-M,9T/Y	ufedhron	lawless man (n)	
C({)I}VdNC	ufedhwed	lawless (adj)	
N|t|H;_Z@%	ufeth	without a word (adj)	
Fq^:98H(IW	uf	fine wool, down (n)	
r`uVM5ngBK	ug-	negative verb (vb)	
EayUL_e-a+	ugwedriol	ineffable, unspeakable, awful (adj)	
da{!V.G4Zk	ui (n)	envelope (n)	
bJsg=uhSmb	uir (n)	eternity (n)	
HPx[w?a6^w	uir-	not to wish, not mean to, mean not to (vb)	
KA(hT~BlTK	uirol	unwilling, reluctant (adj)	
"n`DSz#~9&]"	uista-	not to notice (vb)	
6`%nzT!le	ul-	*ugly (pref)	
AE{wguU{-Q	ulcrum	sin (n)	
H`|}{>=DfE	uluithiad	unquenchable (adj)	
AuB>?u/hlZ	ulvon	*monster, giant (n)	
v$)a=m/1wu	umboth	nightfall (n)	
G%Z^Gqn!ma	umli	a dell (n)	
Py&/G/oXM&	ummast	without bread (adj)	
wa?!*[j_P!	unathriol	unreal; impossible (adj)	
j+_LO|*W&C	unaudrathrol	unabashed, shameless (adj)	
=CZc,;5[/	unc	ourselves (pron)	
Iare2*0QTe	ungorod	without a chief (adj)	
gD|=QJ4|S*	ungra	eighth (adj)	
wKrW-Hw7]T	unnor	without a land (adj)	
OI@x77PMaT	urbeth	wordless (adj)	
"O3^=#.VlOD"	urdhuilin	without swallows (adj)	
bI@V]`?kB@	urduf	humorless (adj)	
HD^YH<^j<g	urfuin	nightless (adj)	
Lr:w@bQU%r	urgeleb	without silver (adj)	
"H[05Cq=j#)"	urhonn	heartless (adj)	
iSP,T0T@Cm	urnor	landless (adj)	
g+&!<?tNEi	urorod	without chief (adj)	
HcpS!!h*st	urrost	never coming to life (adj)	
K~1d^l,oS:	urtha-	to work, wreak, fashion, make, devise (vb)	
qUaSX4Z4([	usta-	to leave, depart (vb)	
kZ|4}Lu[a%	uthairiol	unintentional, unintended; reluctant (adj)	
hoCevBZW!V	uthir	without a king (adj)	
w=M:LQ`%|l	uvan	*noone, nobody (pron)	
o.3u;Z4f`p	uvlant	pathless (adj)	
CK1SD{XvMR	uvost	without a town (adj)	
o]s9;hP{,u	u	no, not, nor (adv)	
DB8Ftg0mV<	ven	toward (n)	
"rORg|BCN!#"	yrin	made (by craft of hand) (adj)	
m50HB{oqud	yrith	care-free (adj)	
"F1zPz[q#k]"	yrlhinn	arrowless (adj)	
js%~@R$GJ?	yrlhith	dustless (adj)	
lZuuMD*%>F	êg	thorn (n)	
Af@=7naw!,	í	indefinite indeclinable relative particle (pron)	
b<qTuK/8UY	îd	treasure, thing of great worth, jewel (n)	
JJ,ITs6&;S	îr-	to be willing; to will, intend to, mean to (vb)	
ydMLlv&dOh	îr	*sexual desire (n)	
D|e>[DN,Y[	ôl (Body Parts and Functions)	dream (n)	
wqtfdChu(n	ôl (Spatial Relations)	height, stature (n)	
"Beiq2wu+;#"	ôn	crown of head, top (n)	
mlMzi@]YYK	ôs	bog (n)	
wxY=3d|/96	úan	monster (n)	
zvyN_{n>C0	únoth	without number, countless (adj)	
I(?@.UlIxA	úr	sun (n)	
"jv4}#~2V#D"	û (adv)	*negative (adv)	
i*}(S_%,wp	û-	not to be, not to do (vb)	
JAd;A7Zk!Q	ûl	odour, *smell, scent (n)	
Q2Ka?==57$	ûmi	large (adj)	
Iy`dMzOE{)	ûn	creature (n)	
